Player,Club,POS,games_played,games_started,Minnesota United FCS,Goals_Scored,Assists,SHTS,SOG,HmG,RdG,HmA,RdA,FC,FS,YC,RC,Year,Season
Chris Wondolowski,San Jose Earthquakes,F,28,26,2308,18,1,68,36,10,8,0,1,26,17,3,0,2010,reg
Edson Buddle,LA Galaxy,F,25,25,2109,17,2,96,43,11,6,1,1,43,31,4,0,2010,reg
Dwayne De Rosario,Toronto FC,M,27,24,2226,15,3,72,36,5,10,3,0,27,31,5,0,2010,reg
Sébastien Le Toux,Philadelphia Union,F,28,28,2520,14,11,90,48,11,3,6,5,10,37,0,0,2010,reg
Omar Cummings,Colorado Rapids,F,29,28,2471,14,3,76,37,9,5,1,2,21,42,4,0,2010,reg
Conor Casey,Colorado Rapids,F,27,26,2289,13,6,69,28,9,4,3,3,52,31,8,0,2010,reg
Juan Pablo Angel,New York Red Bulls ,F,30,29,2593,13,4,98,40,4,9,2,2,19,17,2,0,2010,reg
Alvaro Saborio,Real Salt Lake,F,27,23,1988,12,4,51,22,9,3,2,2,30,30,3,0,2010,reg
Jeff Cunningham,FC Dallas,F,27,13,1464,11,1,58,25,9,2,0,1,8,13,0,0,2010,reg
Fredy Montero,Vancouver Whitecaps,F,29,27,2353,10,10,91,34,7,3,6,4,44,60,5,0,2010,reg
Steve Zakuani,FC Dallas,M,29,27,2285,10,6,41,21,6,4,3,3,22,19,4,0,2010,reg
Kei Kamara,Colorado Rapids,F,29,27,2418,10,6,91,33,8,2,3,3,44,49,4,0,2010,reg
Guillermo Barros Schelotto,Columbus Crew SC,F,29,29,2545,9,8,62,27,6,3,5,3,14,53,2,0,2010,reg
Justin Braun,Chivas USA,F,28,24,2118,9,3,62,25,5,4,0,3,25,30,2,0,2010,reg
David Ferreira,FC Dallas,M,30,30,2699,8,13,54,26,4,4,8,5,34,84,4,0,2010,reg
Landon Donovan,LA Galaxy,M-F,24,24,2141,7,16,44,20,5,2,11,5,25,32,3,0,2010,reg
Javier Morales,Real Salt Lake,M,26,25,2163,7,9,42,21,4,3,6,3,35,76,2,0,2010,reg
Marco Pappa,Chicago Fire FC,M,25,23,1961,7,5,57,26,4,3,1,4,20,15,2,0,2010,reg
Danny Mwanga,Philadelphia Union,F,24,17,1461,7,4,27,14,4,3,3,1,16,16,0,0,2010,reg
Brian Ching,Houston Dynamo,F,20,16,1425,7,3,25,9,5,2,2,1,21,27,2,0,2010,reg
Chad Barrett,Toronto FC,F,23,18,1545,7,2,32,16,4,3,2,0,11,12,4,0,2010,reg
Brian McBride,Chicago Fire FC,F,26,18,1604,6,3,36,18,2,4,1,2,10,44,1,0,2010,reg
Marko Perovic,New England Revolution ,M,25,24,2058,6,3,56,21,4,2,2,1,22,26,7,1,2010,reg
Davy Arnaud,Sporting Kansas City ,M,27,27,2342,6,3,58,27,2,4,1,2,38,51,4,3,2010,reg
Fabian Espindola,Real Salt Lake,F,22,19,1514,6,2,39,15,3,3,1,1,26,22,5,0,2010,reg
Steven Lenhart,Columbus Crew SC,F,27,17,1640,6,2,55,21,1,5,1,1,38,35,1,1,2010,reg
Jesus Padilla,Chivas USA,M,26,14,1378,6,0,39,15,2,4,0,0,14,18,3,0,2010,reg
Brad Davis,Houston Dynamo,M,27,25,2163,5,12,54,23,4,1,6,6,28,19,4,0,2010,reg
Robbie Findley,Real Salt Lake,F,24,15,1355,5,4,33,14,3,2,3,1,5,23,0,0,2010,reg
Brek Shea,,D,25,21,1797,5,4,39,19,4,1,2,2,18,13,2,1,2010,reg
Dominic Oduro,Houston Dynamo,M,27,19,1711,5,4,41,19,3,2,3,1,17,22,0,0,2010,reg
Baggio Husidic,Chicago Fire FC,M,22,18,1498,5,3,22,10,4,1,2,1,25,20,2,0,2010,reg
Dane Richards,New York Red Bulls ,M,25,23,2008,5,3,35,14,4,1,1,2,36,25,2,0,2010,reg
Maicon Santos,Chivas USA,F,22,13,1185,5,2,35,16,3,2,1,1,21,9,2,0,2010,reg
Teal Bunbury,New England Revolution,F,26,13,1441,5,2,41,23,2,3,0,2,23,22,3,0,2010,reg
Birahim Diop,Sporting Kansas City ,M,14,7,497,5,1,15,10,5,0,1,0,12,9,0,0,2010,reg
Milton Rodriguez,FC Dallas,F,13,13,835,5,1,23,10,3,2,0,1,7,6,1,0,2010,reg
Emilio Rentería,Columbus Crew SC,F,19,9,857,5,1,30,15,3,2,0,1,18,22,2,0,2010,reg
Andy Najar,LAFC,D,26,22,1983,5,1,36,13,3,2,1,0,25,25,6,0,2010,reg
Blaise Nkufo,FC Dallas,F,11,11,931,5,0,15,11,1,4,0,0,9,16,2,0,2010,reg
Zack Schilawski,New England Revolution ,F,25,15,1261,5,0,17,9,5,0,0,0,13,8,0,0,2010,reg
Danny Allsopp,DC United ,F,23,18,1456,5,0,37,19,4,1,0,0,10,19,2,0,2010,reg
Mehdi Ballouchy,Colorado Rapids,M,27,25,2138,4,6,35,15,1,3,2,4,22,36,4,0,2010,reg
Shalrie Joseph,New England Revolution ,M,22,22,1931,4,5,37,19,2,2,5,0,30,35,4,0,2010,reg
Jovan Kirovski,LA Galaxy,M-F,21,11,932,4,2,20,6,3,1,1,1,20,6,2,0,2010,reg
Atiba Harris,FC Dallas,D,29,28,2473,4,2,53,21,2,2,0,2,51,30,8,0,2010,reg
Fred,Philadelphia Union,M,25,24,1913,4,1,17,8,4,0,0,1,37,37,6,0,2010,reg
Jeff Larentowicz,Atlanta United FC,M,30,29,2617,4,1,41,13,1,3,1,0,31,18,4,0,2010,reg
Ryan Smith,Chivas USA,M,26,25,2104,3,7,46,22,3,0,6,1,15,46,4,0,2010,reg
Joel Lindpere,New York Red Bulls ,M,29,29,2567,3,6,32,13,3,0,3,3,45,44,3,0,2010,reg
Brian Mullan,Colorado Rapids,D,29,22,1951,3,5,29,13,2,1,3,2,29,29,3,0,2010,reg
Eddie Gaven,Columbus Crew SC,M,28,28,2384,3,5,42,18,1,2,2,3,23,54,0,0,2010,reg
Ilija Stolica,New England Revolution ,F,14,13,1049,3,2,18,9,2,1,1,1,10,13,0,0,2010,reg
Sainey Nyassi,New England Revolution ,M,28,27,2297,3,2,39,11,3,0,2,0,33,45,3,0,2010,reg
Ned Grabavoy,Real Salt Lake,M,23,18,1562,3,1,10,6,3,0,1,0,19,28,4,0,2010,reg
Andy Iro,Columbus Crew SC,D,25,24,2117,3,1,14,3,2,1,0,1,19,13,2,0,2010,reg
Blair Gavin,Chivas USA,M,16,16,1369,3,1,15,5,2,1,1,0,7,8,0,0,2010,reg
Cam Weaver,Houston Dynamo,F,14,9,807,3,1,19,6,1,2,0,1,16,13,2,0,2010,reg
Arturo Alvarez,San Jose Earthquakes ,M,19,11,1210,3,1,26,12,1,2,1,0,16,17,3,0,2010,reg
Collins John,Chicago Fire FC,F,17,10,901,3,1,29,14,1,2,1,0,17,12,2,0,2010,reg
Jack McInerney,Philadelphia Union,F,17,1,350,3,0,9,3,0,3,0,0,10,3,1,0,2010,reg
Ike Opara,Minnesota United FC,D,11,10,914,3,0,10,5,2,1,0,0,8,2,1,0,2010,reg
Calen Carr,Chicago Fire FC,F,14,4,538,3,0,12,6,1,2,0,0,7,3,0,0,2010,reg
Jámison Olave,Real Salt Lake,D,27,27,2413,3,0,15,5,3,0,0,0,30,16,8,0,2010,reg
Salou Ibrahim,New York Red Bulls ,F,19,8,747,3,0,22,7,1,2,0,0,26,15,2,0,2010,reg
Abdoulie Mansally,New England Revolution ,D,21,8,928,3,0,23,9,0,3,0,0,20,29,2,0,2010,reg
Geoff Cameron,Houston Dynamo,D,16,15,1321,3,0,27,13,2,1,0,0,15,18,3,1,2010,reg
Freddie Ljungberg,Chicago Fire FC,M-F,30,27,2432,2,10,38,11,0,2,3,7,31,73,7,0,2010,reg
Alejandro Moreno,Philadelphia Union,F,26,25,1974,2,7,18,8,1,1,3,4,28,53,1,0,2010,reg
Kheli Dube,New England Revolution ,F,20,12,1023,2,5,30,17,1,1,4,1,17,12,0,1,2010,reg
O'Brian White,Toronto FC,F,24,9,1065,2,4,19,8,2,0,3,1,14,9,1,0,2010,reg
Eric Alexander,FC Dallas,M,17,12,1054,2,3,15,6,1,1,1,2,6,4,1,0,2010,reg
Pablo Mastroeni,Colorado Rapids,M,29,29,2493,2,3,16,6,0,2,1,2,30,39,5,1,2010,reg
Kyle Beckerman,Real Salt Lake,M,22,21,1830,2,3,17,4,1,1,2,1,25,15,4,0,2010,reg
Josh Wolff,Sporting Kansas City ,F,25,16,1549,2,3,21,12,1,1,1,2,10,23,1,0,2010,reg
Alan Gordon,Chivas USA,F,21,12,1199,2,3,25,12,1,1,3,0,37,18,2,0,2010,reg
Sanna Nyassi,FC Dallas,M,24,14,1241,2,3,29,12,1,1,1,2,25,18,2,0,2010,reg
Thierry Henry,New York Red Bulls ,F,11,11,859,2,3,30,13,2,0,1,2,11,6,1,0,2010,reg
Jason Garey,Columbus Crew SC,F,22,9,784,2,2,14,5,2,0,0,2,9,2,0,0,2010,reg
Marvin Chávez,FC Dallas,M,16,10,818,2,2,14,4,1,1,2,0,16,19,4,0,2010,reg
Tristan Bowen,LA Galaxy,F,17,10,878,2,2,22,11,1,1,1,1,10,9,3,0,2010,reg
Danny Cruz,Houston Dynamo,M-F,25,14,1362,2,2,26,9,2,0,1,1,18,34,3,1,2010,reg
Juninho,LA Galaxy,M,25,25,2006,2,2,30,9,2,0,1,1,37,26,5,0,2010,reg
Santino Quaranta,DC United ,M-F,27,26,2331,2,2,58,24,1,1,1,1,9,30,5,0,2010,reg
Álvaro Fernández,FC Dallas,M,12,4,475,2,1,4,3,1,1,0,1,6,10,0,0,2010,reg
Adrian Serioux,Houston Dynamo,D,13,7,708,2,1,8,4,0,2,1,0,13,6,1,0,2010,reg
David Beckham,LA Galaxy,M,7,5,466,2,1,9,6,1,1,0,1,4,6,2,0,2010,reg
Adam Cristman,DC United ,F,17,8,708,2,1,15,4,1,1,1,0,17,13,2,0,2010,reg
Andre Hainault,Houston Dynamo,D,28,26,2376,2,1,15,4,0,2,1,0,21,10,4,0,2010,reg
Giancarlo Maldonado,Chivas USA,F,10,7,612,2,1,16,4,1,1,1,0,3,6,1,0,2010,reg
Pat Phelan,New England Revolution ,M-D,28,25,2167,2,1,20,8,2,0,0,1,34,20,5,0,2010,reg
Chris Pontius,DC United ,M,17,13,1189,2,1,25,6,0,2,0,1,12,20,1,0,2010,reg
Seth Stammler,New York Red Bulls ,M-D,21,17,1441,2,1,26,6,1,1,1,0,18,9,4,0,2010,reg
Adam Moffat,Columbus Crew SC,M,24,23,1951,2,1,41,17,1,1,1,0,21,18,8,0,2010,reg
Lovel Palmer,Houston Dynamo,D,26,24,2049,2,1,41,13,2,0,0,1,25,17,4,2,2010,reg
Andrés Mendoza,Columbus Crew SC,F,8,1,204,2,0,4,2,1,1,0,0,3,2,0,0,2010,reg
Zak Boggs,New England Revolution ,M,9,4,390,2,0,6,4,0,2,0,0,6,7,0,0,2010,reg
Nat Borchers,Real Salt Lake,D,30,30,2673,2,0,10,4,1,1,0,0,22,13,4,0,2010,reg
Peter Lowry,Chicago Fire FC,M,15,12,1004,2,0,11,4,2,0,0,0,9,4,2,0,2010,reg
Omar Gonzalez,Toronto FC,D,28,28,2520,2,0,13,4,0,2,0,0,22,13,8,0,2010,reg
Michael Orozco Fiscal,Philadelphia Union,D,29,29,2562,2,0,14,5,2,0,0,0,36,18,5,1,2010,reg
Jaime Moreno,DC United ,F,21,8,905,2,0,14,8,1,1,0,0,7,23,1,1,2010,reg
Wells Thompson,Colorado Rapids,D,27,13,1287,2,0,16,8,2,0,0,0,20,23,5,0,2010,reg
Jack Jewsbury,Sporting Kansas City ,M,29,17,1675,2,0,32,15,2,0,0,0,14,25,4,0,2010,reg
Bobby Convey,San Jose Earthquakes ,M,28,28,2472,1,10,18,9,0,1,7,3,35,36,7,0,2010,reg
Patrick Nyarko,Chicago Fire FC,F-M,27,22,2068,1,10,27,12,0,1,6,4,21,41,2,0,2010,reg
Michael Stephens,LA Galaxy,M,25,21,1884,1,8,19,9,0,1,6,2,13,6,4,0,2010,reg
Jamie Smith,Colorado Rapids,M,22,16,1357,1,8,23,10,1,0,5,3,19,15,3,0,2010,reg
Ryan Johnson,San Jose Earthquakes ,F,27,19,1706,1,8,37,18,1,0,5,3,23,24,2,0,2010,reg
Andy Williams,Real Salt Lake,M,30,20,1862,1,7,32,10,1,0,6,1,24,25,5,0,2010,reg
Nick LaBrocca,Toronto FC,M,28,24,2177,1,6,26,9,1,0,1,5,16,14,4,0,2010,reg
Robbie Russell,Real Salt Lake,D,22,21,1915,1,5,9,6,1,0,4,1,8,8,0,0,2010,reg
Justin Mapp,Chicago Fire FC,M,25,16,1407,1,5,17,7,0,1,4,1,16,30,1,0,2010,reg
Mike Chabala,Houston Dynamo,D,25,22,2030,1,4,3,2,0,1,3,1,15,11,5,0,2010,reg
Dan Gargan,Toronto FC,D,27,25,2237,1,4,10,3,1,0,2,2,39,18,7,0,2010,reg
Chris Tierney,New England Revolution ,D-M,27,26,2238,1,4,22,13,1,0,2,2,12,15,0,0,2010,reg
Logan Pause,Chicago Fire FC,M,26,26,2258,1,3,6,1,0,1,1,2,18,22,2,0,2010,reg
James Riley,FC Dallas,D,27,27,2418,1,3,8,2,0,1,1,2,20,21,4,0,2010,reg
Luis Landin,Houston Dynamo,F,9,5,436,1,3,10,2,1,0,3,0,10,11,2,1,2010,reg
Rodolfo Espinoza,Chivas USA,M,15,14,1156,1,3,17,3,1,0,2,1,13,14,3,0,2010,reg
Brad Evans,FC Dallas,D-M,12,11,965,1,3,18,8,1,0,2,1,7,9,1,0,2010,reg
Sacha Kljestan,LA Galaxy,M,10,10,900,1,3,20,8,1,0,0,3,13,15,0,0,2010,reg
Macoumba Kandji,Colorado Rapids,F,20,12,1129,1,3,22,6,0,1,3,0,36,20,1,0,2010,reg
Geovanni Deiberson,San Jose Earthquakes ,F,12,8,777,1,3,25,13,0,1,0,3,12,19,1,0,2010,reg
Tony Tchani,New York Red Bulls ,M,27,17,1610,1,3,25,8,1,0,2,1,43,23,3,0,2010,reg
Osvaldo Alonso,Minnesota United FC,M,23,21,1874,1,3,30,9,1,0,2,1,28,26,4,0,2010,reg
Eddie Robinson,Houston Dynamo,D,23,19,1636,1,2,7,1,1,0,2,0,25,16,3,0,2010,reg
Chad Marshall,Columbus Crew SC,D,24,24,2160,1,2,11,3,0,1,1,1,16,13,0,0,2010,reg
Ramiro Corrales,San Jose Earthquakes ,M,20,18,1677,1,2,12,4,1,0,2,0,17,20,4,0,2010,reg
Nathan Sturgis,FC Dallas,M,20,16,1483,1,2,12,4,0,1,2,0,11,31,1,0,2010,reg
Jacob Peterson,Toronto FC,F,24,15,1267,1,2,18,4,1,0,1,1,6,16,0,0,2010,reg
Dax McCarty,Nashville SC,M,21,18,1604,1,2,18,6,0,1,0,2,17,25,4,0,2010,reg
Brandon McDonald,San Jose Earthquakes ,D,29,28,2429,1,2,19,4,0,1,1,1,22,20,1,1,2010,reg
Danleigh Borman,New York Red Bulls ,D,18,13,1179,1,1,4,2,0,1,0,1,13,4,4,0,2010,reg
Tyrone Marshall,FC Dallas,D,20,14,1419,1,1,4,3,0,1,0,1,16,12,5,0,2010,reg
Leonardo González,FC Dallas,D,27,27,2347,1,1,5,2,1,0,1,0,40,13,6,1,2010,reg
Nelson González,Real Salt Lake,M,12,3,330,1,1,5,3,1,0,1,0,12,4,1,0,2010,reg
Abdus Ibrahim,Toronto FC,F,8,3,262,1,1,6,2,1,0,1,0,5,3,0,0,2010,reg
Todd Dunivant,LA Galaxy,D,27,27,2409,1,1,7,4,0,1,1,0,19,20,2,0,2010,reg
Steven Kinney,Chicago Fire FC,D,13,10,963,1,1,8,3,0,1,1,0,8,7,2,0,2010,reg
Jordan Harvey,LAFC,D,30,29,2620,1,1,9,3,0,1,0,1,28,16,3,0,2010,reg
Bobby Burling,San Jose Earthquakes ,D,18,16,1410,1,1,9,3,1,0,0,1,18,9,5,0,2010,reg
Alex Cazumba,LA Galaxy,M,18,8,830,1,1,10,3,1,0,1,0,10,18,1,0,2010,reg
Sinisa Ubiparipovic,New York Red Bulls ,F-M,18,11,932,1,1,11,4,1,0,0,1,14,22,0,0,2010,reg
Pat Noonan,FC Dallas,F,12,8,682,1,1,11,3,0,1,1,0,4,5,0,0,2010,reg
Joey Gjertsen,San Jose Earthquakes ,M,18,16,1220,1,1,12,5,1,0,1,0,6,8,0,0,2010,reg
Eric Avila,FC Dallas,M,18,1,452,1,1,14,7,1,0,1,0,8,5,0,0,2010,reg
Rafa Márquez,New York Red Bulls ,M,10,10,783,1,1,17,5,0,1,1,0,11,11,2,0,2010,reg
Khari Stephenson,San Jose Earthquakes ,M,11,11,776,1,1,18,6,0,1,1,0,12,10,1,0,2010,reg
Mike Magee,LA Galaxy,M,16,9,789,1,1,19,8,0,1,1,0,10,9,2,0,2010,reg
Will Johnson,Real Salt Lake,D,28,24,2184,1,1,40,12,1,0,1,0,23,25,3,0,2010,reg
Carl Robinson,New York Red Bulls ,M,10,3,365,1,0,1,1,0,1,0,0,8,3,0,0,2010,reg
A.J. DeLaGarza,,D,17,14,1307,1,0,1,1,1,0,0,0,14,13,3,0,2010,reg
Carlos Borja,Chivas USA,D,8,4,456,1,0,2,2,1,0,0,0,9,0,3,0,2010,reg
Leandre Griffit,Columbus Crew SC,M,3,0,43,1,0,2,2,1,0,0,0,0,1,0,0,2010,reg
Julio Martinez,Chicago Fire FC,M,3,2,108,1,0,2,1,0,1,0,0,2,1,0,0,2010,reg
Samuel Appiah,Houston Dynamo,M,2,0,37,1,0,2,1,1,0,0,0,1,0,0,0,2010,reg
Mike Fucito,FC Dallas,F,4,0,47,1,0,3,1,1,0,0,0,2,1,0,0,2010,reg
Steven Beitashour,San Jose Earthquakes ,D,8,7,640,1,0,4,3,0,1,0,0,9,2,0,0,2010,reg
John Thorrington,Chicago Fire FC,M,5,5,397,1,0,4,2,0,1,0,0,4,6,1,0,2010,reg
Nana Attakora,Toronto FC,D,25,24,2108,1,0,5,1,1,0,0,0,19,15,3,1,2010,reg
Eric Brunner,Columbus Crew SC,D,14,13,1145,1,0,6,2,1,0,0,0,6,8,2,0,2010,reg
Wilman Conde,Chicago Fire FC,D,25,22,2019,1,0,6,2,0,1,0,0,41,14,10,1,2010,reg
Carey Talley,DC United ,D,16,14,1181,1,0,6,2,1,0,0,0,15,7,3,0,2010,reg
Maykel Galindo,Chivas USA,F,6,4,343,1,0,6,4,0,1,0,0,2,3,0,0,2010,reg
Brian Carroll,Columbus Crew SC,M,28,27,2390,1,0,7,3,1,0,0,0,28,9,3,0,2010,reg
Jorge Villafaña,Portland Timbers,F,8,6,452,1,0,7,3,1,0,0,0,1,9,1,0,2010,reg
Tim Ream,New York Red Bulls ,D,30,30,2700,1,0,7,4,1,0,0,0,13,6,2,0,2010,reg
Roger Levesque,FC Dallas,M,16,5,510,1,0,8,5,0,1,0,0,8,8,0,0,2010,reg
Ugo Ihemelu,FC Dallas,D,19,18,1558,1,0,8,3,0,1,0,0,14,15,3,0,2010,reg
Jimmy Conrad,Sporting Kansas City ,D,26,26,2282,1,0,8,3,0,1,0,0,16,12,6,0,2010,reg
Joseph Ngwenya,Houston Dynamo,F,12,6,589,1,0,8,2,1,0,0,0,14,17,1,2,2010,reg
Dema Kovalenko,LA Galaxy,M,9,8,712,1,0,8,6,1,0,0,0,18,16,1,0,2010,reg
Chris Wingert,Real Salt Lake,D,24,22,1985,1,0,9,2,0,1,0,0,26,15,4,0,2010,reg
Quincy Amarikwa,Colorado Rapids,F,14,2,245,1,0,9,3,1,0,0,0,13,6,0,0,2010,reg
Chukwudi Chijindu,Chivas USA,M,12,2,308,1,0,9,3,1,0,0,0,8,7,0,0,2010,reg
William Romero,Chivas USA,M,9,5,421,1,0,9,3,1,0,0,0,11,9,3,0,2010,reg
Shea Salinas,San Jose Earthquakes,M,17,7,795,1,0,11,7,0,1,0,0,8,11,0,0,2010,reg
Julius James,DC United ,D,22,16,1682,1,0,12,3,0,1,0,0,38,16,7,0,2010,reg
Drew Moor,Colorado Rapids,D,30,30,2700,1,0,14,7,1,0,0,0,14,22,2,0,2010,reg
Mike Banner,Chicago Fire FC,M,18,9,1019,1,0,14,6,0,1,0,0,4,8,1,0,2010,reg
Graham Zusi,Sporting Kansas City,M,19,4,540,1,0,15,5,1,0,0,0,11,6,2,0,2010,reg
Paulo Nagamura,Chivas USA,M,15,15,1327,1,0,21,8,1,0,0,0,22,23,3,0,2010,reg
Cornell Glen,San Jose Earthquakes ,F,21,10,947,1,0,32,10,0,1,0,0,17,17,1,0,2010,reg
Robbie Rogers,Columbus Crew SC,D,20,17,1547,1,0,40,9,1,0,0,0,17,31,1,0,2010,reg
Sean Franklin,LA Galaxy,D,25,24,2126,0,6,9,2,0,0,5,1,14,9,1,0,2010,reg
Roger Torres,Philadelphia Union,M,21,10,958,0,6,19,11,0,0,2,4,16,11,4,0,2010,reg
Heath Pearce,FC Dallas,D,28,27,2414,0,6,31,2,0,0,4,2,21,9,5,0,2010,reg
Michael Harrington,Sporting Kansas City ,D,29,29,2560,0,4,3,2,0,0,2,2,21,18,3,0,2010,reg
Richard Mulrooney,Houston Dynamo,M,23,19,1671,0,3,2,0,0,0,3,0,7,12,1,0,2010,reg
Nicholas Lindsay,Toronto FC,F,4,2,240,0,3,3,1,0,0,1,2,5,3,1,0,2010,reg
Mariano Trujillo,Chivas USA,D,28,28,2517,0,3,5,1,0,0,2,1,35,16,7,1,2010,reg
Kosuke Kimura,Colorado Rapids,D,23,21,1931,0,3,6,2,0,0,2,1,8,19,0,0,2010,reg
Michael Lahoud,Chivas USA,M,23,20,1684,0,3,8,2,0,0,2,1,18,16,1,0,2010,reg
Nate Jaqua,FC Dallas,F,15,3,409,0,3,9,5,0,0,0,3,6,7,2,0,2010,reg
Craig Rocastle,Sporting Kansas City ,M,23,18,1470,0,3,10,1,0,0,2,1,27,31,4,1,2010,reg
Corey Ashe,Houston Dynamo,M,27,19,1650,0,3,12,4,0,0,3,0,6,33,0,0,2010,reg
Chris Klein,LA Galaxy,M,11,3,303,0,2,1,0,0,0,0,2,5,2,0,0,2010,reg
Rodney Wallace,DC United ,D,11,11,924,0,2,4,1,0,0,2,0,11,11,2,0,2010,reg
Chris Albright,New York Red Bulls ,D,18,18,1585,0,2,7,2,0,0,2,0,13,5,3,0,2010,reg
Frankie Hejduk,Columbus Crew SC,D,20,20,1736,0,2,8,4,0,0,0,2,25,24,4,1,2010,reg
Jair Benítez,FC Dallas,D,28,28,2424,0,2,8,1,0,0,2,0,22,35,3,1,2010,reg
Roy Miller,New York Red Bulls ,D,25,21,1948,0,2,9,3,0,0,0,2,29,6,5,1,2010,reg
Julian de Guzman,Toronto FC,M,25,21,2014,0,2,16,5,0,0,2,0,37,40,8,1,2010,reg
Jonathan Bornstein,Chicago Fire FC,D,21,17,1673,0,2,16,7,0,0,2,0,10,11,0,0,2010,reg
Chris Birchall,LA Galaxy,M,25,23,1973,0,2,31,8,0,0,1,1,28,13,5,0,2010,reg
Jason Hernandez,San Jose Earthquakes ,D,27,27,2412,0,1,0,0,0,0,0,1,5,7,2,1,2010,reg
Carlos Mendes,New York Red Bulls ,D,21,20,1785,0,1,0,0,0,0,1,0,22,4,5,1,2010,reg
Tyson Wahl,FC Dallas,D,4,2,241,0,1,1,0,0,0,1,0,5,3,0,0,2010,reg
Anthony Wallace,Colorado Rapids,D,9,7,571,0,1,2,1,0,0,1,0,6,3,3,0,2010,reg
Jonathan Leathers,Sporting Kansas City ,D,8,3,356,0,1,2,1,0,0,1,0,1,1,0,0,2010,reg
Bobby Boswell,Houston Dynamo,D,26,26,2277,0,1,2,0,0,0,0,1,16,5,5,1,2010,reg
Ante Jazic,Chivas USA,D,21,21,1771,0,1,3,0,0,0,1,0,8,10,3,0,2010,reg
Nick Garcia,Toronto FC,D,23,20,1811,0,1,3,1,0,0,0,1,18,10,2,1,2010,reg
Tony Beltran,Real Salt Lake,D,18,17,1493,0,1,3,1,0,0,1,0,12,12,1,0,2010,reg
Jeremy Hall,New York Red Bulls ,D-M,13,9,895,0,1,3,1,0,0,1,0,17,7,3,0,2010,reg
Shaun Francis,Columbus Crew SC,D,12,10,993,0,1,3,0,0,0,0,1,19,3,3,0,2010,reg
Sal Zizzo,Chivas USA,D,10,1,254,0,1,4,2,0,0,1,0,1,8,0,0,2010,reg
André Luiz,San Jose Earthquakes ,M,9,9,701,0,1,4,2,0,0,1,0,9,14,1,0,2010,reg
Dasan Robinson,Chicago Fire FC,D,17,17,1369,0,1,4,0,0,0,0,1,16,18,2,0,2010,reg
Danny O'Rourke,Columbus Crew SC,D,17,14,1276,0,1,5,0,0,0,0,1,18,9,2,2,2010,reg
Tim Ward,Chicago Fire FC,D,19,18,1638,0,1,5,3,0,0,0,1,10,9,1,0,2010,reg
Emmanuel Osei,New England Revolution ,D,21,18,1716,0,1,5,0,0,0,0,1,18,13,3,0,2010,reg
Marcelo Saragosa,Chivas USA,M,14,9,823,0,1,5,2,0,0,1,0,17,9,2,0,2010,reg
Jeff Parke,FC Dallas,D,20,20,1682,0,1,6,0,0,0,1,0,15,18,3,0,2010,reg
Eduardo da Silva,San Jose Earthquakes ,F,8,2,303,0,1,6,1,0,0,1,0,4,10,1,0,2010,reg
Mike Seamon,FC Dallas,M-F,8,3,314,0,1,6,2,0,0,1,0,0,7,0,0,2010,reg
Niouky Desire,New England Revolution ,M,13,11,1068,0,1,6,0,0,0,1,0,32,9,5,1,2010,reg
Dario Delgado,Chivas USA,D,22,21,1865,0,1,7,3,0,0,1,0,26,17,2,0,2010,reg
Jackson Goncalves,FC Dallas,M,12,9,805,0,1,7,3,0,0,0,1,10,4,0,0,2010,reg
Scott Sealy,San Jose Earthquakes ,F,15,5,520,0,1,7,2,0,0,1,0,7,9,0,0,2010,reg
Danny Califf,Philadelphia Union,D,28,28,2464,0,1,7,2,0,0,1,0,29,14,3,1,2010,reg
Stéphane Auvray,Sporting Kansas City ,M,21,21,1681,0,1,7,0,0,0,1,0,24,17,2,0,2010,reg
Sam Cronin,San Jose Earthquakes ,M,23,20,1754,0,1,8,2,0,0,1,0,19,14,2,1,2010,reg
Krzysztof Krol,Chicago Fire FC,D,19,17,1565,0,1,9,1,0,0,0,1,13,12,2,1,2010,reg
Pablo Campos,Real Salt Lake,F,16,3,434,0,1,12,4,0,0,1,0,15,7,2,0,2010,reg
Miguel Ferrer,Toronto FC,F,9,5,544,0,1,13,3,0,0,1,0,5,1,1,0,2010,reg
Khano Smith,New England Revolution ,M,16,6,772,0,1,13,5,0,0,0,1,12,10,1,0,2010,reg
Kevin Alston,New England Revolution ,D,22,22,1826,0,1,14,3,0,0,1,0,14,27,1,0,2010,reg
Roger Espinoza,Sporting Kansas City,M,25,25,2192,0,1,15,4,0,0,0,1,42,30,5,0,2010,reg
Ben Zemanski,Chivas USA,M,22,17,1543,0,1,16,3,0,0,1,0,27,8,3,0,2010,reg
Stephen King,DC United ,M,20,16,1415,0,1,17,7,0,0,0,1,7,14,1,0,2010,reg
Pablo Hernandez,DC United ,F,14,13,1149,0,1,29,16,0,0,1,0,29,36,2,0,2010,reg
Michael Holody,Colorado Rapids,D,0,0,0,0,0,0,0,0,0,0,0,0,0,0,0,2010,reg
Ross Schunk,Colorado Rapids,F,0,0,0,0,0,0,0,0,0,0,0,0,0,0,0,2010,reg
Kyle Davies,FC Dallas,D,3,2,166,0,0,0,0,0,0,0,0,3,2,0,0,2010,reg
Michael Videira,New England Revolution ,M,0,0,0,0,0,0,0,0,0,0,0,0,0,0,0,2010,reg
Peri Marosevic,FC Dallas,F,0,0,0,0,0,0,0,0,0,0,0,0,0,0,0,2010,reg
Ciaran O'Brien,Colorado Rapids,M,0,0,0,0,0,0,0,0,0,0,0,0,0,0,0,2010,reg
Rauwshan McKenzie,Real Salt Lake,D,4,2,224,0,0,0,0,0,0,0,0,3,3,1,0,2010,reg
Ali Gerba,Toronto FC,F,0,0,0,0,0,0,0,0,0,0,0,0,0,0,0,2010,reg
Mauricio Castro,New England Revolution ,M,0,0,0,0,0,0,0,0,0,0,0,0,0,0,0,2010,reg
Rob Valentino,Colorado Rapids,D,0,0,0,0,0,0,0,0,0,0,0,0,0,0,0,2010,reg
Alex Nimo,Real Salt Lake,F-M,0,0,0,0,0,0,0,0,0,0,0,0,0,0,0,2010,reg
David Horst,Real Salt Lake,D,0,0,0,0,0,0,0,0,0,0,0,0,0,0,0,2010,reg
Luke Sassano,New York Red Bulls ,D,3,2,120,0,0,0,0,0,0,0,0,1,0,0,1,2010,reg
Taylor Graham,FC Dallas,D,1,0,1,0,0,0,0,0,0,0,0,0,0,0,0,2010,reg
Kevin Goldthwaite,New York Red Bulls ,D,0,0,0,0,0,0,0,0,0,0,0,0,0,0,0,2010,reg
Nico Colaluca,New England Revolution ,M,1,0,14,0,0,0,0,0,0,0,0,1,0,0,0,2010,reg
Alex Zotinca,Chivas USA,D,1,1,45,0,0,0,0,0,0,0,0,1,0,0,0,2010,reg
Sergio Herrera,Columbus Crew SC,F,1,0,1,0,0,0,0,0,0,0,0,0,0,0,0,2010,reg
Andrew Boyens,New York Red Bulls ,D,0,0,0,0,0,0,0,0,0,0,0,0,0,0,0,2010,reg
Aaron Hohlbein,Sporting Kansas City ,D,2,1,111,0,0,0,0,0,0,0,0,2,0,0,0,2010,reg
Nick Kounenakis ,Sporting Kansas City ,D,0,0,0,0,0,0,0,0,0,0,0,0,0,0,0,2010,reg
Anthony Obodai,Houston Dynamo,M,4,4,210,0,0,0,0,0,0,0,0,3,5,1,0,2010,reg
Clint Mathis,LA Galaxy,M,9,0,182,0,0,0,0,0,0,0,0,1,2,0,0,2010,reg
Jim Brennan,Toronto FC,D,1,1,90,0,0,0,0,0,0,0,0,1,1,0,0,2010,reg
Gino Padula,Columbus Crew SC,D,15,13,1001,0,0,0,0,0,0,0,0,9,6,2,0,2010,reg
Juan Pena,DC United ,D,10,9,700,0,0,0,0,0,0,0,0,12,4,2,0,2010,reg
Bryan Namoff,DC United ,D,0,0,0,0,0,0,0,0,0,0,0,0,0,0,0,2010,reg
Steve Ralston,New England Revolution ,M,0,0,0,0,0,0,0,0,0,0,0,0,0,0,0,2010,reg
Duncan Oughton,Columbus Crew SC,D,3,0,41,0,0,0,0,0,0,0,0,0,0,0,0,2010,reg
Taylor Twellman,New England Revolution ,F,0,0,0,0,0,0,0,0,0,0,0,0,0,0,0,2010,reg
Lyle Adams,DC United ,D,0,0,0,0,0,0,0,0,0,0,0,0,0,0,0,2010,reg
Francisco Navas Cobo,Houston Dynamo,M,1,0,1,0,0,0,0,0,0,0,0,0,0,0,0,2010,reg
Luis Gil,Real Salt Lake,M,0,0,0,0,0,0,0,0,0,0,0,0,0,0,0,2010,reg
Othaniel Yanez,Columbus Crew SC,M,0,0,0,0,0,0,0,0,0,0,0,0,0,0,0,2010,reg
Giorgi Chirgadze,New York Red Bulls ,F,0,0,0,0,0,0,0,0,0,0,0,0,0,0,0,2010,reg
Austin da Luz,New York Red Bulls ,M,0,0,0,0,0,0,0,0,0,0,0,0,0,0,0,2010,reg
Irving Garcia,New York Red Bulls ,M,0,0,0,0,0,0,0,0,0,0,0,0,0,0,0,2010,reg
Oscar Murillo,Colorado Rapids,D,0,0,0,0,0,0,0,0,0,0,0,0,0,0,0,2010,reg
Sunil Chhetri,Sporting Kansas City ,F,0,0,0,0,0,0,0,0,0,0,0,0,0,0,0,2010,reg
Igor Kostrov,Sporting Kansas City ,M,0,0,0,0,0,0,0,0,0,0,0,0,0,0,0,2010,reg
Bryan Leyva,FC Dallas,M,1,0,13,0,0,0,0,0,0,0,0,0,0,0,0,2010,reg
Andrew Wiedeman,FC Dallas,F,0,0,0,0,0,0,0,0,0,0,0,0,0,0,0,2010,reg
Chris Schuler,Real Salt Lake,D,1,1,90,0,0,0,0,0,0,0,0,1,1,0,0,2010,reg
José Macotelo,Chivas USA,M-F,3,0,65,0,0,0,0,0,0,0,0,0,0,0,0,2010,reg
Zac Herold,Toronto FC,D,0,0,0,0,0,0,0,0,0,0,0,0,0,0,0,2010,reg
Cesar Zamora,Chivas USA,M,0,0,0,0,0,0,0,0,0,0,0,0,0,0,0,2010,reg
Junior Carreiro,DC United ,M,3,0,43,0,0,0,0,0,0,0,0,0,2,0,0,2010,reg
J.T. Noone,Philadelphia Union,M,0,0,0,0,0,0,0,0,0,0,0,0,0,0,0,2010,reg
John Rodrigues,DC United ,D,1,0,12,0,0,0,0,0,0,0,0,2,1,0,0,2010,reg
Bryan de la Fuente,Chivas USA,F,1,0,5,0,0,0,0,0,0,0,0,0,0,0,0,2010,reg
Josh Williams,Columbus Crew SC,D,0,0,0,0,0,0,0,0,0,0,0,0,0,0,0,2010,reg
Davy Armstrong,Colorado Rapids,M,0,0,0,0,0,0,0,0,0,0,0,0,0,0,0,2010,reg
Victor Pineda,Chicago Fire FC,M,0,0,0,0,0,0,0,0,0,0,0,0,0,0,0,2010,reg
Conor Shanosky,DC United ,M-D,0,0,0,0,0,0,0,0,0,0,0,0,0,0,0,2010,reg
Jamar Beasley,Sporting Kansas City ,M,0,0,0,0,0,0,0,0,0,0,0,0,0,0,0,2010,reg
Roberto Linck,New England Revolution ,F-M,2,0,16,0,0,0,0,0,0,0,0,0,0,0,0,2010,reg
Juan Diego González,Philadelphia Union,D,7,7,630,0,0,0,0,0,0,0,0,7,4,0,0,2010,reg
Doneil Henry,Toronto FC,D,1,0,1,0,0,0,0,0,0,0,0,0,0,0,0,2010,reg
Raivis Hscanovics,Toronto FC,D,11,10,753,0,0,0,0,0,0,0,0,10,7,2,0,2010,reg
Zoltan Hercegfalvi,Sporting Kansas City ,F,0,0,0,0,0,0,0,0,0,0,0,0,0,0,0,2010,reg
Tiyiselani Shipalane,DC United ,M,0,0,0,0,0,0,0,0,0,0,0,0,0,0,0,2010,reg
David Myrie,Philadelphia Union,D,1,1,78,0,0,0,0,0,0,0,0,2,2,1,0,2010,reg
Jhon Kennedy Hurtado,FC Dallas,D,9,9,810,0,0,0,0,0,0,0,0,10,6,1,0,2010,reg
Zach Scott,FC Dallas,D,4,4,360,0,0,0,0,0,0,0,0,4,4,2,0,2010,reg
Emmanuel Gomez,Toronto FC,D,0,0,0,0,0,0,0,0,0,0,0,0,0,0,0,2010,reg
Eduardo Lillingston,Chivas USA,F,0,0,0,0,0,0,0,0,0,0,0,0,0,0,0,2010,reg
Darrius Barnes,New England Revolution ,D,21,20,1800,0,0,0,0,0,0,0,0,8,6,3,0,2010,reg
Yohance Marshall,LA Galaxy,D,2,2,180,0,0,0,0,0,0,0,0,5,1,2,0,2010,reg
Maksim Usanov,Toronto FC,D,14,13,1045,0,0,0,0,0,0,0,0,27,8,5,1,2010,reg
Edson Edward,FC Dallas,D,1,0,5,0,0,0,0,0,0,0,0,0,0,0,0,2010,reg
Korede Aiyegbusi,Sporting Kansas City ,D,5,1,129,0,0,0,0,0,0,0,0,3,1,0,0,2010,reg
Toni Stahl,Philadelphia Union,M,1,1,41,0,0,0,0,0,0,0,0,1,1,1,1,2010,reg
Ross LaBauex,Colorado Rapids,M,5,1,76,0,0,0,0,0,0,0,0,1,5,1,0,2010,reg
Dilly Duka,Columbus Crew SC,M,3,2,160,0,0,1,1,0,0,0,0,3,2,1,0,2010,reg
David Estrada,FC Dallas,M-F,3,1,88,0,0,1,1,0,0,0,0,0,1,0,0,2010,reg
Conor Chinn,New York Red Bulls ,F,5,0,29,0,0,1,1,0,0,0,0,0,1,0,0,2010,reg
Jason Yeisley,FC Dallas,F,5,0,39,0,0,1,0,0,0,0,0,0,1,0,0,2010,reg
Zach Loyd,FC Dallas,D,24,19,1769,0,0,1,0,0,0,0,0,19,11,2,0,2010,reg
Yamith Cuesta,Chivas USA,D,6,3,290,0,0,1,1,0,0,0,0,9,1,1,0,2010,reg
Juan Agudelo,,F,2,0,14,0,0,1,1,0,0,0,0,1,0,0,0,2010,reg
Andre Akpan,Colorado Rapids,F,1,0,13,0,0,1,1,0,0,0,0,0,0,0,0,2010,reg
Justin Morrow,Toronto FC,D,3,0,59,0,0,1,0,0,0,0,0,1,0,0,0,2010,reg
Bratislav Ristic,Chicago Fire FC,M,8,8,692,0,0,1,1,0,0,0,0,17,9,0,0,2010,reg
Carlos Varela,DC United ,M,6,1,173,0,0,1,0,0,0,0,0,5,2,0,0,2010,reg
Eduardo Coudet,Philadelphia Union,M,9,9,631,0,0,1,0,0,0,0,0,6,5,0,0,2010,reg
C.J. Brown,Chicago Fire FC,D,26,26,2340,0,0,1,0,0,0,0,0,12,8,2,0,2010,reg
Chris Leitch,San Jose Earthquakes ,D,15,15,1225,0,0,1,0,0,0,0,0,10,4,1,1,2010,reg
Peter Vagenas,FC Dallas,M,7,7,542,0,0,1,1,0,0,0,0,7,11,0,0,2010,reg
Mike Petke,New York Red Bulls ,D,16,11,1047,0,0,1,0,0,0,0,0,11,7,5,0,2010,reg
Gonzalo Segares,Chicago Fire FC,D,6,6,439,0,0,1,0,0,0,0,0,10,5,0,1,2010,reg
Ramon Sanchez,San Jose Earthquakes ,M,3,1,83,0,0,1,1,0,0,0,0,0,0,0,0,2010,reg
Luciano Emilio,DC United ,F,4,1,157,0,0,1,1,0,0,0,0,1,0,0,0,2010,reg
Gabe Gala,Toronto FC,M,10,1,217,0,0,1,0,0,0,0,0,4,0,0,0,2010,reg
Ryan Cochrane,Houston Dynamo,D,12,5,569,0,0,1,0,0,0,0,0,7,3,2,0,2010,reg
Craig Waibel,Houston Dynamo,D,4,3,225,0,0,1,0,0,0,0,0,2,1,0,0,2010,reg
Bryan Jordan,LA Galaxy,D,8,2,268,0,0,1,0,0,0,0,0,6,2,1,0,2010,reg
Bruno Guarda,FC Dallas,M,9,2,233,0,0,1,0,0,0,0,0,9,3,1,0,2010,reg
Santiago Hirsig,Sporting Kansas City ,M,1,1,45,0,0,1,0,0,0,0,0,3,2,0,0,2010,reg
Deris Umanzor,Chicago Fire FC,D,10,5,502,0,0,2,2,0,0,0,0,6,4,0,0,2010,reg
Michael Umaña,Chivas USA,D,28,28,2483,0,0,2,1,0,0,0,0,26,13,6,0,2010,reg
Jed Zayner,Columbus Crew SC,D,17,12,1187,0,0,2,0,0,0,0,0,21,10,4,0,2010,reg
Kevin Burns,Columbus Crew SC,M,9,4,433,0,0,2,1,0,0,0,0,6,5,1,0,2010,reg
Marc Burch,DC United ,D,4,4,360,0,0,2,1,0,0,0,0,7,4,1,0,2010,reg
Edgaras Jankauskas,New England Revolution ,F,4,0,147,0,0,2,1,0,0,0,0,5,2,1,0,2010,reg
Omar Jasseh,San Jose Earthquakes ,M,4,0,76,0,0,2,1,0,0,0,0,3,5,1,0,2010,reg
Barry Rice,DC United ,D,2,1,86,0,0,2,0,0,0,0,0,1,1,0,0,2010,reg
Ruben Luna,FC Dallas,F,4,0,48,0,0,2,0,0,0,0,0,4,1,0,0,2010,reg
Scott Palguta,Colorado Rapids,D,16,5,560,0,0,2,0,0,0,0,0,2,2,2,0,2010,reg
Corben Bone,Chicago Fire FC,M,5,1,114,0,0,2,1,0,0,0,0,0,0,0,0,2010,reg
Javier Robles,San Jose Earthquakes ,M,2,1,61,0,0,2,2,0,0,0,0,1,1,0,0,2010,reg
Kwame Watson-Siriboe,Chicago Fire FC,D,10,7,681,0,0,3,1,0,0,0,0,6,3,0,0,2010,reg
Stefan Dimitrov,Chicago Fire FC,F,5,1,67,0,0,3,0,0,0,0,0,0,1,0,0,2010,reg
Dejan Jakovic,LAFC,D,19,18,1624,0,0,3,1,0,0,0,0,14,10,1,1,2010,reg
Amadou Sanyang,Toronto FC,D,13,12,898,0,0,3,0,0,0,0,0,14,14,2,1,2010,reg
Amobi Okugo,Philadelphia Union,D-M,11,4,437,0,0,3,1,0,0,0,0,14,1,0,0,2010,reg
Paulo Jr.,Real Salt Lake,F,3,0,65,0,0,3,1,0,0,0,0,0,1,0,0,2010,reg
Gregg Berhalter,LA Galaxy,D,16,16,1399,0,0,3,0,0,0,0,0,22,10,1,0,2010,reg
Thabiso Khumalo,DC United ,F,8,3,270,0,0,3,2,0,0,0,0,7,4,0,0,2010,reg
Nick Zimmerman,Philadelphia Union,M,8,1,159,0,0,3,0,0,0,0,0,0,3,0,0,2010,reg
Jean-Marc Alexandre,Real Salt Lake,F,15,5,494,0,0,4,3,0,0,0,0,15,1,2,0,2010,reg
Matt Besler,Sporting Kansas City,D,12,10,1016,0,0,4,3,0,0,0,0,13,4,2,0,2010,reg
George John,FC Dallas,D,25,25,2138,0,0,4,1,0,0,0,0,21,10,3,0,2010,reg
Brian Nielsen,New York Red Bulls ,M,2,1,105,0,0,4,2,0,0,0,0,1,0,0,0,2010,reg
Brandon Barklage,DC United ,D,3,2,205,0,0,4,1,0,0,0,0,3,2,1,0,2010,reg
Ty Harden,Toronto FC,D,12,10,975,0,0,4,1,0,0,0,0,10,5,0,0,2010,reg
John Wolyniec,New York Red Bulls ,F,4,2,190,0,0,4,1,0,0,0,0,2,7,0,0,2010,reg
Devon McTavish,DC United ,D,19,16,1405,0,0,4,1,0,0,0,0,17,11,1,0,2010,reg
Jason Griffiths,New England Revolution ,M,10,4,377,0,0,4,1,0,0,0,0,5,2,1,0,2010,reg
Miguel Montaño,FC Dallas,F,6,1,161,0,0,4,0,0,0,0,0,3,7,0,1,2010,reg
Sheanon Williams,Philadelphia Union,D-M,8,8,720,0,0,4,3,0,0,0,0,12,7,0,0,2010,reg
Leonardo,LA Galaxy,D,10,10,855,0,0,4,1,0,0,0,0,11,8,0,0,2010,reg
Danny Earls,Colorado Rapids,D,18,15,1413,0,0,5,2,0,0,0,0,8,8,2,0,2010,reg
Jordan Graye,DC United ,D,20,20,1662,0,0,5,3,0,0,0,0,10,14,1,0,2010,reg
Marvell Wynne,Colorado Rapids,D,27,27,2383,0,0,5,1,0,0,0,0,17,16,3,0,2010,reg
Adrian Cann,Toronto FC,D,26,26,2340,0,0,5,3,0,0,0,0,24,13,5,0,2010,reg
Eddie Lewis,LA Galaxy,M,13,1,250,0,0,6,1,0,0,0,0,2,5,0,1,2010,reg
Collen Warner,Colorado Rapids,M,13,4,426,0,0,6,2,0,0,0,0,4,6,2,0,2010,reg
Pablo Escobar,Sporting Kansas City ,D,7,7,529,0,0,6,2,0,0,0,0,4,0,1,0,2010,reg
Seth Sinovic,New England Revolution,D,20,18,1580,0,0,7,1,0,0,0,0,13,10,3,0,2010,reg
Cory Gibbs,New England Revolution ,D,25,25,2179,0,0,7,1,0,0,0,0,22,15,5,1,2010,reg
Brad Ring,San Jose Earthquakes ,D,11,4,435,0,0,7,1,0,0,0,0,3,7,0,0,2010,reg
Claudio Lopez,Colorado Rapids,F,11,0,200,0,0,8,4,0,0,0,0,0,1,0,0,2010,reg
Cristian Arrieta,Philadelphia Union,D,16,15,1343,0,0,8,3,0,0,0,0,16,10,5,0,2010,reg
Diego Saric,Toronto FC,M,17,15,1153,0,0,8,3,0,0,0,0,32,9,6,1,2010,reg
Joseph Nane,Toronto FC,M,11,8,614,0,0,8,1,0,0,0,0,8,8,0,0,2010,reg
Nery Castillo,Chicago Fire FC,F,8,6,487,0,0,9,5,0,0,0,0,1,5,1,0,2010,reg
Chance Myers,Sporting Kansas City ,D,15,6,568,0,0,9,4,0,0,0,0,9,3,0,0,2010,reg
Shavar Thomas,Sporting Kansas City ,D,17,16,1432,0,0,9,2,0,0,0,0,10,2,1,0,2010,reg
Julien Baudet,Colorado Rapids,D,18,14,1154,0,0,11,0,0,0,0,0,11,7,2,1,2010,reg
Kurt Morsink,DC United ,M,20,18,1558,0,0,11,4,0,0,0,0,20,24,5,0,2010,reg
Clyde Simms,DC United ,M,20,18,1508,0,0,12,6,0,0,0,0,13,5,0,0,2010,reg
Colin Clark,Colorado Rapids,M,16,9,866,0,0,12,3,0,0,0,0,7,10,2,0,2010,reg
Stefani Miglioranzi,Philadelphia Union,M,26,25,2097,0,0,14,5,0,0,0,0,31,16,4,1,2010,reg
Christian Castillo,DC United ,M,10,8,691,0,0,14,4,0,0,0,0,9,12,2,0,2010,reg
Patrick Ianni,FC Dallas,D-M,25,24,2096,0,0,15,1,0,0,0,0,22,11,2,0,2010,reg
Emmanuel Ekpo,Columbus Crew SC,M,24,13,1178,0,0,16,3,0,0,0,0,15,23,1,0,2010,reg
Daniel Hernandez,FC Dallas,M,24,24,2098,0,0,16,7,0,0,0,0,49,27,6,0,2010,reg
Kyle Nakazawa,Philadelphia Union,M,14,8,798,0,0,17,8,0,0,0,0,11,3,2,0,2010,reg
Andrew Jacobson,Philadelphia Union,M,25,13,1294,0,0,18,8,0,0,0,0,29,14,3,0,2010,reg
Branko Boskovic,DC United ,M,13,8,771,0,0,20,7,0,0,0,0,7,8,1,0,2010,reg
Dwayne De Rosario,DC United ,M,33,31,2781,16,12,112,44,10,6,8,4,57,46,3,0,2011,reg
Chris Wondolowski,San Jose Earthquakes,F,30,30,2672,16,3,109,52,7,9,3,0,29,24,3,0,2011,reg
Thierry Henry,New York Red Bulls ,F,26,26,2266,14,4,65,30,8,6,2,2,28,27,3,2,2011,reg
Andrés Mendoza,Columbus Crew SC,F,29,25,2022,13,2,74,31,10,3,2,0,19,14,1,0,2011,reg
Fredy Montero,Vancouver Whitecaps,F,30,27,2304,12,9,108,42,3,9,5,4,55,54,7,0,2011,reg
Landon Donovan,LA Galaxy,M-F,23,21,1915,12,3,42,23,8,4,2,1,36,36,4,0,2011,reg
Camilo Sanvezzo,Vancouver Whitecaps,F,32,29,2484,12,3,83,37,7,5,2,1,47,55,5,0,2011,reg
Dominic Oduro,Chicago Fire FC,M,34,29,2633,12,2,78,39,6,6,0,2,25,52,5,0,2011,reg
Sébastien Le Toux,Philadelphia Union,F,34,34,3060,11,9,81,30,9,2,3,6,20,36,0,0,2011,reg
Brek Shea,,D,31,30,2647,11,4,74,23,6,5,1,3,25,43,6,1,2011,reg
Alvaro Saborio,Real Salt Lake,F,23,22,1928,11,2,66,24,7,4,2,0,43,38,3,0,2011,reg
Charlie Davies,DC United ,F,26,18,1553,11,1,34,18,5,6,1,0,23,22,3,0,2011,reg
Fabian Espindola,Real Salt Lake,F,27,25,2096,10,3,62,30,5,5,2,1,39,31,6,0,2011,reg
Eric Hassli,Vancouver Whitecaps,F,26,21,1865,10,2,72,28,6,4,2,0,53,35,8,3,2011,reg
Juan Pablo Angel,Chivas USA,F,31,26,2314,10,1,78,32,5,5,1,0,29,13,2,0,2011,reg
Kei Kamara,Colorado Rapids,F,30,24,2201,9,4,91,29,6,3,2,2,37,44,2,0,2011,reg
Luke Rodgers,New York Red Bulls ,F,23,20,1560,9,3,45,20,7,2,2,1,27,26,6,0,2011,reg
Teal Bunbury,New England Revolution,F,29,20,1744,9,3,66,22,5,4,1,2,36,17,2,1,2011,reg
Omar Bravo,Sporting Kansas City ,F,27,26,2150,9,2,59,25,7,2,1,1,22,24,4,2,2011,reg
Álvaro Fernández,FC Dallas,M,29,23,1849,9,0,42,21,6,3,0,0,16,34,3,0,2011,reg
Nick LaBrocca,Chivas USA,M,34,34,3058,8,6,77,25,4,4,1,5,29,38,4,0,2011,reg
Justin Braun,Chivas USA,F,29,22,2055,8,5,69,29,4,4,2,3,42,32,4,0,2011,reg
Emilio Rentería,Columbus Crew SC,F,18,14,1159,8,2,43,17,5,3,0,2,36,33,0,0,2011,reg
Kenny Cooper,Portland Timbers,F,34,29,2562,8,2,78,30,4,4,1,1,27,56,2,0,2011,reg
Marco Pappa,Chicago Fire FC,M,29,27,2324,8,2,92,39,2,6,1,1,42,35,2,0,2011,reg
Maicon Santos,FC Dallas,F,30,24,1974,8,2,92,25,4,4,0,2,30,29,0,0,2011,reg
Danny Koevermans,Toronto FC,F,10,9,756,8,1,30,17,4,4,1,0,7,4,0,0,2011,reg
Shalrie Joseph,New England Revolution ,M,32,32,2860,8,1,52,23,5,3,1,0,37,54,7,1,2011,reg
Jack Jewsbury,Portland Timbers,M,31,31,2790,7,8,47,20,4,3,6,2,36,26,5,0,2011,reg
Dane Richards,New York Red Bulls ,M,27,27,2333,7,7,51,21,3,4,5,2,46,28,5,1,2011,reg
Joel Lindpere,New York Red Bulls ,M,34,34,3048,7,7,54,22,3,4,4,3,45,53,4,0,2011,reg
Chad Barrett,LA Galaxy,F,27,20,1583,7,5,49,19,3,4,4,1,13,15,0,0,2011,reg
Chris Pontius,DC United ,M,25,25,2114,7,5,53,20,4,3,0,5,18,32,2,0,2011,reg
Jeff Larentowicz,Atlanta United FC,M,34,34,3051,7,1,37,17,2,5,1,0,45,37,5,0,2011,reg
Marvin Chávez,FC Dallas,M,31,30,2521,6,4,66,28,3,3,2,2,38,53,4,0,2011,reg
Jorge Perlaza,Portland Timbers,F,31,26,2152,6,2,34,12,6,0,1,1,21,25,2,0,2011,reg
Caleb Folan,Colorado Rapids,F,26,16,1521,6,2,40,16,4,2,0,2,27,25,5,1,2011,reg
Juan Agudelo,,F,27,12,1364,6,2,44,17,5,1,0,2,25,22,1,0,2011,reg
Simon Dawkins,San Jose Earthquakes ,M,26,19,1773,6,2,64,20,5,1,1,1,15,29,2,0,2011,reg
Conor Casey,Colorado Rapids,F,14,11,809,6,1,18,10,4,2,1,0,25,14,4,1,2011,reg
Rajko Lekic,New England Revolution ,F,23,22,1851,6,1,44,17,3,3,0,1,37,39,3,0,2011,reg
Diego Chaves,Chicago Fire FC,F,29,19,1699,6,1,49,14,3,3,1,0,17,43,5,0,2011,reg
Carlos Ruiz,Philadelphia Union,F,14,13,1144,6,0,35,14,4,2,0,0,15,16,2,0,2011,reg
Mauro Rosales,FC Dallas,M,26,22,1870,5,13,18,9,3,2,9,4,18,59,2,0,2011,reg
Josh Wolff,DC United ,F,30,23,1924,5,7,41,17,3,2,5,2,17,36,1,0,2011,reg
Graham Zusi,Sporting Kansas City,M,32,25,2329,5,7,47,16,3,2,6,1,26,38,4,0,2011,reg
Andy Najar,LAFC,D,31,28,2522,5,6,57,20,4,1,5,1,44,37,2,1,2011,reg
Brad Evans,FC Dallas,D-M,20,17,1509,5,5,32,9,2,3,3,2,13,9,2,0,2011,reg
CJ Sapong,Chicago Fire FC,F,34,22,2096,5,5,53,25,3,2,1,4,30,44,0,0,2011,reg
Sanna Nyassi,Colorado Rapids,M,26,17,1586,5,5,61,23,3,2,4,1,24,33,4,0,2011,reg
Geoff Cameron,Houston Dynamo,D,33,33,2970,5,5,63,18,2,3,3,2,29,36,2,0,2011,reg
Sebastián Grazzini,Chicago Fire FC,M,11,11,780,5,4,21,9,3,2,3,1,15,20,1,0,2011,reg
Danny Mwanga,Philadelphia Union,F,28,13,1535,5,4,37,20,2,3,2,2,28,23,4,0,2011,reg
Khari Stephenson,San Jose Earthquakes ,M,31,27,2256,5,4,78,26,3,2,3,1,41,18,3,0,2011,reg
Steven Lenhart,San Jose Earthquakes ,F,14,13,1163,5,3,34,14,2,3,2,1,30,36,6,0,2011,reg
Alejandro Moreno,Chivas USA,F,24,22,2016,5,2,30,12,1,4,2,0,42,48,0,0,2011,reg
Lamar Neagle,FC Dallas,M,23,9,1008,5,2,32,12,3,2,1,1,10,14,1,0,2011,reg
Alan Gordon,San Jose Earthquakes ,F,10,8,739,5,1,20,10,2,3,1,0,30,14,4,0,2011,reg
Bobby Boswell,Houston Dynamo,D,28,27,2460,5,1,22,10,3,2,1,0,20,18,6,0,2011,reg
Brian Ching,Houston Dynamo,F,20,15,1242,5,1,31,14,4,1,1,0,12,25,0,1,2011,reg
Will Bruin,FC Dallas,F,25,21,1693,5,1,54,23,5,0,0,1,18,18,1,0,2011,reg
Eddie Gaven,Columbus Crew SC,M,26,26,2227,5,1,58,24,4,1,0,1,28,65,0,0,2011,reg
Mike Magee,LA Galaxy,M,27,20,1772,5,0,28,11,4,1,0,0,30,34,2,0,2011,reg
Brad Davis,Houston Dynamo,M,34,34,2892,4,16,49,15,3,1,13,3,38,33,5,0,2011,reg
Benny Feilhaber,New England Revolution ,M,23,23,2046,4,7,36,11,1,3,3,4,37,71,3,1,2011,reg
Sean Franklin,LA Galaxy,D,28,25,2338,4,3,15,7,1,3,2,1,23,12,2,0,2011,reg
Colin Clark,Houston Dynamo,M,29,17,1486,4,3,30,10,4,0,2,1,18,12,1,1,2011,reg
Juninho,LA Galaxy,M,30,30,2556,4,2,39,13,2,2,0,2,35,43,4,1,2011,reg
Jackson Goncalves,FC Dallas,M,28,22,1952,4,2,54,17,2,2,1,1,39,22,8,1,2011,reg
Drew Moor,Colorado Rapids,D,32,32,2880,4,1,28,9,2,2,1,0,22,35,8,0,2011,reg
Cam Weaver,Houston Dynamo,F,28,16,1611,4,1,30,11,3,1,1,0,47,29,3,0,2011,reg
Kyle Beckerman,Real Salt Lake,M,29,27,2423,3,9,33,13,2,1,9,0,36,24,6,1,2011,reg
Omar Cummings,Colorado Rapids,F,26,18,1686,3,6,34,10,3,0,4,2,18,21,1,0,2011,reg
Nick Soolsma,Toronto FC,F,23,18,1578,3,5,27,14,2,1,3,2,12,18,1,0,2011,reg
Joao Plata,Toronto FC,F,26,21,1753,3,5,46,17,3,0,2,3,9,19,1,0,2011,reg
Justin Mapp,Philadelphia Union,M,29,24,1861,3,4,29,8,0,3,2,2,19,28,1,0,2011,reg
Jamie Smith,Colorado Rapids,M,20,18,1519,3,4,31,14,2,1,1,3,12,21,0,0,2011,reg
Ryan Johnson,San Jose Earthquakes ,F,26,24,2080,3,4,46,15,0,3,2,2,29,24,3,0,2011,reg
Wells Thompson,Colorado Rapids,D,31,22,1935,3,3,22,9,1,2,1,2,31,39,4,0,2011,reg
Veljko Paunovic,Philadelphia Union,F,17,16,1236,3,3,32,10,1,2,3,0,26,21,1,0,2011,reg
Osvaldo Alonso,Minnesota United FC,M,33,32,2891,3,3,54,11,2,1,3,0,50,39,7,0,2011,reg
Roger Levesque,FC Dallas,M,19,9,1062,3,2,13,6,3,0,2,0,16,16,3,0,2011,reg
Roger Torres,Philadelphia Union,M,25,9,931,3,2,24,6,3,0,2,0,13,17,1,0,2011,reg
Marcos Mondaini,Chivas USA,F,24,20,1493,3,2,28,13,2,1,2,0,17,35,1,1,2011,reg
Milton Caraglio,New England Revolution ,F,12,12,991,3,2,46,15,2,1,1,1,22,19,5,0,2011,reg
David Ferreira,FC Dallas,M,6,6,505,3,1,11,5,2,1,0,1,5,19,0,0,2011,reg
Eric Brunner,Portland Timbers,D,32,31,2795,3,1,17,4,3,0,1,0,19,29,1,1,2011,reg
George John,FC Dallas,D,31,31,2781,3,1,18,7,1,2,0,1,25,29,4,1,2011,reg
Nat Borchers,Real Salt Lake,D,30,30,2547,3,1,19,6,3,0,1,0,14,15,1,2,2011,reg
Cory Gibbs,Chicago Fire FC,D,26,26,2203,3,1,19,5,3,0,1,0,30,23,6,1,2011,reg
Alain Rochat,Vancouver Whitecaps,D,28,27,2434,3,1,21,5,3,0,1,0,35,39,6,0,2011,reg
Tom Heinemann,Columbus Crew SC,F,28,12,1315,3,1,45,15,2,1,1,0,26,23,4,0,2011,reg
Aurelien Collin,Philadelphia Union,D,23,21,1912,3,0,15,5,0,3,0,0,38,19,10,1,2011,reg
Mamadou Danso,Portland Timbers,D,24,23,1999,3,0,20,7,1,2,0,0,7,9,0,0,2011,reg
David Beckham,LA Galaxy,M,26,25,2226,2,15,29,9,2,0,10,5,26,47,10,0,2011,reg
Davide Chiumiento,Vancouver Whitecaps,M,26,20,1674,2,9,20,6,1,1,6,3,15,43,2,0,2011,reg
Robbie Rogers,Columbus Crew SC,D,27,24,2218,2,7,36,11,1,1,4,3,27,50,2,0,2011,reg
Paulo Jr.,Real Salt Lake,F,11,5,468,2,4,11,6,1,1,3,1,6,5,0,0,2011,reg
Ben Zemanski,Chivas USA,M,28,23,2056,2,4,22,5,2,0,2,2,30,25,6,0,2011,reg
Diego Chara,Portland Timbers,M,28,27,2401,2,4,26,7,2,0,3,1,64,23,7,0,2011,reg
Daniel Hernandez,FC Dallas,M,30,30,2668,2,4,29,4,1,1,3,1,47,38,6,0,2011,reg
Chris Tierney,New England Revolution ,D-M,27,25,2184,2,4,32,8,0,2,0,4,13,1,3,2,2011,reg
Javier Morales,Real Salt Lake,M,10,9,785,2,3,12,5,2,0,1,2,10,22,3,0,2011,reg
Atiba Harris,Vancouver Whitecaps,D,5,5,444,2,3,12,8,2,0,3,0,13,12,2,0,2011,reg
Julian de Guzman,Toronto FC,M,19,16,1325,2,3,16,5,0,2,2,1,37,29,6,0,2011,reg
Eric Avila,FC Dallas,M,22,13,1289,2,3,19,6,1,1,3,0,11,24,1,0,2011,reg
Michael Farfan,Philadelphia Union,M,21,13,1460,2,3,23,6,2,0,2,1,22,14,1,0,2011,reg
Danny Cruz,Houston Dynamo,M-F,20,13,1152,2,3,25,8,1,1,2,1,19,19,5,0,2011,reg
Dilly Duka,Columbus Crew SC,M,22,16,1399,2,3,26,8,0,2,3,0,22,18,2,0,2011,reg
Fabian Castillo,FC Dallas,M-F,21,16,1355,2,3,28,8,2,0,3,0,11,9,0,0,2011,reg
Darlington Nagbe,Columbus Crew SC,M,28,21,1651,2,3,30,10,2,0,2,1,8,42,0,0,2011,reg
Júlio César,Sporting Kansas City ,D,27,25,2149,2,2,9,4,2,0,2,0,30,18,3,1,2011,reg
Matt Besler,Sporting Kansas City,D,32,32,2880,2,2,10,3,0,2,1,1,23,13,2,0,2011,reg
Ugo Ihemelu,FC Dallas,D,31,30,2726,2,2,10,3,1,1,1,1,28,24,6,0,2011,reg
Steve Zakuani,FC Dallas,M,6,6,453,2,2,12,5,2,0,0,2,6,3,0,0,2011,reg
O'Brian White,FC Dallas,F,7,7,517,2,2,15,8,1,1,1,1,9,3,0,0,2011,reg
Rodney Wallace,Portland Timbers,D,25,22,1973,2,2,19,6,2,0,0,2,29,14,6,0,2011,reg
Josh Gardner,Columbus Crew SC,M,22,21,1812,2,2,22,7,1,1,1,1,13,3,0,0,2011,reg
Mike Fucito,FC Dallas,F,19,13,1045,2,2,24,7,2,0,1,1,21,11,2,0,2011,reg
Orr Barouch,Chicago Fire FC,F,28,2,624,2,2,28,8,0,2,1,1,19,14,2,0,2011,reg
Ramiro Corrales,San Jose Earthquakes ,M,29,29,2552,2,2,30,5,1,1,1,1,28,30,7,0,2011,reg
Robbie Keane,LA Galaxy,F,4,3,275,2,1,5,3,2,0,1,0,1,1,0,0,2011,reg
Jalil Anibaba,Nashville SC,D,29,27,2508,2,1,11,4,2,0,1,0,27,14,0,0,2011,reg
Stephen McCarthy,New England Revolution ,D,21,18,1428,2,1,12,4,1,1,0,1,16,6,4,0,2011,reg
Diego Fagundez,New England Revolution,M,6,3,314,2,1,12,4,2,0,0,1,4,3,0,0,2011,reg
Jeff Cunningham,Columbus Crew SC,F,21,4,591,2,1,13,3,0,2,1,0,3,8,0,0,2011,reg
Monsef Zerka,New England Revolution ,F,7,7,511,2,1,14,5,0,2,1,0,4,12,0,0,2011,reg
Freddy Adu,Philadelphia Union,F,11,6,609,2,1,15,3,1,1,0,1,8,14,2,0,2011,reg
Omar Gonzalez,Toronto FC,D,29,29,2599,2,1,18,6,1,1,0,1,16,21,3,0,2011,reg
Jámison Olave,Real Salt Lake,D,24,24,2128,2,1,20,7,1,1,1,0,30,17,3,1,2011,reg
Adam Moffat,Houston Dynamo,M,17,12,1203,2,1,21,8,2,0,0,1,13,11,4,1,2011,reg
Mehdi Ballouchy,New York Red Bulls ,M,29,17,1519,2,1,23,7,1,1,0,1,33,24,4,0,2011,reg
Andy Williams,Real Salt Lake,M,31,20,1970,2,1,38,13,2,0,0,1,33,45,2,0,2011,reg
Will Johnson,Real Salt Lake,D,25,22,2059,2,1,39,15,2,0,1,0,20,29,6,1,2011,reg
Scott Palguta,Colorado Rapids,D,9,5,550,2,0,3,2,1,1,0,0,5,1,1,0,2011,reg
Sammy Ochoa,FC Dallas,F,4,0,100,2,0,6,2,1,1,0,0,0,5,0,0,2011,reg
Ryan Guy,New England Revolution ,M,11,6,610,2,0,8,6,0,2,0,0,5,6,1,0,2011,reg
Brandon McDonald,DC United ,D,29,26,2294,2,0,10,3,1,1,0,0,29,13,6,1,2011,reg
Peri Marosevic,FC Dallas,F,7,4,410,2,0,12,5,0,2,0,0,3,3,0,0,2011,reg
Chris Schuler,Real Salt Lake,D,20,16,1638,2,0,13,2,1,1,0,0,16,13,2,0,2011,reg
Javier Martina,Toronto FC,F,23,15,1389,2,0,15,9,2,0,0,0,13,9,3,0,2011,reg
Cristian Nazarit,Chicago Fire FC,F,12,6,624,2,0,20,5,0,2,0,0,25,2,3,0,2011,reg
Luis Gil,Real Salt Lake,M,25,14,1288,2,0,21,7,1,1,0,0,16,11,0,0,2011,reg
Patrick Nyarko,Chicago Fire FC,F-M,30,24,2266,1,9,33,7,1,0,1,8,30,60,2,0,2011,reg
Pável Pardo,Chicago Fire FC,M,13,12,1047,1,5,6,3,1,0,4,1,9,6,0,1,2011,reg
Andrew Jacobson,FC Dallas,M,27,22,1850,1,5,32,11,0,1,2,3,33,17,4,0,2011,reg
Zach Loyd,FC Dallas,D,30,28,2416,1,4,8,1,1,0,2,2,37,44,4,0,2011,reg
Pablo Mastroeni,Colorado Rapids,M,30,30,2517,1,4,12,1,0,1,2,2,28,39,6,0,2011,reg
Santino Quaranta,DC United ,M-F,21,10,1091,1,4,23,5,0,1,2,2,22,15,2,1,2011,reg
Nizar Khalfan,Vancouver Whitecaps,M,22,9,1066,1,4,33,9,1,0,3,1,9,2,1,0,2011,reg
Terry Dunfield,Toronto FC,M,18,13,1191,1,3,11,2,1,0,2,1,13,10,4,0,2011,reg
Michael Lahoud,Chivas USA,M,23,17,1341,1,3,12,3,1,0,2,1,19,13,4,0,2011,reg
Rafael Baca,San Jose Earthquakes ,M,15,11,1046,1,3,12,4,1,0,1,2,12,10,2,0,2011,reg
Kyle Nakazawa,Philadelphia Union,M,22,14,1208,1,3,15,4,0,1,1,2,24,14,1,0,2011,reg
Sheanon Williams,Philadelphia Union,D-M,32,32,2828,1,3,20,7,0,1,2,1,37,42,4,1,2011,reg
Roger Espinoza,Sporting Kansas City,M,24,24,1979,1,3,20,5,1,0,1,2,44,44,3,1,2011,reg
Joey Gjertsen,San Jose Earthquakes ,M,18,13,977,1,3,21,6,1,0,1,2,7,11,0,0,2011,reg
Shea Salinas,San Jose Earthquakes,M,26,18,1695,1,3,22,3,1,0,1,2,12,15,0,1,2011,reg
Miguel López,LA Galaxy,M,24,14,1165,1,3,30,8,0,1,1,2,19,22,2,0,2011,reg
Gabriel Farfan,Chivas USA,M,22,18,1609,1,2,2,1,0,1,1,1,27,25,1,0,2011,reg
Hunter Freeman,Houston Dynamo,D,23,22,1909,1,2,4,1,1,0,2,0,17,21,3,0,2011,reg
Mariano Trujillo,Chivas USA,D,12,0,451,1,2,5,2,0,1,1,1,10,3,2,0,2011,reg
Mike Chabala,Houston Dynamo,D,21,15,1423,1,2,7,4,1,0,2,0,9,8,5,0,2011,reg
Keon Daniel,Philadelphia Union,M,18,9,888,1,2,7,2,1,0,0,2,6,6,1,0,2011,reg
Tyson Wahl,FC Dallas,D,23,22,1989,1,2,7,2,1,0,1,1,22,6,5,0,2011,reg
Erik Friberg,FC Dallas,M,26,23,1897,1,2,9,3,1,0,0,2,30,13,4,0,2011,reg
Long Tan,Vancouver Whitecaps,F,13,4,437,1,2,10,3,1,0,1,1,6,9,0,0,2011,reg
Je-Vaughn Watson,Houston Dynamo,D,22,11,1163,1,2,12,4,0,1,1,1,28,10,4,1,2011,reg
Jean-Marc Alexandre,Real Salt Lake,F,19,9,703,1,2,12,4,1,0,1,1,19,9,3,0,2011,reg
Austin da Luz,DC United ,M,21,9,983,1,2,16,5,0,1,0,2,9,2,5,0,2011,reg
Gaston Puerari,Chicago Fire FC,F,14,10,808,1,2,17,8,1,0,0,2,18,20,3,0,2011,reg
Bobby Convey,San Jose Earthquakes ,M,21,19,1766,1,2,17,4,1,0,2,0,28,18,5,0,2011,reg
Blake Brettschneider,DC United ,F,15,9,789,1,2,20,5,1,0,0,2,13,8,1,0,2011,reg
Emmanuel Ekpo,Columbus Crew SC,M,32,29,2506,1,2,32,6,1,0,2,0,48,53,8,2,2011,reg
Nelson González,Real Salt Lake,M,6,2,174,1,1,5,2,1,0,0,1,4,1,0,0,2011,reg
Marc Burch,DC United ,D,17,11,1117,1,1,7,1,0,1,1,0,10,8,4,0,2011,reg
Daniel Cruz,FC Dallas,M,10,6,543,1,1,7,3,0,1,0,1,12,12,2,1,2011,reg
Adam Cristman,LA Galaxy,F,11,5,527,1,1,8,2,0,1,1,0,14,18,0,0,2011,reg
Ryan Cochrane,New England Revolution ,D,22,19,1478,1,1,8,1,1,0,1,0,29,4,5,1,2011,reg
Michael Umaña,Chivas USA,D,22,21,1796,1,1,9,3,0,1,1,0,21,13,3,0,2011,reg
Marko Perovic,New England Revolution ,M,4,4,262,1,1,10,3,1,0,0,1,5,3,1,0,2011,reg
Ruben Luna,FC Dallas,F,15,2,407,1,1,12,5,0,1,1,0,11,13,1,0,2011,reg
Kosuke Kimura,Colorado Rapids,D,34,34,2996,1,1,13,6,1,0,1,0,16,26,0,0,2011,reg
Brian Mullan,Colorado Rapids,D,22,19,1665,1,1,14,4,1,0,0,1,36,31,4,1,2011,reg
Bernardo Añor,Columbus Crew SC,M,13,6,640,1,1,15,5,0,1,0,1,7,8,2,0,2011,reg
Omar Salgado,Vancouver Whitecaps,F,14,5,504,1,1,15,5,0,1,1,0,9,4,1,0,2011,reg
Zak Boggs,New England Revolution ,M,20,16,1348,1,1,16,7,0,1,1,0,9,16,2,0,2011,reg
Quincy Amarikwa,Colorado Rapids,F,15,5,510,1,1,16,4,0,1,1,0,14,15,1,1,2011,reg
Milton Rodriguez,FC Dallas,F,13,5,511,1,1,19,6,1,0,0,1,8,2,1,0,2011,reg
Carlo Costly,Houston Dynamo,F,11,7,576,1,1,22,3,1,0,1,0,8,10,1,1,2011,reg
Carlos Valdés,Philadelphia Union,D,32,32,2880,1,1,22,4,0,1,1,0,37,33,8,0,2011,reg
Zack Schilawski,New England Revolution ,F,25,13,1199,1,1,24,9,1,0,0,1,5,7,1,0,2011,reg
Jorge Villafaña,Portland Timbers,F,25,24,1793,1,1,29,12,0,1,0,1,21,34,2,1,2011,reg
Lovel Palmer,Houston Dynamo,D,34,31,2782,1,1,58,9,0,1,1,0,26,18,6,1,2011,reg
Kevin Goldthwaite,Portland Timbers,D,4,3,190,1,0,1,1,1,0,0,0,2,5,0,0,2011,reg
Ilija Stolica,New England Revolution ,F,2,0,73,1,0,1,1,0,1,0,0,2,0,1,0,2011,reg
Rich Balchan,Columbus Crew SC,D,19,18,1615,1,0,1,1,0,1,0,0,12,10,1,0,2011,reg
Jack McBean,LA Galaxy,F,1,1,90,1,0,1,1,0,1,0,0,1,4,0,0,2011,reg
Soony Saad,Sporting Kansas City ,F,4,0,39,1,0,2,1,1,0,0,0,1,2,0,0,2011,reg
Bobby Warshaw,FC Dallas,D,17,4,461,1,0,2,1,0,1,0,0,9,4,2,0,2011,reg
Leonardo,LA Galaxy,D,7,7,630,1,0,2,1,1,0,0,0,5,5,1,0,2011,reg
Luke Sassano,Sporting Kansas City ,D,9,5,531,1,0,2,2,0,1,0,0,2,6,1,0,2011,reg
Jimmy Conrad,Chivas USA,D,2,2,180,1,0,3,1,1,0,0,0,1,3,1,0,2011,reg
Bright Dike,Portland Timbers,F,11,0,164,1,0,3,3,0,1,0,0,7,3,2,0,2011,reg
Patrick Ianni,FC Dallas,D-M,16,12,1232,1,0,5,2,0,1,0,0,14,8,2,0,2011,reg
Ethan White,DC United ,D,24,21,1928,1,0,6,4,1,0,0,0,14,1,3,0,2011,reg
Dan Gargan,Chicago Fire FC,D,25,21,1848,1,0,7,1,1,0,0,0,30,11,7,0,2011,reg
Ellis McLoughlin,San Jose Earthquakes ,F,10,0,167,1,0,7,2,1,0,0,0,9,2,0,0,2011,reg
Koke,Houston Dynamo,F,7,2,233,1,0,7,4,1,0,0,0,3,3,0,0,2011,reg
Andrew Boyens,Chivas USA,D,12,10,909,1,0,7,4,0,1,0,0,12,3,1,1,2011,reg
Edward Johnson,Portland Timbers,F,7,3,265,1,0,7,3,1,0,0,0,4,5,1,0,2011,reg
Daniel Woolard,DC United ,D,26,26,2254,1,0,8,1,0,1,0,0,16,23,0,0,2011,reg
Julius James,Columbus Crew SC,D,31,31,2790,1,0,8,2,1,0,0,0,53,22,7,0,2011,reg
Calen Carr,Houston Dynamo,F,9,4,380,1,0,9,3,0,1,0,0,11,6,0,0,2011,reg
Danny Califf,Philadelphia Union,D,33,33,2970,1,0,9,4,0,1,0,0,33,25,4,0,2011,reg
Ryan Smith,Chivas USA,M,6,2,294,1,0,9,3,0,1,0,0,0,5,1,0,2011,reg
Andre Hainault,Houston Dynamo,D,31,31,2790,1,0,9,1,0,1,0,0,44,24,1,0,2011,reg
Perry Kitchen,LA Galaxy,M,31,30,2726,1,0,10,2,0,1,0,0,33,24,4,0,2011,reg
Jeff Parke,FC Dallas,D,28,28,2387,1,0,10,4,1,0,0,0,17,15,2,0,2011,reg
Victor Estupinan,Chivas USA,F,9,3,320,1,0,11,6,1,0,0,0,10,5,1,0,2011,reg
Laurent Courtois ,Chivas USA,M,11,3,454,1,0,12,4,0,1,0,0,6,6,0,0,2011,reg
Brian Carroll,Philadelphia Union,M,30,30,2571,1,0,15,4,0,1,0,0,27,13,5,0,2011,reg
Tony Tchani,Columbus Crew SC,M,15,14,1144,1,0,15,7,1,0,0,0,24,21,3,1,2011,reg
Andre Akpan,Colorado Rapids,F,12,5,479,1,0,15,5,1,0,0,0,8,8,0,0,2011,reg
Jack McInerney,Philadelphia Union,F,18,5,558,1,0,16,6,1,0,0,0,10,7,1,1,2011,reg
A.J. Soares,New England Revolution ,D,28,28,2464,1,0,17,5,0,1,0,0,27,24,2,2,2011,reg
Stephen King,DC United ,M,20,11,1068,1,0,18,5,1,0,0,0,8,10,0,0,2011,reg
Sainey Nyassi,New England Revolution ,M,21,8,959,1,0,21,10,0,1,0,0,15,20,1,0,2011,reg
Chris Birchall,LA Galaxy,M,23,17,1551,1,0,26,4,1,0,0,0,27,15,3,1,2011,reg
Gershon Koffie,Vancouver Whitecaps,M,29,28,2467,1,0,34,9,1,0,0,0,58,76,3,1,2011,reg
Steven Beitashour,San Jose Earthquakes ,D,19,19,1654,0,7,4,2,0,0,5,2,15,13,3,1,2011,reg
Ante Jazic,Chivas USA,D,28,28,2468,0,7,6,2,0,0,4,3,22,13,3,0,2011,reg
Jan Gunnar Solli,New York Red Bulls ,D,31,31,2643,0,7,15,4,0,0,4,3,20,12,1,1,2011,reg
Dax McCarty,Nashville SC,M,29,25,2121,0,6,18,2,0,0,4,2,21,34,2,0,2011,reg
Kalif Alhassan,Portland Timbers,M,32,27,2337,0,6,58,14,0,0,6,0,28,52,3,1,2011,reg
Jordan Harvey,LAFC,D,30,30,2498,0,5,9,2,0,0,3,2,24,12,7,1,2011,reg
Rafa Márquez,New York Red Bulls ,M,19,19,1684,0,5,16,4,0,0,4,1,26,27,6,0,2011,reg
Collen Warner,Colorado Rapids,M,24,15,1106,0,5,16,8,0,0,1,4,28,19,3,1,2011,reg
Gonzalo Segares,Chicago Fire FC,D,33,33,2950,0,5,17,3,0,0,2,3,44,20,8,0,2011,reg
Todd Dunivant,LA Galaxy,D,32,32,2880,0,4,12,5,0,0,1,3,25,30,2,0,2011,reg
Danleigh Borman,New York Red Bulls ,D,24,19,1697,0,3,3,0,0,0,2,1,19,10,4,0,2011,reg
Sebastián Miranda,Columbus Crew SC,D,34,34,3044,0,3,8,2,0,0,1,2,17,13,5,0,2011,reg
Jeremy Hall,FC Dallas,D-M,21,19,1715,0,3,9,2,0,0,1,2,22,15,6,1,2011,reg
Heath Pearce,Chivas USA,D,30,29,2581,0,3,10,0,0,0,0,3,13,13,2,0,2011,reg
Pat Phelan,New England Revolution ,M-D,20,15,1426,0,3,12,2,0,0,1,2,24,20,4,1,2011,reg
Blair Gavin,Chivas USA,M,18,11,958,0,3,12,3,0,0,2,1,6,10,0,0,2011,reg
Jair Benítez,FC Dallas,D,27,25,2231,0,3,15,2,0,0,0,3,23,33,2,0,2011,reg
Jacob Peterson,San Jose Earthquakes ,F,22,18,1460,0,3,17,6,0,0,2,1,12,14,2,0,2011,reg
Roy Miller,New York Red Bulls ,D,30,30,2699,0,3,18,5,0,0,1,2,29,16,5,0,2011,reg
Sal Zizzo,Portland Timbers,D,30,14,1515,0,3,22,10,0,0,2,1,13,20,0,0,2011,reg
Bryan Jordan,LA Galaxy,D,13,5,581,0,2,0,0,0,0,2,0,6,6,1,0,2011,reg
Marvell Wynne,Colorado Rapids,D,29,28,2530,0,2,0,0,0,0,2,0,16,14,2,0,2011,reg
Chris Korb,DC United ,D,12,12,1020,0,2,0,0,0,0,1,1,7,9,0,0,2011,reg
Ashtone Morgan,Real Salt Lake,D,14,9,903,0,2,2,0,0,0,1,1,12,7,1,0,2011,reg
Luiz Camargo,Houston Dynamo,M,7,6,515,0,2,3,2,0,0,1,1,10,9,0,0,2011,reg
Stephen Keel,New York Red Bulls ,D,16,13,1226,0,2,3,0,0,0,1,1,14,6,3,0,2011,reg
Anthony Ampaipitakwong,San Jose Earthquakes ,M,12,5,546,0,2,4,2,0,0,0,2,7,1,0,0,2011,reg
Francisco Mendoza,Chivas USA,M,12,2,281,0,2,5,2,0,0,2,0,5,3,0,0,2011,reg
Bruno Guarda,FC Dallas,M,11,5,500,0,2,6,1,0,0,0,2,9,7,2,0,2011,reg
James Riley,FC Dallas,D,29,29,2579,0,2,7,1,0,0,2,0,26,17,3,0,2011,reg
Robbie Russell,Real Salt Lake,D,26,22,1809,0,2,8,1,0,0,2,0,17,10,4,0,2011,reg
Justin Meram,Real Salt Lake,M,17,4,515,0,2,9,2,0,0,0,2,8,6,2,0,2011,reg
Baggio Husidic,Chicago Fire FC,M,18,9,794,0,2,12,2,0,0,1,1,14,6,2,0,2011,reg
Dejan Rusmir,Columbus Crew SC,M,18,13,1016,0,2,14,1,0,0,1,1,35,14,4,0,2011,reg
Nate Jaqua,FC Dallas,F,23,7,843,0,2,16,2,0,0,0,2,29,9,2,0,2011,reg
Simon Elliott,Chivas USA,M,24,21,1824,0,2,17,1,0,0,0,2,19,21,3,0,2011,reg
Milos Stojcev,Sporting Kansas City ,M,12,11,790,0,2,18,4,0,0,0,2,9,8,1,1,2011,reg
Sam Cronin,San Jose Earthquakes ,M,27,22,1903,0,2,21,2,0,0,1,1,29,10,6,1,2011,reg
Ricardo Villar,FC Dallas,M,20,14,1317,0,2,23,6,0,0,0,2,24,26,2,0,2011,reg
Davy Arnaud,Sporting Kansas City ,M,22,16,1536,0,2,24,4,0,0,1,1,19,28,2,0,2011,reg
Teemu Tainio,New York Red Bulls ,M,28,28,2407,0,2,27,4,0,0,1,1,45,18,7,1,2011,reg
Abdoulie Mansally,New England Revolution ,D,25,9,1140,0,2,29,4,0,0,2,0,28,29,3,1,2011,reg
Jack Stewart,FC Dallas,D,2,1,109,0,1,0,0,0,0,0,1,0,0,0,0,2011,reg
Jed Zayner,DC United ,D,4,4,311,0,1,0,0,0,0,1,0,9,4,0,0,2011,reg
Chris Leitch,San Jose Earthquakes ,D,14,12,1115,0,1,1,1,0,0,0,1,8,9,3,0,2011,reg
Didier Domi,New England Revolution ,D,9,8,680,0,1,3,0,0,0,0,1,8,4,1,0,2011,reg
Michael Videira,Chicago Fire FC,M,9,7,493,0,1,3,1,0,0,1,0,10,0,2,0,2011,reg
Anthony Wallace,Colorado Rapids,D,10,8,719,0,1,4,0,0,0,1,0,7,5,3,0,2011,reg
Leonardo González,FC Dallas,D,14,12,1069,0,1,4,1,0,0,1,0,22,8,5,0,2011,reg
Wes Knight,Vancouver Whitecaps,D,12,10,805,0,1,5,1,0,0,1,0,8,4,0,0,2011,reg
Tony Beltran,Real Salt Lake,D,22,19,1731,0,1,5,3,0,0,0,1,14,20,1,1,2011,reg
Gregg Berhalter,LA Galaxy,D,10,8,748,0,1,5,1,0,0,1,0,13,8,3,0,2011,reg
Jermaine Taylor,Houston Dynamo,D,13,10,925,0,1,5,0,0,0,0,1,9,1,2,0,2011,reg
Gianluca Zavarise,Toronto FC,M,14,4,569,0,1,6,1,0,0,1,0,7,13,1,1,2011,reg
Tim Ream,New York Red Bulls ,D,28,28,2520,0,1,6,3,0,0,0,1,10,9,2,0,2011,reg
Brian Umony,Portland Timbers,F,6,0,131,0,1,6,2,0,0,0,1,3,1,1,0,2011,reg
Michael Stephens,LA Galaxy,M,25,12,1109,0,1,7,2,0,0,0,1,13,4,3,0,2011,reg
Tyrone Marshall,Colorado Rapids,D,27,24,2177,0,1,7,0,0,0,0,1,24,14,4,0,2011,reg
Paulo Nagamura,Chivas USA,M,11,6,544,0,1,8,0,0,0,1,0,9,6,2,0,2011,reg
Chris Wingert,Real Salt Lake,D,23,22,1915,0,1,9,2,0,0,1,0,32,10,5,0,2011,reg
Torsten Frings,Toronto FC,M,13,13,1124,0,1,9,4,0,0,0,1,8,11,0,0,2011,reg
Fred,DC United ,M,17,5,596,0,1,10,1,0,0,0,1,14,10,3,0,2011,reg
Jhon Kennedy Hurtado,FC Dallas,D,23,23,1945,0,1,10,1,0,0,1,0,30,16,4,2,2011,reg
Corben Bone,Chicago Fire FC,M,10,7,534,0,1,10,4,0,0,0,1,2,1,0,0,2011,reg
Birahim Diop,Sporting Kansas City ,M,18,8,761,0,1,10,1,0,0,0,1,19,6,3,0,2011,reg
Matt Stinson,Toronto FC,M,13,5,675,0,1,10,1,0,0,1,0,11,6,1,0,2011,reg
Jeb Brovsky,Vancouver Whitecaps,D,24,16,1509,0,1,11,2,0,0,1,0,24,13,4,0,2011,reg
Brad Ring,San Jose Earthquakes ,D,21,17,1600,0,1,11,2,0,0,1,0,33,25,7,0,2011,reg
Bobby Burling,San Jose Earthquakes ,D,23,23,2041,0,1,11,2,0,0,0,1,22,17,4,2,2011,reg
Kevin Burns,Columbus Crew SC,M,19,15,1243,0,1,11,2,0,0,1,0,12,7,4,0,2011,reg
Kevin Alston,New England Revolution ,D,33,33,2954,0,1,13,1,0,0,0,1,25,45,1,0,2011,reg
Chad Marshall,Columbus Crew SC,D,32,32,2835,0,1,15,6,0,0,1,0,19,28,2,0,2011,reg
Jéferson,Sporting Kansas City ,M,9,8,571,0,1,17,3,0,0,1,0,4,1,1,0,2011,reg
Arturo Alvarez,Real Salt Lake,M,16,8,724,0,1,18,1,0,0,1,0,12,9,0,0,2011,reg
Chance Myers,Sporting Kansas City ,D,28,24,2209,0,1,21,5,0,0,1,0,35,21,1,0,2011,reg
Mikael Yourassowsky,Toronto FC,D,21,13,1302,0,1,21,4,0,0,0,1,26,27,4,1,2011,reg
Daniel Paladini,Chicago Fire FC,M,23,16,1491,0,1,37,14,0,0,0,1,37,15,7,0,2011,reg
Alexandre Morfaw,Vancouver Whitecaps,M,2,1,135,0,0,0,0,0,0,0,0,4,2,0,0,2011,reg
Eddy Viator,Toronto FC,D,3,2,186,0,0,0,0,0,0,0,0,4,0,2,0,2011,reg
Miguel Comminges,Colorado Rapids,D,4,4,322,0,0,0,0,0,0,0,0,3,1,1,1,2011,reg
Marko Maric,Chicago Fire FC,M,1,0,19,0,0,0,0,0,0,0,0,1,1,0,0,2011,reg
Taylor Graham,FC Dallas,D,0,0,0,0,0,0,0,0,0,0,0,0,0,0,0,2011,reg
Shavar Thomas,Sporting Kansas City ,D,3,0,35,0,0,0,0,0,0,0,0,2,1,1,0,2011,reg
Rodrigo López,Portland Timbers,M,0,0,0,0,0,0,0,0,0,0,0,0,0,0,0,2011,reg
Jason Hernandez,San Jose Earthquakes ,D,28,28,2491,0,0,0,0,0,0,0,0,23,14,4,0,2011,reg
Rauwshan McKenzie,Real Salt Lake,D,2,2,180,0,0,0,0,0,0,0,0,2,2,0,0,2011,reg
Joe Tait,Philadelphia Union,D,0,0,0,0,0,0,0,0,0,0,0,0,0,0,0,2011,reg
Kyle Davies,FC Dallas,D,1,0,21,0,0,0,0,0,0,0,0,1,0,0,0,2011,reg
Brian Nielsen,New York Red Bulls ,M,1,0,4,0,0,0,0,0,0,0,0,1,0,0,0,2011,reg
Michael Holody,Colorado Rapids,D,0,0,0,0,0,0,0,0,0,0,0,0,0,0,0,2011,reg
Mike Banner,Chicago Fire FC,M,0,0,0,0,0,0,0,0,0,0,0,0,0,0,0,2011,reg
Danny O'Rourke,Columbus Crew SC,D,6,5,471,0,0,0,0,0,0,0,0,11,3,1,0,2011,reg
Devon McTavish,DC United ,D,0,0,0,0,0,0,0,0,0,0,0,0,0,0,0,2011,reg
Kurt Morsink,DC United ,M,2,2,157,0,0,0,0,0,0,0,0,0,3,1,0,2011,reg
Ousmane Dabo,New England Revolution ,M,3,3,148,0,0,0,0,0,0,0,0,1,0,0,0,2011,reg
Elbekay Bouchiba,Toronto FC,M,0,0,0,0,0,0,0,0,0,0,0,0,0,0,0,2011,reg
Carl Robinson,New York Red Bulls ,M,2,0,54,0,0,0,0,0,0,0,0,2,0,0,0,2011,reg
Nick Kounenakis ,Sporting Kansas City ,D,0,0,0,0,0,0,0,0,0,0,0,0,0,0,0,2011,reg
Nery Castillo,Chicago Fire FC,F,0,0,0,0,0,0,0,0,0,0,0,0,0,0,0,2011,reg
Eddie Robinson,Houston Dynamo,D,2,2,146,0,0,0,0,0,0,0,0,1,4,0,0,2011,reg
André Luiz,San Jose Earthquakes ,M,0,0,0,0,0,0,0,0,0,0,0,0,0,0,0,2011,reg
Blaise Nkufo,FC Dallas,F,0,0,0,0,0,0,0,0,0,0,0,0,0,0,0,2011,reg
Bratislav Ristic,Chicago Fire FC,M,9,5,413,0,0,0,0,0,0,0,0,5,6,1,0,2011,reg
Peterson Joseph,Sporting Kansas City ,M,1,0,8,0,0,0,0,0,0,0,0,0,0,0,0,2011,reg
Chukwudi Chijindu,Chivas USA,M,0,0,0,0,0,0,0,0,0,0,0,0,0,0,0,2011,reg
Amadou Sanyang,FC Dallas,D,1,0,8,0,0,0,0,0,0,0,0,0,0,0,0,2011,reg
Daneil Cyrus,Sporting Kansas City ,D,2,1,108,0,0,0,0,0,0,0,0,4,1,1,0,2011,reg
Francisco Navas Cobo,Houston Dynamo,M,0,0,0,0,0,0,0,0,0,0,0,0,0,0,0,2011,reg
Edson Edward,FC Dallas,D,0,0,0,0,0,0,0,0,0,0,0,0,0,0,0,2011,reg
Kwame Watson-Siriboe,Chicago Fire FC,D,0,0,0,0,0,0,0,0,0,0,0,0,0,0,0,2011,reg
Korede Aiyegbusi,Sporting Kansas City ,D,3,1,94,0,0,0,0,0,0,0,0,1,0,0,0,2011,reg
Mike Seamon,FC Dallas,M-F,0,0,0,0,0,0,0,0,0,0,0,0,0,0,0,2011,reg
Steven Kinney,Chicago Fire FC,D,0,0,0,0,0,0,0,0,0,0,0,0,0,0,0,2011,reg
Miguel Montaño,FC Dallas,F,2,0,31,0,0,0,0,0,0,0,0,1,1,0,0,2011,reg
Omar Jasseh,San Jose Earthquakes ,M,1,0,13,0,0,0,0,0,0,0,0,0,0,0,0,2011,reg
Jordan Graye,Houston Dynamo,D,0,0,0,0,0,0,0,0,0,0,0,0,0,0,0,2011,reg
Bryan Leyva,FC Dallas,M,0,0,0,0,0,0,0,0,0,0,0,0,0,0,0,2011,reg
Juan Diego González,Philadelphia Union,D,0,0,0,0,0,0,0,0,0,0,0,0,0,0,0,2011,reg
Nicholas Lindsay,Toronto FC,F,0,0,0,0,0,0,0,0,0,0,0,0,0,0,0,2011,reg
Junior Carreiro,DC United ,M,0,0,0,0,0,0,0,0,0,0,0,0,0,0,0,2011,reg
Bryan de la Fuente,Chivas USA,F,0,0,0,0,0,0,0,0,0,0,0,0,0,0,0,2011,reg
Philippe Davies,Vancouver Whitecaps,M,0,0,0,0,0,0,0,0,0,0,0,0,0,0,0,2011,reg
Andy Adlard,Columbus Crew SC,M,0,0,0,0,0,0,0,0,0,0,0,0,0,0,0,2011,reg
Ben Sippola,Columbus Crew SC,M,0,0,0,0,0,0,0,0,0,0,0,0,0,0,0,2011,reg
Korey Veeder,Columbus Crew SC,D,0,0,0,0,0,0,0,0,0,0,0,0,0,0,0,2011,reg
Josh Williams,Columbus Crew SC,D,0,0,0,0,0,0,0,0,0,0,0,0,0,0,0,2011,reg
Michael Tetteh,FC Dallas,D,0,0,0,0,0,0,0,0,0,0,0,0,0,0,0,2011,reg
Steven Emory,Colorado Rapids,M,0,0,0,0,0,0,0,0,0,0,0,0,0,0,0,2011,reg
Conor Shanosky,DC United ,M-D,0,0,0,0,0,0,0,0,0,0,0,0,0,0,0,2011,reg
Cole Grossman,Columbus Crew SC,M,2,0,12,0,0,0,0,0,0,0,0,0,0,0,0,2011,reg
Marcos Paullo,New York Red Bulls ,M,0,0,0,0,0,0,0,0,0,0,0,0,0,0,0,2011,reg
Davy Armstrong,Colorado Rapids,M,0,0,0,0,0,0,0,0,0,0,0,0,0,0,0,2011,reg
Victor Pineda,Chicago Fire FC,M,0,0,0,0,0,0,0,0,0,0,0,0,0,0,0,2011,reg
Hector Jimenez,Columbus Crew SC,M,2,1,115,0,0,0,0,0,0,0,0,1,0,0,0,2011,reg
Dustin McCarty,LA Galaxy,M,0,0,0,0,0,0,0,0,0,0,0,0,0,0,0,2011,reg
Ryan Thomas,LA Galaxy,D,1,0,13,0,0,0,0,0,0,0,0,1,0,0,0,2011,reg
Mike Jones,Sporting Kansas City ,D,1,0,1,0,0,0,0,0,0,0,0,0,0,0,0,2011,reg
Josue Soto,Houston Dynamo,D-M,0,0,0,0,0,0,0,0,0,0,0,0,0,0,0,2011,reg
Ryan Richter,Philadelphia Union,D,0,0,0,0,0,0,0,0,0,0,0,0,0,0,0,2011,reg
Chris Taylor,Portland Timbers,D,0,0,0,0,0,0,0,0,0,0,0,0,0,0,0,2011,reg
Freddie Braun ,Portland Timbers,M,0,0,0,0,0,0,0,0,0,0,0,0,0,0,0,2011,reg
Sean Alvarado,LA Galaxy,D,0,0,0,0,0,0,0,0,0,0,0,0,0,0,0,2011,reg
Demitrius Omphroy,Toronto FC,D,1,0,1,0,0,0,0,0,0,0,0,0,1,0,0,2011,reg
Davis Paul,Chicago Fire FC,F,1,1,45,0,0,0,0,0,0,0,0,0,0,0,0,2011,reg
Spencer Thompson,Portland Timbers,F,0,0,0,0,0,0,0,0,0,0,0,0,0,0,0,2011,reg
Levi Houapeu,Philadelphia Union,F,0,0,0,0,0,0,0,0,0,0,0,0,0,0,0,2011,reg
Rodrigo Brasesco,DC United ,D,3,2,155,0,0,0,0,0,0,0,0,1,1,0,0,2011,reg
Scott Lorenz,Sporting Kansas City ,D,1,1,84,0,0,0,0,0,0,0,0,3,0,0,0,2011,reg
Konrad Warzycha,Sporting Kansas City ,M,0,0,0,0,0,0,0,0,0,0,0,0,0,0,0,2011,reg
Kevin Ellis,Sporting Kansas City ,D,0,0,0,0,0,0,0,0,0,0,0,0,0,0,0,2011,reg
Alan Koger,New England Revolution ,F,0,0,0,0,0,0,0,0,0,0,0,0,0,0,0,2011,reg
Michael Augustine,New England Revolution ,M,0,0,0,0,0,0,0,0,0,0,0,0,0,0,0,2011,reg
Andrew Sousa,New England Revolution ,M,0,0,0,0,0,0,0,0,0,0,0,0,0,0,0,2011,reg
Ryan Kinne,New England Revolution ,M,1,0,1,0,0,0,0,0,0,0,0,0,0,0,0,2011,reg
Chris Agorsor,Philadelphia Union,F,1,0,10,0,0,0,0,0,0,0,0,0,0,0,0,2011,reg
Sacir Hot,New York Red Bulls ,D,0,0,0,0,0,0,0,0,0,0,0,0,0,0,0,2011,reg
Moises Hernandez,FC Dallas,D,0,0,0,0,0,0,0,0,0,0,0,0,0,0,0,2011,reg
Victor Ulloa,,M,1,0,9,0,0,0,0,0,0,0,0,0,0,0,0,2011,reg
Jonathan Top,FC Dallas,F,0,0,0,0,0,0,0,0,0,0,0,0,0,0,0,2011,reg
Maxwell Griffin,San Jose Earthquakes ,F,4,0,46,0,0,0,0,0,0,0,0,0,0,0,0,2011,reg
Lawrence Olum,Sporting Kansas City ,D,1,0,13,0,0,0,0,0,0,0,0,0,0,0,0,2011,reg
Carlyle Mitchell,Vancouver Whitecaps,D,3,3,241,0,0,0,0,0,0,0,0,3,1,0,0,2011,reg
Morgan Langley,Philadelphia Union,M,1,0,10,0,0,0,0,0,0,0,0,1,0,0,0,2011,reg
Yordany Álvarez,Real Salt Lake,M,5,4,419,0,0,0,0,0,0,0,0,21,4,4,0,2011,reg
Nico Muñiz,Real Salt Lake,M,0,0,0,0,0,0,0,0,0,0,0,0,0,0,0,2011,reg
Eddie Ababio,Colorado Rapids,D,0,0,0,0,0,0,0,0,0,0,0,0,0,0,0,2011,reg
Santiago Prim,Columbus Crew SC,M,0,0,0,0,0,0,0,0,0,0,0,0,0,0,0,2011,reg
Aaron Horton,Columbus Crew SC,F,1,0,1,0,0,0,0,0,0,0,0,0,0,0,0,2011,reg
Tyler Lassiter,New York Red Bulls ,D,0,0,0,0,0,0,0,0,0,0,0,0,0,0,0,2011,reg
Seth Owusu,Chivas USA,D,0,0,0,0,0,0,0,0,0,0,0,0,0,0,0,2011,reg
Matt Gold,Toronto FC,D,3,0,45,0,0,0,0,0,0,0,0,1,0,0,0,2011,reg
Pari Pantazopoulos,Chicago Fire FC,M,0,0,0,0,0,0,0,0,0,0,0,0,0,0,0,2011,reg
Otto Loewy,New England Revolution ,D,0,0,0,0,0,0,0,0,0,0,0,0,0,0,0,2011,reg
Josh Janniere,Colorado Rapids,M,0,0,0,0,0,0,0,0,0,0,0,0,0,0,0,2011,reg
Donny Toia,Real Salt Lake,D,0,0,0,0,0,0,0,0,0,0,0,0,0,0,0,2011,reg
Teddy Schneider,New York Red Bulls ,D,0,0,0,0,0,0,0,0,0,0,0,0,0,0,0,2011,reg
Bilal Duckett,Vancouver Whitecaps,D,4,2,226,0,0,1,1,0,0,0,0,4,1,1,0,2011,reg
Corey Hertzog,New York Red Bulls ,F,5,0,35,0,0,1,1,0,0,0,0,0,2,0,0,2011,reg
Matt Kassel,New York Red Bulls ,D-M,2,0,82,0,0,1,1,0,0,0,0,1,0,0,0,2011,reg
Mouloud Akloul,Vancouver Whitecaps,D,8,7,625,0,0,1,1,0,0,0,0,7,6,2,0,2011,reg
Cody Arnoux,Real Salt Lake,F,2,0,69,0,0,1,0,0,0,0,0,1,1,0,0,2011,reg
Matt Luzunaris,San Jose Earthquakes ,F,6,0,63,0,0,1,0,0,0,0,0,3,2,0,0,2011,reg
Edmundo Zura,San Jose Earthquakes ,F,1,0,19,0,0,1,0,0,0,0,0,0,0,0,0,2011,reg
Danny Earls,Colorado Rapids,D,4,3,224,0,0,1,1,0,0,0,0,0,2,0,0,2011,reg
Chris Albright,New York Red Bulls ,D,8,6,482,0,0,1,0,0,0,0,0,4,8,0,0,2011,reg
Leandre Griffit,Columbus Crew SC,M,1,0,2,0,0,1,1,0,0,0,0,0,0,0,0,2011,reg
Tim Ward,San Jose Earthquakes ,D,3,2,226,0,0,1,0,0,0,0,0,0,6,0,0,2011,reg
Gabriel Ferrari,Chicago Fire FC,F,3,0,17,0,0,1,1,0,0,0,0,3,1,0,0,2011,reg
Greg Janicki,Vancouver Whitecaps,D,10,8,752,0,0,1,0,0,0,0,0,13,5,1,0,2011,reg
John Rooney,New York Red Bulls ,M,5,0,48,0,0,1,0,0,0,0,0,0,0,0,0,2011,reg
Peter Lowry,Portland Timbers,M,3,2,146,0,0,1,0,0,0,0,0,1,2,1,0,2011,reg
Kevin Harmse,Vancouver Whitecaps,M,3,1,126,0,0,1,0,0,0,0,0,0,1,0,0,2011,reg
Steve Purdy,Portland Timbers,D,8,8,720,0,0,2,1,0,0,0,0,12,9,2,0,2011,reg
Brandon Barklage,DC United ,D,4,0,38,0,0,2,1,0,0,0,0,1,0,0,0,2011,reg
Maykel Galindo,FC Dallas,F,6,1,147,0,0,2,0,0,0,0,0,0,0,0,0,2011,reg
Michael Harrington,Sporting Kansas City ,D,23,16,1495,0,0,2,0,0,0,0,0,14,16,5,0,2011,reg
Carlos Mendes,New York Red Bulls ,D,18,16,1505,0,0,2,1,0,0,0,0,21,9,3,0,2011,reg
Craig Rocastle,Sporting Kansas City ,M,6,5,306,0,0,2,0,0,0,0,0,6,7,0,0,2011,reg
Peter Vagenas,Vancouver Whitecaps,M,16,13,1042,0,0,2,0,0,0,0,0,11,6,0,0,2011,reg
Frankie Hejduk,LA Galaxy,D,6,6,472,0,0,2,1,0,0,0,0,13,1,5,0,2011,reg
Ross LaBauex,Colorado Rapids,M,11,4,313,0,0,2,1,0,0,0,0,5,8,3,0,2011,reg
Tristan Bowen,Chivas USA,F,3,0,60,0,0,2,0,0,0,0,0,2,2,0,0,2011,reg
Darrius Barnes,New England Revolution ,D,28,22,2153,0,0,2,1,0,0,0,0,14,12,1,0,2011,reg
Dejan Jakovic,LAFC,D,15,15,1324,0,0,2,1,0,0,0,0,18,9,3,1,2011,reg
Andrew Wiedeman,FC Dallas,F,3,0,59,0,0,2,1,0,0,0,0,0,1,0,0,2011,reg
Justin Morrow,Toronto FC,D,9,9,810,0,0,2,0,0,0,0,0,9,5,1,0,2011,reg
Russell Teibert,Vancouver Whitecaps,M,11,5,503,0,0,2,0,0,0,0,0,4,6,0,0,2011,reg
Doneil Henry,Toronto FC,D,10,6,503,0,0,2,1,0,0,0,0,7,1,1,0,2011,reg
Joseph Nane,Colorado Rapids,M,10,2,308,0,0,2,1,0,0,0,0,6,3,0,0,2011,reg
Michael Nanchoff,Vancouver Whitecaps,M,5,1,137,0,0,2,0,0,0,0,0,3,0,0,0,2011,reg
Kofi Sarkodie,Houston Dynamo,D,7,7,582,0,0,2,0,0,0,0,0,10,6,2,1,2011,reg
Michael Boxall,Minnesota United FC,D,19,18,1616,0,0,2,2,0,0,0,0,25,10,3,0,2011,reg
Keith Makubuya,Toronto FC,F,1,0,45,0,0,2,0,0,0,0,0,0,0,0,0,2011,reg
Artur Aghasyan,Real Salt Lake,F,4,1,98,0,0,3,0,0,0,0,0,5,2,0,0,2011,reg
Oscar Cordon,Toronto FC,M,4,1,144,0,0,3,1,0,0,0,0,6,2,1,0,2011,reg
Zach Pfeffer,Philadelphia Union,M,3,2,136,0,0,3,2,0,0,0,0,1,2,0,0,2011,reg
Eric Gehrig,Columbus Crew SC,D,8,4,474,0,0,3,0,0,0,0,0,2,1,1,0,2011,reg
Dan Keat,LA Galaxy,M,5,1,117,0,0,3,0,0,0,0,0,2,2,0,0,2011,reg
Shaun Francis,Columbus Crew SC,D,6,5,428,0,0,3,0,0,0,0,0,10,5,1,0,2011,reg
David Estrada,FC Dallas,M-F,3,1,108,0,0,3,0,0,0,0,0,1,1,0,0,2011,reg
Ike Opara,Minnesota United FC,D,8,5,485,0,0,3,0,0,0,0,0,10,4,1,0,2011,reg
Dasan Robinson,Chicago Fire FC,D,6,3,338,0,0,3,0,0,0,0,0,4,9,1,0,2011,reg
Scott Sealy,San Jose Earthquakes ,F,11,6,419,0,0,3,0,0,0,0,0,3,8,0,0,2011,reg
A.J. DeLaGarza,,D,30,30,2627,0,0,3,1,0,0,0,0,31,31,3,0,2011,reg
Zach Scott,FC Dallas,D,12,9,864,0,0,3,0,0,0,0,0,11,6,3,0,2011,reg
Adrian Cann,Toronto FC,D,12,12,988,0,0,3,0,0,0,0,0,11,3,0,0,2011,reg
Kheli Dube,New England Revolution ,F,5,0,114,0,0,3,1,0,0,0,0,2,1,0,0,2011,reg
Nathan Sturgis,Toronto FC,M,14,11,953,0,0,3,0,0,0,0,0,3,13,1,0,2011,reg
Jonathan Leathers,Vancouver Whitecaps,D,22,21,1840,0,0,4,1,0,0,0,0,15,8,3,0,2011,reg
David Júnior Lopes,Chivas USA,D,8,7,580,0,0,4,0,0,0,0,0,13,8,2,1,2011,reg
Jay DeMerit,Vancouver Whitecaps,D,21,20,1671,0,0,4,1,0,0,0,0,20,13,4,0,2011,reg
Jason Garey,Houston Dynamo,F,10,2,164,0,0,4,1,0,0,0,0,4,1,0,0,2011,reg
Ryan Pore,Portland Timbers,M,8,2,200,0,0,4,0,0,0,0,0,2,6,0,0,2011,reg
Jovan Kirovski,LA Galaxy,M-F,13,2,244,0,0,4,0,0,0,0,0,4,1,1,1,2011,reg
Josip Mikulic,Chicago Fire FC,D,14,12,1038,0,0,4,0,0,0,0,0,21,5,5,1,2011,reg
Franco Coria,New England Revolution ,D,18,14,1250,0,0,4,0,0,0,0,0,29,5,5,0,2011,reg
Zarek Valentin,Houston Dynamo,D,25,24,2114,0,0,4,0,0,0,0,0,20,13,5,0,2011,reg
Dicoy Williams,Toronto FC,D,8,7,655,0,0,4,1,0,0,0,0,10,2,1,0,2011,reg
Chris Cortez,Chivas USA,F,9,1,207,0,0,5,1,0,0,0,0,7,3,1,0,2011,reg
John Thorrington,Vancouver Whitecaps,M,11,9,740,0,0,5,0,0,0,0,0,14,7,1,0,2011,reg
Macoumba Kandji,Colorado Rapids,F,9,1,123,0,0,5,1,0,0,0,0,2,3,0,0,2011,reg
Nana Attakora,San Jose Earthquakes ,D,12,9,756,0,0,5,0,0,0,0,0,8,9,2,0,2011,reg
Ty Harden,Toronto FC,D,26,24,2120,0,0,6,1,0,0,0,0,24,7,3,1,2011,reg
Blake Wagner,Real Salt Lake,D-M,11,10,841,0,0,6,2,0,0,0,0,11,11,0,0,2011,reg
Andy Iro,Columbus Crew SC,D,17,15,1323,0,0,6,0,0,0,0,0,24,16,4,1,2011,reg
Richard Eckersley,Toronto FC,D,23,22,1953,0,0,6,3,0,0,0,0,41,42,6,0,2011,reg
Stéphane Auvray,Sporting Kansas City ,M,12,4,449,0,0,6,0,0,0,0,0,7,6,0,0,2011,reg
Logan Pause,Chicago Fire FC,M,29,28,2514,0,0,6,2,0,0,0,0,25,11,3,0,2011,reg
Pat Noonan,FC Dallas,F,9,2,259,0,0,6,3,0,0,0,0,2,3,0,0,2011,reg
Seth Sinovic,New England Revolution,D,20,20,1737,0,0,6,2,0,0,0,0,15,15,2,0,2011,reg
Yamith Cuesta,Chicago Fire FC,D,20,18,1681,0,0,7,1,0,0,0,0,34,13,3,1,2011,reg
Servando Carrasco,FC Dallas,M,12,7,689,0,0,7,0,0,0,0,0,11,5,5,0,2011,reg
James Marcelin,Portland Timbers,M,20,12,1142,0,0,8,0,0,0,0,0,20,10,4,0,2011,reg
Branko Boskovic,DC United ,M,4,1,124,0,0,8,2,0,0,0,0,1,1,0,0,2011,reg
Stefani Miglioranzi,Philadelphia Union,M,17,11,980,0,0,8,0,0,0,0,0,15,11,1,0,2011,reg
David Horst,Portland Timbers,D,16,11,1170,0,0,8,4,0,0,0,0,11,11,0,0,2011,reg
Corey Ashe,Houston Dynamo,M,32,30,2617,0,0,9,1,0,0,0,0,13,34,2,0,2011,reg
Clyde Simms,DC United ,M,29,29,2404,0,0,10,1,0,0,0,0,20,6,2,0,2011,reg
Joseph Ngwenya,DC United ,F,16,7,629,0,0,11,6,0,0,0,0,20,11,1,0,2011,reg
Alen Stevanovic,Toronto FC,M,12,9,773,0,0,11,3,0,0,0,0,6,10,1,0,2011,reg
Amobi Okugo,Philadelphia Union,D-M,15,10,811,0,0,12,4,0,0,0,0,18,8,2,0,2011,reg
Mustapha Jarju,Vancouver Whitecaps,F,10,5,450,0,0,14,3,0,0,0,0,5,4,0,0,2011,reg
Ned Grabavoy,Real Salt Lake,M,25,21,1899,0,0,17,3,0,0,0,0,25,38,3,0,2011,reg
Eric Alexander,FC Dallas,M,28,19,1467,0,0,19,3,0,0,0,0,12,7,0,0,2011,reg
Paolo Cardozo,LA Galaxy,M,17,8,821,0,0,26,9,0,0,0,0,18,30,1,0,2011,reg
Chris Wondolowski,San Jose Earthquakes,F,32,31,2813,27,7,127,55,13,14,4,3,19,25,3,0,2012,reg
Kenny Cooper,New York Red Bulls ,F,33,26,2505,18,3,84,46,11,7,3,0,36,28,3,0,2012,reg
Alvaro Saborio,Real Salt Lake,F,31,26,2390,17,3,87,40,13,4,1,2,35,37,5,0,2012,reg
Robbie Keane,LA Galaxy,F,28,28,2519,16,9,94,43,9,7,6,3,15,34,0,0,2012,reg
Thierry Henry,New York Red Bulls ,F,25,24,2108,15,12,88,37,10,5,9,3,18,26,5,0,2012,reg
Eddie Johnson,FC Dallas,F,28,24,2119,14,3,72,25,7,7,1,2,40,46,6,0,2012,reg
Fredy Montero,Vancouver Whitecaps,F,33,28,2576,13,8,126,46,4,9,4,4,63,68,5,1,2012,reg
Alan Gordon,San Jose Earthquakes ,F,23,13,1297,13,7,43,25,8,5,5,2,54,35,7,1,2012,reg
Chris Pontius,DC United ,M,31,26,2339,12,4,71,29,6,6,3,1,19,49,3,0,2012,reg
Will Bruin,FC Dallas,F,32,31,2510,12,4,78,35,6,6,2,2,14,20,1,0,2012,reg
Kei Kamara,Colorado Rapids,F,33,32,2871,11,8,134,49,6,5,6,2,46,63,3,0,2012,reg
Saer Sene,New England Revolution ,M,25,23,1934,11,3,75,35,8,3,2,1,20,37,0,0,2012,reg
Steven Lenhart,San Jose Earthquakes ,F,26,18,1623,10,2,64,33,7,3,2,0,52,46,7,1,2012,reg
Landon Donovan,LA Galaxy,M-F,26,25,2256,9,14,65,29,4,5,6,8,33,43,6,0,2012,reg
Patrice Bernier,Montreal Impact,M,27,25,2194,9,8,32,15,7,2,7,1,43,16,5,0,2012,reg
Fabian Espindola,Real Salt Lake,F,30,27,2293,9,7,69,30,3,6,3,4,46,36,7,1,2012,reg
Jairo Arrieta,Columbus Crew SC,F,18,18,1534,9,4,41,21,5,4,3,1,21,19,1,0,2012,reg
Blas Pérez,FC Dallas,F,20,19,1705,9,4,53,23,3,6,4,0,33,37,3,1,2012,reg
Danny Koevermans,Toronto FC,F,16,12,1186,9,2,39,24,3,6,1,1,23,12,2,0,2012,reg
Eddie Gaven,Columbus Crew SC,M,34,34,2990,9,2,55,27,6,3,1,1,29,61,2,0,2012,reg
CJ Sapong,Chicago Fire FC,F,31,24,2210,9,2,61,24,5,4,2,0,38,51,2,0,2012,reg
Brad Davis,Houston Dynamo,M,31,28,2523,8,12,53,22,5,3,8,4,40,35,3,0,2012,reg
Jaime Castrillón,Colorado Rapids,M,30,29,2417,8,4,50,18,4,4,2,2,41,29,3,1,2012,reg
Jack McInerney,Philadelphia Union,F,25,18,1630,8,3,42,19,4,4,2,1,24,16,4,1,2012,reg
Chris Rolfe,Chicago Fire FC,F,22,19,1760,8,3,58,20,4,4,1,2,12,26,1,0,2012,reg
Lionard Pajoy,DC United ,F,32,28,2475,8,3,59,20,6,2,2,1,34,35,5,0,2012,reg
Simon Dawkins,San Jose Earthquakes ,M,27,21,1847,8,1,65,24,6,2,1,0,26,35,2,0,2012,reg
Dwayne De Rosario,DC United ,M,26,25,2195,7,12,81,26,6,1,8,4,36,31,4,0,2012,reg
David Beckham,LA Galaxy,M,24,23,1985,7,9,40,18,2,5,6,3,28,25,7,0,2012,reg
Ryan Johnson,Toronto FC,F,31,31,2769,7,5,67,23,2,5,1,4,46,44,6,0,2012,reg
Juninho,LA Galaxy,M,32,30,2666,7,4,52,20,5,2,3,1,42,27,6,0,2012,reg
Maicon Santos,DC United ,F,26,16,1470,7,3,64,19,6,1,1,2,32,16,4,0,2012,reg
Darren Mattocks,Vancouver Whitecaps,F,21,15,1300,7,1,38,16,2,5,1,0,16,32,7,2,2012,reg
Kris Boyd,Portland Timbers,F,26,22,1893,7,1,63,28,6,1,1,0,33,12,4,0,2012,reg
Marco Pappa,Chicago Fire FC,M,22,20,1615,6,5,69,21,4,2,2,3,28,32,5,0,2012,reg
Nick DeLeon,Toronto FC,M,28,25,2175,6,4,44,22,4,2,2,2,25,29,0,0,2012,reg
Fabian Castillo,FC Dallas,M-F,26,23,1892,6,3,36,19,2,4,2,1,20,22,7,0,2012,reg
Dominic Oduro,Chicago Fire FC,M,33,21,1823,6,3,54,25,4,2,2,1,21,35,3,0,2012,reg
Sanna Nyassi,Montreal Impact,M,28,17,1716,6,3,58,31,3,3,2,1,47,28,9,0,2012,reg
Omar Cummings,Colorado Rapids,F,28,23,2000,6,2,76,28,3,3,1,1,18,23,1,0,2012,reg
Darlington Nagbe,Columbus Crew SC,M,33,31,2777,6,1,50,16,3,3,1,0,16,46,0,0,2012,reg
Gabriel Gómez,Philadelphia Union,M,24,18,1578,6,0,30,9,3,3,0,0,36,24,5,0,2012,reg
Hamdi Salihi,DC United ,F,22,10,945,6,0,32,17,3,3,0,0,9,13,3,0,2012,reg
Graham Zusi,Sporting Kansas City,M,32,31,2788,5,15,82,24,4,1,10,5,39,45,3,0,2012,reg
Federico Higuain,DC United,F,13,11,1004,5,7,32,9,5,0,3,4,8,11,2,0,2012,reg
Camilo Sanvezzo,Vancouver Whitecaps,F,28,19,1719,5,7,64,24,5,0,5,2,41,49,4,0,2012,reg
Joel Lindpere,New York Red Bulls ,M,34,26,2385,5,5,28,12,1,4,2,3,33,30,5,0,2012,reg
Brian Ching,Houston Dynamo,F,30,13,1385,5,5,35,15,2,3,2,3,14,28,0,0,2012,reg
Eric Hassli,Toronto FC,F,25,16,1469,5,5,49,16,4,1,2,3,63,22,8,0,2012,reg
Luis Silva,Toronto FC,F,30,22,2061,5,5,50,19,2,3,4,1,14,32,1,0,2012,reg
Mike Magee,LA Galaxy,M,29,24,2078,5,4,56,22,3,2,2,2,20,41,2,0,2012,reg
Marco Di Vaio,Montreal Impact,F,17,16,1366,5,3,49,15,3,2,2,1,13,11,1,0,2012,reg
Kamani Hill,Colorado Rapids,F,19,3,582,5,2,15,8,4,1,1,1,8,11,1,0,2012,reg
Sébastien Le Toux,New York Red Bulls ,F,33,27,2522,5,2,34,16,4,1,1,1,17,24,0,0,2012,reg
Lee Nguyen,,M,30,27,2386,5,2,60,18,3,2,2,0,31,49,3,0,2012,reg
Freddy Adu,Philadelphia Union,F,24,20,1468,5,1,33,13,4,1,1,0,24,28,2,1,2012,reg
Teal Bunbury,New England Revolution,F,22,14,1247,5,1,50,16,1,4,1,0,23,15,2,0,2012,reg
David Estrada,FC Dallas,M-F,17,12,1027,5,0,25,10,4,1,0,0,6,12,1,0,2012,reg
Bright Dike,Portland Timbers,F,12,9,896,5,0,29,12,3,2,0,0,16,16,0,0,2012,reg
Felipe,DC United,M,30,30,2652,4,10,59,23,2,2,7,3,48,70,5,0,2012,reg
Patrick Nyarko,Chicago Fire FC,F-M,34,31,2756,4,7,40,13,3,1,4,3,41,84,3,0,2012,reg
Jackson Goncalves,FC Dallas,M,21,18,1732,4,7,56,14,3,1,3,4,46,36,4,0,2012,reg
Boniek Garcia,Houston Dynamo,M,17,17,1530,4,6,30,12,3,1,4,2,19,31,0,0,2012,reg
Sherjill MacDonald,Chicago Fire FC,F,14,12,1033,4,4,32,11,2,2,2,2,17,6,2,0,2012,reg
Kyle Beckerman,Real Salt Lake,M,30,29,2592,4,4,35,8,2,2,2,2,57,23,6,1,2012,reg
Brad Evans,FC Dallas,D-M,29,29,2371,4,4,35,13,3,1,2,2,18,24,2,0,2012,reg
Álvaro Fernández,Chicago Fire FC,M,27,23,1863,4,3,29,7,2,2,3,0,16,43,2,1,2012,reg
Dane Richards,New York Red Bulls ,M,29,26,2402,4,3,30,11,3,1,3,0,60,26,9,0,2012,reg
Davy Arnaud,Montreal Impact,M,33,31,2765,4,3,40,13,4,0,2,1,42,74,7,0,2012,reg
Calen Carr,Houston Dynamo,F,26,17,1512,4,2,29,11,3,1,2,0,22,29,6,0,2012,reg
Macoumba Kandji,Houston Dynamo,F,29,21,1630,4,2,34,16,3,1,2,0,46,26,3,0,2012,reg
Milovan Mirosevic,Columbus Crew SC,M,26,25,2140,4,2,46,14,2,2,2,0,27,49,2,0,2012,reg
Bernardo Corradi,Montreal Impact,F,11,7,619,4,1,13,7,2,2,1,0,14,14,3,0,2012,reg
Antoine Hoppenot,Philadelphia Union,F,25,3,817,4,1,18,8,2,2,0,1,14,25,2,0,2012,reg
Jacob Peterson,Sporting Kansas City ,F,23,9,942,4,1,24,11,1,3,1,0,7,7,0,1,2012,reg
Justin Meram,Real Salt Lake,M,22,11,960,4,1,27,10,2,2,0,1,22,15,3,0,2012,reg
Andrew Wenger,Montreal Impact,D-M,23,7,823,4,0,20,9,3,1,0,0,13,7,0,0,2012,reg
Juan Pablo Angel,Chivas USA,F,19,9,1004,4,0,50,18,2,2,0,0,16,5,0,0,2012,reg
Mauro Rosales,FC Dallas,M,27,25,2031,3,13,16,5,2,1,7,6,20,44,1,0,2012,reg
Marvin Chávez,San Jose Earthquakes ,M,27,23,1910,3,13,42,14,2,1,5,8,38,32,5,0,2012,reg
Javier Morales,Real Salt Lake,M,29,23,2119,3,9,31,12,2,1,5,4,42,69,5,0,2012,reg
Jan Gunnar Solli,New York Red Bulls ,D,24,21,1865,3,5,16,9,2,1,4,1,16,10,2,0,2012,reg
Kelyn Rowe,New England Revolution,M,30,21,1897,3,5,43,20,1,2,3,2,20,24,1,0,2012,reg
Shalrie Joseph,Chivas USA,M,30,27,2561,3,4,22,6,1,2,0,4,42,31,7,0,2012,reg
Jack Jewsbury,Portland Timbers,M,32,31,2765,3,4,35,10,2,1,4,0,36,35,5,0,2012,reg
Miller Bolaños,Chivas USA,M,24,21,1858,3,4,68,20,2,1,1,3,45,43,5,0,2012,reg
Will Johnson,Real Salt Lake,D,26,23,2087,3,3,36,18,2,1,0,3,24,28,4,1,2012,reg
Dax McCarty,Nashville SC,M,33,33,2918,3,3,40,10,2,1,2,1,40,57,6,0,2012,reg
Juan Agudelo,,F,24,17,1570,3,3,44,16,2,1,1,2,36,26,1,0,2012,reg
Emilio Rentería,Columbus Crew SC,F,27,16,1542,3,3,50,14,2,1,2,1,31,42,4,0,2012,reg
Tony Cascio,Colorado Rapids,M,29,18,1692,3,3,53,19,2,1,3,0,24,24,1,0,2012,reg
Drew Moor,Colorado Rapids,D,34,34,3060,3,2,17,8,3,0,2,0,25,32,3,0,2012,reg
Barry Robson,Vancouver Whitecaps,M,17,16,1421,3,2,32,9,3,0,2,0,31,56,2,0,2012,reg
Gershon Koffie,Vancouver Whitecaps,M,29,28,2503,3,2,39,11,3,0,2,0,59,70,9,0,2012,reg
Brek Shea,,D,21,20,1747,3,2,55,20,2,1,0,2,28,20,1,0,2012,reg
Gonzalo Segares,Chicago Fire FC,D,31,31,2682,3,1,15,8,1,2,1,0,30,31,5,2,2012,reg
Danny Mwanga,Philadelphia Union,F,27,12,1198,3,1,18,7,1,2,1,0,16,10,0,0,2012,reg
Aurelien Collin,Philadelphia Union,D,29,28,2490,3,1,28,7,2,1,0,1,57,28,6,0,2012,reg
Edson Buddle,LA Galaxy,F,19,10,969,3,1,31,9,1,2,1,0,37,16,0,0,2012,reg
Andre Akpan,Colorado Rapids,F,15,4,434,3,0,9,5,3,0,0,0,6,8,0,0,2012,reg
Markus Holgersson,New York Red Bulls ,D,31,31,2790,3,0,11,5,2,1,0,0,23,15,2,0,2012,reg
Matt Hedges,FC Dallas,D,28,23,2022,3,0,12,5,0,3,0,0,20,22,1,0,2012,reg
Austin Berry,Chicago Fire FC,D,28,28,2520,3,0,14,5,1,2,0,0,16,19,2,0,2012,reg
Terry Dunfield,Toronto FC,M,30,30,2493,3,0,24,11,1,2,0,0,49,19,7,0,2012,reg
Jeff Larentowicz,Atlanta United FC,M,32,32,2779,3,0,61,16,2,1,0,0,61,41,8,1,2012,reg
David Ferreira,FC Dallas,M,17,16,1427,2,9,21,9,1,1,4,5,7,53,3,0,2012,reg
Martin Rivero,Colorado Rapids,M,30,30,2597,2,8,61,19,0,2,5,3,23,61,3,0,2012,reg
Brian Mullan,Colorado Rapids,D,28,25,2116,2,7,16,6,2,0,3,4,26,33,1,0,2012,reg
Ramiro Corrales,San Jose Earthquakes ,M,22,19,1667,2,7,20,6,2,0,5,2,21,21,7,1,2012,reg
Brandon Barklage,New York Red Bulls ,D,19,16,1360,2,5,9,2,2,0,3,2,20,7,1,0,2012,reg
Chris Tierney,New England Revolution ,D-M,28,26,2379,2,5,22,10,0,2,3,2,15,13,4,0,2012,reg
Sebastián Grazzini,Chicago Fire FC,M,14,14,1103,2,5,30,15,2,0,2,3,18,22,4,0,2012,reg
Justin Mapp,Montreal Impact,M,27,21,1641,2,5,34,14,1,1,4,1,8,20,0,0,2012,reg
Brandon McDonald,DC United ,D,33,33,2963,2,4,18,3,2,0,2,2,29,16,4,0,2012,reg
Danny Cruz,DC United ,M-F,28,24,1868,2,4,39,10,1,1,1,3,30,40,2,0,2012,reg
Kosuke Kimura,Colorado Rapids,D,29,28,2363,2,3,6,3,2,0,2,1,20,22,2,0,2012,reg
Andre Hainault,Houston Dynamo,D,25,24,2035,2,3,12,6,1,1,3,0,25,6,2,0,2012,reg
Zach Loyd,FC Dallas,D,32,31,2696,2,3,15,3,2,0,2,1,36,31,4,2,2012,reg
Reggie Lambe,Toronto FC,M,27,22,1845,2,3,22,13,2,0,1,2,24,29,3,0,2012,reg
Adam Moffat,Houston Dynamo,M,23,22,1930,2,3,28,7,2,0,1,2,28,19,2,1,2012,reg
Khari Stephenson,San Jose Earthquakes ,M,27,10,1052,2,3,31,10,1,1,2,1,28,3,2,0,2012,reg
Conor Casey,Colorado Rapids,F,18,13,1156,2,3,38,12,1,1,3,0,25,8,1,0,2012,reg
Todd Dunivant,LA Galaxy,D,29,29,2544,2,2,8,2,2,0,2,0,18,17,2,0,2012,reg
Daniel Paladini,Chicago Fire FC,M,15,7,691,2,2,13,5,1,1,0,2,12,5,1,0,2012,reg
Alain Rochat,Vancouver Whitecaps,D,27,27,2323,2,2,16,6,2,0,2,0,38,23,7,0,2012,reg
Diego Fagundez,New England Revolution,M,20,8,770,2,2,18,9,2,0,1,1,6,6,0,0,2012,reg
Jonny Steele,Real Salt Lake,M,28,11,1179,2,2,19,4,1,1,1,1,29,14,6,0,2012,reg
Lamar Neagle,Montreal Impact,M,23,11,1086,2,2,23,5,2,0,1,1,10,12,1,0,2012,reg
Paulo Jr.,Real Salt Lake,F,22,12,848,2,2,26,12,1,1,1,1,13,7,0,0,2012,reg
Fernando Cárdenas,New England Revolution ,F,27,9,1016,2,2,27,10,1,1,1,1,13,14,1,1,2012,reg
Tony Tchani,Columbus Crew SC,M,22,14,1331,2,2,30,5,1,1,1,1,23,21,3,0,2012,reg
Torsten Frings,Toronto FC,M,20,20,1669,2,2,30,10,1,1,2,0,20,17,5,0,2012,reg
Nick LaBrocca,Chivas USA,M,29,26,2293,2,2,36,14,0,2,1,1,27,33,3,0,2012,reg
Marcelo Sarvas,LA Galaxy,M,27,22,1951,2,2,41,11,1,1,2,0,57,49,5,0,2012,reg
Lewis Neal,DC United ,M,18,7,717,2,1,7,2,2,0,1,0,3,3,1,0,2012,reg
Kenny Miller,Vancouver Whitecaps,F,13,8,716,2,1,11,4,1,1,1,0,9,7,0,0,2012,reg
Blake Brettschneider,New England Revolution ,F,17,10,892,2,1,17,9,0,2,1,0,10,11,0,0,2012,reg
Víctor Bernárdez,San Jose Earthquakes ,D,24,24,2088,2,1,19,4,2,0,0,1,30,17,6,0,2012,reg
Bobby Boswell,Houston Dynamo,D,33,33,2930,2,1,20,7,2,0,0,1,22,15,4,0,2012,reg
Jamie Smith,Colorado Rapids,M,10,1,226,2,0,4,3,1,1,0,0,1,3,0,0,2012,reg
Sinisa Ubiparipovic,Montreal Impact,F-M,12,3,325,2,0,5,2,2,0,0,0,5,3,1,0,2012,reg
Tyrone Marshall,Colorado Rapids,D,16,13,1128,2,0,7,3,1,1,0,0,21,7,3,1,2012,reg
Heath Pearce,Chivas USA,D,28,28,2504,2,0,7,4,1,1,0,0,9,20,1,0,2012,reg
Ricardo Villar,FC Dallas,M,9,8,609,2,0,11,6,1,1,0,0,7,18,0,0,2012,reg
A.J. Soares,New England Revolution ,D,30,30,2611,2,0,11,5,0,2,0,0,29,23,3,0,2012,reg
Nat Borchers,Real Salt Lake,D,26,26,2340,2,0,12,6,1,1,0,0,16,11,0,0,2012,reg
José Erick Correa,Chivas USA,F,16,7,695,2,0,15,3,1,1,0,0,13,10,1,0,2012,reg
Scott Sealy,FC Dallas,F,16,8,641,2,0,16,6,1,1,0,0,8,7,0,0,2012,reg
Andrew Wiedeman,FC Dallas,F,20,8,897,2,0,17,5,1,1,0,0,5,8,0,0,2012,reg
Alejandro Moreno,Chivas USA,F,22,17,1520,2,0,18,5,1,1,0,0,36,42,1,0,2012,reg
Chad Marshall,Columbus Crew SC,D,24,24,2146,2,0,22,8,2,0,0,0,15,15,1,0,2012,reg
Jerry Bengtson,New England Revolution,F,13,10,942,2,0,22,8,1,1,0,0,15,17,1,0,2012,reg
Carlos Valdés,Philadelphia Union,D,33,33,2923,2,0,24,5,2,0,0,0,36,34,4,0,2012,reg
Alex,Chicago Fire FC,M,17,6,705,2,0,29,9,2,0,0,0,14,18,1,0,2012,reg
Shea Salinas,San Jose Earthquakes,M,19,11,1099,1,7,17,5,0,1,6,1,16,10,1,0,2012,reg
Branko Boskovic,DC United ,M,26,12,1081,1,7,20,8,1,0,5,2,22,18,1,1,2012,reg
Sam Cronin,San Jose Earthquakes ,M,31,30,2578,1,6,25,3,1,0,3,3,37,21,3,0,2012,reg
Julian de Guzman,FC Dallas,M,28,21,1957,1,5,32,5,1,0,2,3,37,23,6,0,2012,reg
Franck Songo'o,Portland Timbers,M,27,21,1732,1,5,47,18,1,0,2,3,35,44,7,0,2012,reg
Michael Farfan,Philadelphia Union,M,32,31,2802,1,5,54,15,0,1,3,2,74,64,7,0,2012,reg
Justin Morrow,Toronto FC,D,33,33,2970,1,4,6,2,1,0,2,2,25,30,2,0,2012,reg
Lee Young-Pyo,Vancouver Whitecaps,D,33,33,2970,1,4,7,2,0,1,4,0,23,29,2,0,2012,reg
Alex Caskey,FC Dallas,M,20,12,1093,1,4,19,5,1,0,1,3,21,17,0,0,2012,reg
Rafael Baca,San Jose Earthquakes ,M,33,31,2551,1,4,24,7,0,1,2,2,22,33,4,0,2012,reg
Sal Zizzo,Portland Timbers,D,20,12,1174,1,4,24,6,0,1,1,3,4,22,2,0,2012,reg
Pável Pardo,Chicago Fire FC,M,28,27,2386,1,4,25,8,1,0,2,2,19,19,4,0,2012,reg
Chad Barrett,LA Galaxy,F,18,7,677,1,3,14,2,1,0,2,1,6,7,1,0,2012,reg
Luis Gil,Real Salt Lake,M,29,19,1610,1,3,22,5,1,0,2,1,17,12,2,0,2012,reg
Josh Williams,Columbus Crew SC,D,30,27,2429,1,3,24,8,0,1,2,1,30,20,1,1,2012,reg
Tim Cahill,New York Red Bulls ,M,12,12,1080,1,3,24,8,1,0,2,1,27,21,2,0,2012,reg
Eric Avila,Toronto FC,M,24,16,1366,1,3,27,6,0,1,0,3,14,17,1,0,2012,reg
Daniel Woolard,DC United ,D,20,20,1754,1,2,5,2,0,1,2,0,12,16,0,0,2012,reg
Jordan Harvey,LAFC,D,26,18,1737,1,2,6,1,1,0,0,2,21,12,3,0,2012,reg
Bobby Convey,Sporting Kansas City ,M,16,14,989,1,2,7,3,0,1,1,1,5,7,1,0,2012,reg
Hector Jimenez,Columbus Crew SC,M,15,13,920,1,2,8,3,1,0,1,1,9,6,0,1,2012,reg
Sheanon Williams,Philadelphia Union,D-M,28,28,2486,1,2,14,6,0,1,1,1,26,32,5,1,2012,reg
Hassoun Camara,Montreal Impact,D,20,19,1663,1,2,15,4,1,0,1,1,21,14,2,1,2012,reg
Mehdi Ballouchy,New York Red Bulls ,M,22,14,1116,1,2,15,3,1,0,0,2,22,20,3,0,2012,reg
Casey Townsend,Chivas USA,F,17,10,907,1,2,17,8,0,1,0,2,11,9,3,0,2012,reg
Chris Birchall,Columbus Crew SC,M,18,17,1515,1,2,18,6,1,0,1,1,16,16,4,0,2012,reg
Kalif Alhassan,Portland Timbers,M,16,10,827,1,2,19,6,1,0,2,0,5,21,1,0,2012,reg
Ryan Guy,New England Revolution ,M,23,20,1832,1,2,34,12,0,1,1,1,21,18,3,0,2012,reg
Osvaldo Alonso,Minnesota United FC,M,30,30,2688,1,2,41,13,0,1,2,0,37,52,8,0,2012,reg
Benny Feilhaber,New England Revolution ,M,29,23,2147,1,2,42,16,1,0,1,1,30,70,5,1,2012,reg
Zarek Valentin,Houston Dynamo,D,15,14,1161,1,1,2,1,1,0,1,0,8,6,1,0,2012,reg
Jonathan Top,FC Dallas,F,4,1,101,1,1,2,2,0,1,0,1,3,1,0,0,2012,reg
Jose Villarreal,LA Galaxy,M,10,0,122,1,1,3,2,0,1,1,0,7,2,1,0,2012,reg
Luiz Camargo,Houston Dynamo,M,26,16,1425,1,1,6,2,0,1,1,0,23,26,1,0,2012,reg
Sebastián Miranda,Columbus Crew SC,D,33,33,2882,1,1,6,2,1,0,1,0,18,9,3,0,2012,reg
Steve Zakuani,FC Dallas,M,8,4,320,1,1,7,4,1,0,0,1,0,4,0,0,2012,reg
Wilman Conde,New York Red Bulls ,D,17,16,1433,1,1,7,1,0,1,1,0,27,6,3,0,2012,reg
Marcelo Saragosa,DC United ,M,16,12,1120,1,1,8,4,1,0,0,1,32,16,4,0,2012,reg
Martín Bonjour,Vancouver Whitecaps,D,28,27,2396,1,1,8,2,1,0,0,1,43,16,7,0,2012,reg
Sammy Ochoa,FC Dallas,F,9,3,324,1,1,9,3,0,1,1,0,5,7,0,0,2012,reg
Omar Gonzalez,Toronto FC,D,14,13,1147,1,1,10,3,0,1,1,0,12,9,2,0,2012,reg
Doneil Henry,Toronto FC,D,18,11,1139,1,1,10,3,0,1,1,0,18,8,3,0,2012,reg
Zach Scott,FC Dallas,D,20,16,1437,1,1,11,2,1,0,0,1,27,7,5,1,2012,reg
Quincy Amarikwa,Colorado Rapids,F,14,6,601,1,1,12,4,1,0,0,1,13,12,0,0,2012,reg
Jorge Villafaña,Portland Timbers,F,14,9,906,1,1,12,2,1,0,1,0,15,16,1,0,2012,reg
Jay DeMerit,Vancouver Whitecaps,D,31,31,2726,1,1,13,5,0,1,0,1,18,26,4,0,2012,reg
Jair Benítez,FC Dallas,D,28,27,2397,1,1,15,3,1,0,0,1,16,48,3,1,2012,reg
Jermaine Taylor,Houston Dynamo,D,27,26,2334,1,1,16,3,1,0,0,1,15,3,2,0,2012,reg
Andy Rose,Vancouver Whitecaps,M,23,11,1156,1,1,17,4,1,0,0,1,16,9,4,0,2012,reg
Jalil Anibaba,Nashville SC,D,33,32,2868,1,1,18,5,0,1,1,0,22,12,1,1,2012,reg
Brian Carroll,Philadelphia Union,M,33,32,2898,1,1,20,4,0,1,0,1,37,15,4,0,2012,reg
Keon Daniel,Philadelphia Union,M,22,17,1517,1,1,20,4,0,1,1,0,19,22,0,1,2012,reg
Laurent Courtois ,Chivas USA,M,17,9,773,1,1,21,6,0,1,0,1,11,7,0,0,2012,reg
Rodney Wallace,Portland Timbers,D,19,14,1224,1,1,25,9,1,0,0,1,23,10,3,0,2012,reg
Paulo Nagamura,Sporting Kansas City ,M,27,19,1757,1,1,37,5,1,0,1,0,30,19,4,0,2012,reg
Andrew Jacobson,FC Dallas,M,31,31,2597,1,1,40,8,1,0,1,0,47,46,6,0,2012,reg
Oriol Rosell,Orlando City SC,M-D,5,1,127,1,0,1,1,1,0,0,0,2,1,0,0,2012,reg
Ruben Luna,FC Dallas,F,7,2,208,1,0,2,1,1,0,0,0,3,4,0,0,2012,reg
Andrew Jean-Baptiste,Portland Timbers,D,5,4,426,1,0,2,1,1,0,0,0,2,1,0,0,2012,reg
Patrick Ianni,FC Dallas,D-M,16,15,1357,1,0,2,1,1,0,0,0,13,11,1,0,2012,reg
Darrius Barnes,New England Revolution ,D,13,11,1017,1,0,2,1,1,0,0,0,8,4,3,0,2012,reg
Dejan Jakovic,LAFC,D,23,21,1861,1,0,2,2,1,0,0,0,19,26,4,0,2012,reg
Pat Noonan,LA Galaxy,F,10,1,174,1,0,3,2,1,0,0,0,2,1,0,0,2012,reg
Joseph Nane,Colorado Rapids,M,9,6,446,1,0,3,1,1,0,0,0,11,6,2,0,2012,reg
Cole Grossman,Columbus Crew SC,M,10,5,500,1,0,3,1,0,1,0,0,10,3,1,1,2012,reg
Emiliano Bonfigli,Real Salt Lake,F,10,1,288,1,0,5,2,0,1,0,0,2,2,0,0,2012,reg
Logan Pause,Chicago Fire FC,M,32,31,2424,1,0,5,2,1,0,0,0,11,17,0,0,2012,reg
Ugo Ihemelu,FC Dallas,D,10,10,900,1,0,5,1,1,0,0,0,7,9,0,0,2012,reg
Danny Califf,Chivas USA,D,23,23,2034,1,0,6,1,0,1,0,0,19,21,2,0,2012,reg
Robbie Russell,DC United ,D,19,16,1355,1,0,7,3,1,0,0,0,13,7,0,0,2012,reg
Jeremy Hall,Toronto FC,D-M,23,19,1708,1,0,7,2,0,1,0,0,14,13,1,0,2012,reg
Hernán Pertúz,FC Dallas,D,30,24,2116,1,0,7,2,0,1,0,0,22,10,0,0,2012,reg
Bernardo Añor,Columbus Crew SC,M,11,5,493,1,0,7,2,0,1,0,0,13,10,3,0,2012,reg
Colin Clark,Houston Dynamo,M,14,6,655,1,0,8,2,1,0,0,0,5,5,2,0,2012,reg
Eric Brunner,Portland Timbers,D,13,10,924,1,0,8,2,1,0,0,0,4,6,0,0,2012,reg
 Christian Wilhelmsson,LA Galaxy,M,5,4,303,1,0,9,2,1,0,0,0,8,6,0,0,2012,reg
Ricardo Clark,Houston Dynamo,M,11,8,760,1,0,9,2,1,0,0,0,11,16,0,0,2012,reg
José Moreno,New England Revolution ,F,7,5,376,1,0,10,7,1,0,0,0,4,4,1,0,2012,reg
Arne Friedrich,Chicago Fire FC,D,23,22,1832,1,0,12,7,0,1,0,0,16,15,4,1,2012,reg
Paolo Cardozo,Chivas USA,M,10,9,692,1,0,13,4,0,1,0,0,8,20,0,0,2012,reg
Carlos Rodríguez,FC Dallas,M,24,12,1303,1,0,14,5,0,1,0,0,24,30,1,0,2012,reg
Josué Martínez,Philadelphia Union,F,18,6,594,1,0,14,6,1,0,0,0,15,7,1,0,2012,reg
Dimitry Imbongo,New England Revolution ,F,9,4,382,1,0,15,3,1,0,0,0,16,18,2,0,2012,reg
Olman Vargas,Columbus Crew SC,F,11,7,667,1,0,15,7,1,0,0,0,6,6,1,0,2012,reg
Long Tan,DC United ,F,10,3,259,1,0,15,5,1,0,0,0,5,8,0,0,2012,reg
Oswaldo Minda,Chivas USA,M,22,20,1748,1,0,17,3,0,1,0,0,41,21,13,0,2012,reg
David Horst,Portland Timbers,D,21,20,1845,1,0,17,3,1,0,0,0,30,23,1,0,2012,reg
Júlio César,Sporting Kansas City ,D,27,25,2071,1,0,18,2,1,0,0,0,32,20,4,0,2012,reg
Chance Myers,Sporting Kansas City ,D,30,28,2538,0,7,20,2,0,0,5,2,36,27,4,0,2012,reg
Roy Miller,New York Red Bulls ,D,24,20,1662,0,6,6,0,0,0,3,3,14,14,2,0,2012,reg
Steven Beitashour,San Jose Earthquakes ,D,33,33,2955,0,6,11,2,0,0,4,2,29,30,6,0,2012,reg
Eric Alexander,Portland Timbers,M,24,14,1302,0,6,26,7,0,0,4,2,15,9,1,0,2012,reg
Hunter Freeman,Colorado Rapids,D,19,18,1542,0,5,6,2,0,0,3,2,17,16,3,0,2012,reg
Ashtone Morgan,Real Salt Lake,D,30,27,2528,0,5,10,2,0,0,4,1,29,22,7,0,2012,reg
Sean Franklin,LA Galaxy,D,34,33,2937,0,5,17,4,0,0,1,4,22,9,2,0,2012,reg
Davide Chiumiento,Vancouver Whitecaps,M,16,15,1276,0,5,22,6,0,0,4,1,20,39,0,0,2012,reg
Andy Najar,LAFC,D,25,22,2045,0,4,15,3,0,0,2,2,26,20,4,0,2012,reg
Ryan Smith,Chivas USA,M,21,12,1215,0,4,23,5,0,0,0,4,14,33,3,0,2012,reg
Tressor Moreno,San Jose Earthquakes ,M,12,6,557,0,3,3,0,0,0,3,0,3,6,1,0,2012,reg
Rafa Márquez,New York Red Bulls ,M,15,13,987,0,3,6,1,0,0,2,1,15,19,3,0,2012,reg
Shaun Francis,Columbus Crew SC,D,10,6,507,0,3,6,1,0,0,3,0,7,3,1,0,2012,reg
Chris Korb,DC United ,D,26,22,2051,0,3,6,2,0,0,3,0,18,17,3,0,2012,reg
Christian Tiffert,FC Dallas,M,12,11,978,0,3,7,1,0,0,2,1,19,9,4,0,2012,reg
Marc Burch,FC Dallas,D,29,19,1824,0,3,8,1,0,0,2,1,16,13,3,0,2012,reg
Connor Lade,New York Red Bulls ,D,26,22,2088,0,3,8,2,0,0,3,0,27,20,4,1,2012,reg
Ned Grabavoy,Real Salt Lake,M,26,22,1946,0,3,10,5,0,0,2,1,16,28,0,0,2012,reg
Nemanja Vukovic,Columbus Crew SC,D,15,12,1113,0,3,15,3,0,0,2,1,12,9,2,0,2012,reg
Roger Torres,Philadelphia Union,M,10,1,181,0,2,0,0,0,0,1,1,8,5,2,0,2012,reg
Adam Johansson,FC Dallas,D,21,21,1834,0,2,0,0,0,0,0,2,31,13,1,0,2012,reg
Michael Stephens,LA Galaxy,M,23,6,724,0,2,3,1,0,0,1,1,7,2,1,0,2012,reg
Miguel Aceval,Toronto FC,D,5,5,416,0,2,3,0,0,0,0,2,3,2,0,0,2012,reg
Brian Ownby,Houston Dynamo,M,7,0,115,0,2,5,2,0,0,1,1,2,4,0,0,2012,reg
Darren O'Dea,Toronto FC,D,9,9,810,0,2,5,1,0,0,1,1,11,2,2,0,2012,reg
Steven Smith,Portland Timbers,D,22,22,1875,0,2,5,0,0,0,1,1,11,19,6,0,2012,reg
Nick Soolsma,Toronto FC,F,9,3,324,0,2,6,1,0,0,1,1,4,5,0,0,2012,reg
Matt Besler,Sporting Kansas City,D,31,30,2769,0,2,7,1,0,0,1,1,26,12,3,0,2012,reg
Tristan Bowen,Chivas USA,F,5,3,248,0,2,7,3,0,0,1,1,4,5,0,0,2012,reg
Chris Wingert,Real Salt Lake,D,31,30,2603,0,2,8,1,0,0,2,0,34,13,7,0,2012,reg
Corey Ashe,Houston Dynamo,M,30,30,2625,0,2,8,1,0,0,1,1,28,40,3,0,2012,reg
Richard Eckersley,Toronto FC,D,33,32,2802,0,2,9,0,0,0,1,1,37,31,5,0,2012,reg
James Riley,Chivas USA,D,32,32,2880,0,2,10,0,0,0,1,1,25,22,2,1,2012,reg
Geoff Cameron,Houston Dynamo,D,15,15,1326,0,2,11,1,0,0,2,0,15,6,1,0,2012,reg
Tony Beltran,Real Salt Lake,D,32,32,2857,0,2,12,4,0,0,2,0,28,28,4,0,2012,reg
Seth Sinovic,New England Revolution,D,30,30,2621,0,2,12,1,0,0,1,1,29,26,3,0,2012,reg
Ben Zemanski,Chivas USA,M,22,18,1649,0,2,15,6,0,0,0,2,24,24,3,0,2012,reg
Roger Espinoza,Sporting Kansas City,M,26,26,2275,0,2,35,9,0,0,0,2,47,46,5,1,2012,reg
Dilly Duka,Columbus Crew SC,M,20,14,1073,0,2,36,6,0,0,0,2,27,9,3,0,2012,reg
Terukazu Tanaka,Real Salt Lake,D,4,4,325,0,1,0,0,0,0,1,0,3,0,0,0,2012,reg
Michael Harrington,Sporting Kansas City ,D,11,9,877,0,1,0,0,0,0,1,0,9,5,1,0,2012,reg
Stephen King,DC United ,M,7,1,202,0,1,1,0,0,0,0,1,1,2,0,0,2012,reg
Adam Cristman,LA Galaxy,F,2,1,69,0,1,2,0,0,0,1,0,2,2,1,0,2012,reg
Peter Vagenas,Chivas USA,M,13,11,842,0,1,2,1,0,0,1,0,10,13,1,0,2012,reg
Dennis Iapichino,Montreal Impact,D,7,5,438,0,1,2,0,0,0,1,0,5,3,2,0,2012,reg
Raymon Gaddis,Philadelphia Union,D,18,17,1475,0,1,2,0,0,0,1,0,19,9,2,0,2012,reg
Eric Gehrig,Columbus Crew SC,D,12,8,812,0,1,2,0,0,0,1,0,8,7,1,0,2012,reg
Matt Stinson,Toronto FC,M,4,1,89,0,1,2,0,0,0,1,0,2,0,0,0,2012,reg
Kofi Sarkodie,Houston Dynamo,D,10,7,695,0,1,2,0,0,0,0,1,6,8,0,0,2012,reg
Blair Gavin,Chivas USA,M,11,5,398,0,1,3,2,0,0,0,1,1,2,0,0,2012,reg
Federico Puppo,Chicago Fire FC,F,11,1,216,0,1,3,3,0,0,0,1,4,5,1,0,2012,reg
Cordell Cato,FC Dallas,F,8,0,117,0,1,3,0,0,0,0,1,3,1,0,0,2012,reg
Warren Creavalle,Philadelphia Union,M,11,5,479,0,1,3,1,0,0,1,0,5,5,0,0,2012,reg
Josh Wolff,DC United ,F,9,1,223,0,1,3,2,0,0,1,0,3,3,1,0,2012,reg
Tyson Wahl,Colorado Rapids,D,15,15,1350,0,1,3,1,0,0,0,1,25,7,5,0,2012,reg
Jason Hernandez,San Jose Earthquakes ,D,25,23,2090,0,1,3,0,0,0,0,1,14,10,1,2,2012,reg
Peterson Joseph,Sporting Kansas City ,M,10,4,263,0,1,3,0,0,0,0,1,6,7,3,1,2012,reg
Teemu Tainio,New York Red Bulls ,M,14,9,782,0,1,4,0,0,0,0,1,11,9,2,0,2012,reg
Sam Garza,San Jose Earthquakes ,M,6,0,102,0,1,4,0,0,0,1,0,3,3,1,0,2012,reg
Bryan Gaul,LA Galaxy,D,14,7,800,0,1,4,2,0,0,1,0,13,3,3,0,2012,reg
Omar Salgado,Vancouver Whitecaps,F,7,5,398,0,1,4,1,0,0,1,0,7,8,1,0,2012,reg
Kirk Urso,Columbus Crew SC,M,6,5,453,0,1,5,0,0,0,1,0,7,2,1,0,2012,reg
Cesar Romero,Chivas USA,F,12,4,392,0,1,5,0,0,0,1,0,9,4,1,0,2012,reg
Florian Lechner,New England Revolution ,D,9,7,599,0,1,5,0,0,0,0,1,4,12,0,0,2012,reg
Lloyd Sam,New York Red Bulls ,M-F,5,2,164,0,1,5,1,0,0,1,0,5,3,1,0,2012,reg
Jhon Kennedy Hurtado,FC Dallas,D,22,20,1791,0,1,5,0,0,0,0,1,27,11,1,1,2012,reg
Rauwshan McKenzie,Chivas USA,D,20,19,1732,0,1,5,2,0,0,0,1,18,7,2,0,2012,reg
Jámison Olave,Real Salt Lake,D,21,21,1734,0,1,6,0,0,0,1,0,27,17,5,1,2012,reg
Aaron Schoenfeld ,Minnesota United FC,F,9,3,298,0,1,6,3,0,0,1,0,9,3,2,0,2012,reg
Gabriel Farfan,Chivas USA,M,23,22,1960,0,1,6,1,0,0,1,0,34,32,5,1,2012,reg
Soony Saad,Sporting Kansas City ,F,9,2,305,0,1,7,2,0,0,0,1,5,5,0,0,2012,reg
Stephen McCarthy,New England Revolution ,D,28,27,2308,0,1,7,3,0,0,1,0,22,28,2,1,2012,reg
Hanyer Mosquera ,Portland Timbers,D,26,25,2092,0,1,8,0,0,0,1,0,25,11,4,0,2012,reg
Luis Zapata,Colorado Rapids,D,27,26,2336,0,1,8,3,0,0,0,1,33,27,2,0,2012,reg
Nelson Rivas,Montreal Impact,D,11,11,858,0,1,8,1,0,0,1,0,9,11,2,1,2012,reg
John Thorrington,Vancouver Whitecaps,M,19,14,1099,0,1,10,2,0,0,1,0,18,11,2,0,2012,reg
Jeb Brovsky,Montreal Impact,D,28,25,2233,0,1,10,3,0,0,1,0,17,14,1,1,2012,reg
Wells Thompson,Chicago Fire FC,D,21,5,664,0,1,11,2,0,0,1,0,11,13,1,0,2012,reg
Dan Gargan,Chicago Fire FC,D,22,19,1754,0,1,12,2,0,0,1,0,38,12,5,0,2012,reg
Perry Kitchen,LA Galaxy,M,32,32,2804,0,1,12,0,0,0,1,0,43,33,2,0,2012,reg
Chris Schuler,Real Salt Lake,D,13,9,944,0,1,12,1,0,0,1,0,12,3,2,0,2012,reg
Kevin Alston,New England Revolution ,D,31,31,2623,0,1,13,2,0,0,0,1,37,45,3,0,2012,reg
Justin Braun,Montreal Impact,F,14,6,581,0,1,14,5,0,0,0,1,12,8,0,0,2012,reg
Clyde Simms,New England Revolution ,M,29,29,2303,0,1,14,4,0,0,1,0,16,7,2,0,2012,reg
Amobi Okugo,Philadelphia Union,D-M,27,24,2230,0,1,16,2,0,0,1,0,24,24,3,0,2012,reg
Jeff Parke,FC Dallas,D,30,29,2568,0,1,17,3,0,0,1,0,32,27,3,0,2012,reg
Collen Warner,Colorado Rapids,M,29,27,2431,0,1,32,2,0,0,0,1,44,43,6,0,2012,reg
Steven Kinney,Chicago Fire FC,D,0,0,0,0,0,0,0,0,0,0,0,0,0,0,0,2012,reg
Mike Seamon,FC Dallas,M-F,1,0,50,0,0,0,0,0,0,0,0,0,0,0,0,2012,reg
Russell Teibert,Vancouver Whitecaps,M,4,1,117,0,0,0,0,0,0,0,0,1,1,0,0,2012,reg
Rich Balchan,Columbus Crew SC,D,0,0,0,0,0,0,0,0,0,0,0,0,0,0,0,2012,reg
Nicholas Lindsay,Toronto FC,F,0,0,0,0,0,0,0,0,0,0,0,0,0,0,0,2012,reg
Digao,New York Red Bulls ,D,0,0,0,0,0,0,0,0,0,0,0,0,0,0,0,2012,reg
Zach Pfeffer,Philadelphia Union,M,1,0,4,0,0,0,0,0,0,0,0,0,0,0,0,2012,reg
Ross LaBauex,Colorado Rapids,M,2,1,79,0,0,0,0,0,0,0,0,5,4,0,0,2012,reg
Cody Arnoux,Real Salt Lake,F,0,0,0,0,0,0,0,0,0,0,0,0,0,0,0,2012,reg
Matias Jara,FC Dallas,F,0,0,0,0,0,0,0,0,0,0,0,0,0,0,0,2012,reg
Corben Bone,Chicago Fire FC,M,2,0,26,0,0,0,0,0,0,0,0,0,0,0,0,2012,reg
Birahim Diop,Sporting Kansas City ,M,0,0,0,0,0,0,0,0,0,0,0,0,0,0,0,2012,reg
Zak Boggs,New England Revolution ,M,0,0,0,0,0,0,0,0,0,0,0,0,0,0,0,2012,reg
Leonardo,LA Galaxy,D,0,0,0,0,0,0,0,0,0,0,0,0,0,0,0,2012,reg
Joey Gjertsen,San Jose Earthquakes ,M,0,0,0,0,0,0,0,0,0,0,0,0,0,0,0,2012,reg
Moises Hernandez,FC Dallas,D,0,0,0,0,0,0,0,0,0,0,0,0,0,0,0,2012,reg
Victor Ulloa,,M,0,0,0,0,0,0,0,0,0,0,0,0,0,0,0,2012,reg
Josue Soto,Houston Dynamo,D-M,0,0,0,0,0,0,0,0,0,0,0,0,0,0,0,2012,reg
Chris Taylor,Portland Timbers,D,0,0,0,0,0,0,0,0,0,0,0,0,0,0,0,2012,reg
Conor Shanosky,DC United ,M-D,0,0,0,0,0,0,0,0,0,0,0,0,0,0,0,2012,reg
Davy Armstrong,Colorado Rapids,M,1,0,4,0,0,0,0,0,0,0,0,0,0,0,0,2012,reg
Victor Pineda,Chicago Fire FC,M,0,0,0,0,0,0,0,0,0,0,0,0,0,0,0,2012,reg
Steven Emory,Colorado Rapids,M,0,0,0,0,0,0,0,0,0,0,0,0,0,0,0,2012,reg
Corey Hertzog,New York Red Bulls ,F,0,0,0,0,0,0,0,0,0,0,0,0,0,0,0,2012,reg
Tom Heinemann,Columbus Crew SC,F,1,0,5,0,0,0,0,0,0,0,0,0,0,0,0,2012,reg
Korey Veeder,Columbus Crew SC,D,0,0,0,0,0,0,0,0,0,0,0,0,0,0,0,2012,reg
Michael Tetteh,FC Dallas,D,0,0,0,0,0,0,0,0,0,0,0,0,0,0,0,2012,reg
Anthony Ampaipitakwong,San Jose Earthquakes ,M,0,0,0,0,0,0,0,0,0,0,0,0,0,0,0,2012,reg
Dan Keat,LA Galaxy,M,1,1,90,0,0,0,0,0,0,0,0,2,0,1,0,2012,reg
Michael Boxall,Minnesota United FC,D,0,0,0,0,0,0,0,0,0,0,0,0,0,0,0,2012,reg
Oscar Cordon,Toronto FC,M,0,0,0,0,0,0,0,0,0,0,0,0,0,0,0,2012,reg
Keith Makubuya,Toronto FC,F,1,0,10,0,0,0,0,0,0,0,0,0,1,0,0,2012,reg
Ethan White,DC United ,D,0,0,0,0,0,0,0,0,0,0,0,0,0,0,0,2012,reg
Jack McBean,LA Galaxy,F,1,0,8,0,0,0,0,0,0,0,0,1,2,0,0,2012,reg
Konrad Warzycha,Sporting Kansas City ,M,1,0,1,0,0,0,0,0,0,0,0,0,0,0,0,2012,reg
Kevin Ellis,Sporting Kansas City ,D,0,0,0,0,0,0,0,0,0,0,0,0,0,0,0,2012,reg
Eddie Ababio,Colorado Rapids,D,0,0,0,0,0,0,0,0,0,0,0,0,0,0,0,2012,reg
Aaron Horton,Columbus Crew SC,F,0,0,0,0,0,0,0,0,0,0,0,0,0,0,0,2012,reg
Dicoy Williams,Toronto FC,D,2,1,86,0,0,0,0,0,0,0,0,3,0,0,0,2012,reg
Pari Pantazopoulos,Chicago Fire FC,M,0,0,0,0,0,0,0,0,0,0,0,0,0,0,0,2012,reg
Josh Janniere,Colorado Rapids,M,0,0,0,0,0,0,0,0,0,0,0,0,0,0,0,2012,reg
Jimmy McLaughlin,FC Cincinnati,M,1,0,17,0,0,0,0,0,0,0,0,0,0,0,0,2012,reg
Porfirio López,Philadelphia Union,D,5,4,327,0,0,0,0,0,0,0,0,4,1,0,0,2012,reg
Josh Suggs,San Jose Earthquakes ,D,0,0,0,0,0,0,0,0,0,0,0,0,0,0,0,2012,reg
Luis Perea,FC Dallas,D,2,0,15,0,0,0,0,0,0,0,0,0,0,0,0,2012,reg
Scott Gordon,Chivas USA,D,3,0,23,0,0,0,0,0,0,0,0,2,0,0,0,2012,reg
Tiago Ulisses,Vancouver Whitecaps,M,0,0,0,0,0,0,0,0,0,0,0,0,0,0,0,2012,reg
Raphael Augusto,DC United ,M,0,0,0,0,0,0,0,0,0,0,0,0,0,0,0,2012,reg
Leone Cruz,Real Salt Lake,D,0,0,0,0,0,0,0,0,0,0,0,0,0,0,0,2012,reg
Harrison Henao,Colorado Rapids,M,1,0,22,0,0,0,0,0,0,0,0,0,0,0,0,2012,reg
Sebastián Rincón,Portland Timbers,F,0,0,0,0,0,0,0,0,0,0,0,0,0,0,0,2012,reg
Daniel Steres ,LA Galaxy,D,0,0,0,0,0,0,0,0,0,0,0,0,0,0,0,2012,reg
Alex Lee,FC Dallas,D,0,0,0,0,0,0,0,0,0,0,0,0,0,0,0,2012,reg
John Lozano,New England Revolution ,D,2,2,155,0,0,0,0,0,0,0,0,3,2,1,0,2012,reg
Kellen Gulley,Chicago Fire FC,F,0,0,0,0,0,0,0,0,0,0,0,0,0,0,0,2012,reg
Jose Angulo,New York Red Bulls ,F,0,0,0,0,0,0,0,0,0,0,0,0,0,0,0,2012,reg
Jhonny Arteaga,New York Red Bulls ,F,5,0,17,0,0,0,0,0,0,0,0,1,0,0,0,2012,reg
Ryan Maduro,New York Red Bulls ,M,0,0,0,0,0,0,0,0,0,0,0,0,0,0,0,2012,reg
Eduardo Sebrango,Montreal Impact,F,7,1,120,0,0,0,0,0,0,0,0,0,2,0,0,2012,reg
Marvin Iraheta,Chivas USA,M,0,0,0,0,0,0,0,0,0,0,0,0,0,0,0,2012,reg
Caleb Clarke,Vancouver Whitecaps,F,2,0,15,0,0,0,0,0,0,0,0,0,0,0,0,2012,reg
Karl Ouimette,Montreal Impact,D,2,0,66,0,0,0,0,0,0,0,0,1,0,0,0,2012,reg
Shane O'Neill,FC Dallas,D,1,0,4,0,0,0,0,0,0,0,0,0,0,0,0,2012,reg
Michael Roach,New England Revolution ,F,0,0,0,0,0,0,0,0,0,0,0,0,0,0,0,2012,reg
Krystian Witkowski ,Philadelphia Union,F,0,0,0,0,0,0,0,0,0,0,0,0,0,0,0,2012,reg
Ryan Kawulok,Portland Timbers,D,0,0,0,0,0,0,0,0,0,0,0,0,0,0,0,2012,reg
Cesar Diaz Pizarro,San Jose Earthquakes ,F,1,0,29,0,0,0,0,0,0,0,0,1,0,0,0,2012,reg
Kyle Miller,Sporting Kansas City ,M,0,0,0,0,0,0,0,0,0,0,0,0,0,0,0,2012,reg
Greg Klazura ,Vancouver Whitecaps,D-M,0,0,0,0,0,0,0,0,0,0,0,0,0,0,0,2012,reg
Charles Renken,Portland Timbers,M,0,0,0,0,0,0,0,0,0,0,0,0,0,0,0,2012,reg
Cyprian Hedrik,Sporting Kansas City ,D,0,0,0,0,0,0,0,0,0,0,0,0,0,0,0,2012,reg
Jacob Hustedt,San Jose Earthquakes ,M,0,0,0,0,0,0,0,0,0,0,0,0,0,0,0,2012,reg
Kenney Walker,LA Galaxy,M,1,1,45,0,0,0,0,0,0,0,0,1,0,0,0,2012,reg
Tony Walls,Chicago Fire FC,D,0,0,0,0,0,0,0,0,0,0,0,0,0,0,0,2012,reg
Kohei Yamada,Colorado Rapids,M,0,0,0,0,0,0,0,0,0,0,0,0,0,0,0,2012,reg
Lance Rozeboom ,DC United ,M,0,0,0,0,0,0,0,0,0,0,0,0,0,0,0,2012,reg
Enzo Martinez,Real Salt Lake,M,0,0,0,0,0,0,0,0,0,0,0,0,0,0,0,2012,reg
Colin Rolfe ,Houston Dynamo,F,0,0,0,0,0,0,0,0,0,0,0,0,0,0,0,2012,reg
Tyler Polak,New England Revolution ,D,1,0,30,0,0,0,0,0,0,0,0,0,2,0,0,2012,reg
Shawn Singh,Sporting Kansas City ,D,0,0,0,0,0,0,0,0,0,0,0,0,0,0,0,2012,reg
Babayele Sodade,FC Dallas,F,0,0,0,0,0,0,0,0,0,0,0,0,0,0,0,2012,reg
Diogo de Almeida,Real Salt Lake,D,0,0,0,0,0,0,0,0,0,0,0,0,0,0,0,2012,reg
Gienir García,Montreal Impact,D,0,0,0,0,0,0,0,0,0,0,0,0,0,0,0,2012,reg
Rafael Garcia ,LA Galaxy,D,1,0,5,0,0,0,0,0,0,0,0,0,0,0,0,2012,reg
Evan James,Montreal Impact,F,0,0,0,0,0,0,0,0,0,0,0,0,0,0,0,2012,reg
Greg Jordan,Philadelphia Union,M,0,0,0,0,0,0,0,0,0,0,0,0,0,0,0,2012,reg
Hunter Jumper,Chicago Fire FC,D,5,0,48,0,0,0,0,0,0,0,0,3,1,0,0,2012,reg
Tommy Meyer,LA Galaxy,D,8,7,660,0,0,0,0,0,0,0,0,2,0,0,0,2012,reg
Aubrey Perry,Columbus Crew SC,D,0,0,0,0,0,0,0,0,0,0,0,0,0,0,0,2012,reg
Nico Muñiz,Real Salt Lake,M,0,0,0,0,0,0,0,0,0,0,0,0,0,0,0,2012,reg
Bryce Alderson,Vancouver Whitecaps,M,0,0,0,0,0,0,0,0,0,0,0,0,0,0,0,2012,reg
José Adolfo Valencia,Portland Timbers,F,0,0,0,0,0,0,0,0,0,0,0,0,0,0,0,2012,reg
Ian Hogg,Portland Timbers,D,0,0,0,0,0,0,0,0,0,0,0,0,0,0,0,2012,reg
Jonathan Borrajo,New York Red Bulls ,D,1,0,74,0,0,0,0,0,0,0,0,1,0,0,0,2012,reg
Andrew Duran,FC Dallas,D,0,0,0,0,0,0,0,0,0,0,0,0,0,0,0,2012,reg
Chris Estridge,Real Salt Lake,D,0,0,0,0,0,0,0,0,0,0,0,0,0,0,0,2012,reg
Stephen Keel,New York Red Bulls ,D,9,6,501,0,0,0,0,0,0,0,0,3,2,1,0,2012,reg
Bobby Burling,Chivas USA,D,3,3,270,0,0,0,0,0,0,0,0,8,3,1,0,2012,reg
Shavar Thomas,Montreal Impact,D,15,13,1255,0,0,0,0,0,0,0,0,8,4,2,0,2012,reg
Anthony Wallace,Colorado Rapids,D,0,0,0,0,0,0,0,0,0,0,0,0,0,0,0,2012,reg
Sainey Nyassi,New England Revolution ,M,1,0,11,0,0,0,0,0,0,0,0,0,0,0,0,2012,reg
Kheli Dube,Chicago Fire FC,F,0,0,0,0,0,0,0,0,0,0,0,0,0,0,0,2012,reg
Bryan Jordan,LA Galaxy,D,8,4,405,0,0,0,0,0,0,0,0,4,2,0,0,2012,reg
Michael Videira,Chicago Fire FC,M,3,0,40,0,0,0,0,0,0,0,0,3,0,0,0,2012,reg
Marcus Tracy,San Jose Earthquakes ,F,0,0,0,0,0,0,0,0,0,0,0,0,0,0,0,2012,reg
Jose Recio,Houston Dynamo,D,0,0,0,0,0,0,0,0,0,0,0,0,0,0,0,2012,reg
Ellis McLoughlin,San Jose Earthquakes ,F,0,0,0,0,0,0,0,0,0,0,0,0,0,0,0,2012,reg
Christian Sivebaek,FC Dallas,M,3,1,88,0,0,0,0,0,0,0,0,4,1,1,0,2012,reg
Dom Dwyer,Orlando City SC,F,1,0,4,0,0,0,0,0,0,0,0,1,0,0,0,2012,reg
O'Brian White,FC Dallas,F,0,0,0,0,0,0,0,0,0,0,0,0,0,0,0,2012,reg
Brad Ring,San Jose Earthquakes ,D,2,1,76,0,0,0,0,0,0,0,0,1,1,0,0,2012,reg
Jean-Marc Alexandre,San Jose Earthquakes,F,2,0,8,0,0,0,0,0,0,0,0,2,0,0,0,2012,reg
Amadou Sanyang,FC Dallas,D,0,0,0,0,0,0,0,0,0,0,0,0,0,0,0,2012,reg
Scott Palguta,Colorado Rapids,D,2,1,116,0,0,0,0,0,0,0,0,0,0,0,0,2012,reg
Edward Johnson,Portland Timbers,F,0,0,0,0,0,0,0,0,0,0,0,0,0,0,0,2012,reg
Björn Runström,New England Revolution ,F,3,0,32,0,0,0,0,0,0,0,0,1,0,0,0,2012,reg
Pablo Mastroeni,Colorado Rapids,M,2,2,150,0,0,0,0,0,0,0,0,0,3,0,0,2012,reg
Alessandro Nesta,Montreal Impact,D,8,8,633,0,0,0,0,0,0,0,0,4,4,0,0,2012,reg
Kurt Morsink,DC United ,M,0,0,0,0,0,0,0,0,0,0,0,0,0,0,0,2012,reg
Tim Ward,San Jose Earthquakes ,D,0,0,0,0,0,0,0,0,0,0,0,0,0,0,0,2012,reg
Jed Zayner,San Jose Earthquakes ,D,1,1,72,0,0,0,0,0,0,0,0,0,1,0,0,2012,reg
Bryan Arguez,Montreal Impact,M,0,0,0,0,0,0,0,0,0,0,0,0,0,0,0,2012,reg
Floyd Franks,Vancouver Whitecaps,M,2,0,9,0,0,0,0,0,0,0,0,1,0,0,0,2012,reg
Bakary Soumare,Philadelphia Union,D,1,1,90,0,0,0,0,0,0,0,0,0,1,0,0,2012,reg
Etienne Barbara,Vancouver Whitecaps,F,2,0,13,0,0,0,0,0,0,0,0,0,0,1,0,2012,reg
Andrew Boyens,LA Galaxy,D,2,2,180,0,0,0,0,0,0,0,0,1,1,0,0,2012,reg
Guillermo Franco,Chicago Fire FC,F,3,0,43,0,0,1,0,0,0,0,0,2,1,0,1,2012,reg
Atiba Harris,Vancouver Whitecaps,D,7,3,253,0,0,1,0,0,0,0,0,12,6,1,0,2012,reg
Marvell Wynne,Colorado Rapids,D,28,28,2520,0,0,1,0,0,0,0,0,13,18,1,0,2012,reg
Chris Albright,Philadelphia Union,D,8,3,246,0,0,1,1,0,0,0,0,4,3,0,0,2012,reg
Mario Martinez,FC Dallas,M,3,0,40,0,0,1,0,0,0,0,0,2,1,1,0,2012,reg
Jeremiah White,New England Revolution ,M,2,0,31,0,0,1,0,0,0,0,0,2,0,0,0,2012,reg
Luke Sassano,Sporting Kansas City ,D,1,0,14,0,0,1,0,0,0,0,0,0,0,0,0,2012,reg
Neven Markovic,Sporting Kansas City ,D,2,1,96,0,0,1,0,0,0,0,0,4,3,0,0,2012,reg
Bruno Guarda,FC Dallas,M,4,1,169,0,0,1,1,0,0,0,0,1,2,0,0,2012,reg
A.J. DeLaGarza,,D,30,30,2644,0,0,1,0,0,0,0,0,41,32,4,0,2012,reg
Carlyle Mitchell,Vancouver Whitecaps,D,2,2,180,0,0,1,0,0,0,0,0,1,2,0,0,2012,reg
Alec Purdie ,New England Revolution ,F,5,1,123,0,0,1,1,0,0,0,0,0,4,0,0,2012,reg
Chris Klute,Colorado Rapids,D,1,1,90,0,0,1,1,0,0,0,0,1,0,0,0,2012,reg
David Viana,Real Salt Lake,M,2,0,27,0,0,1,0,0,0,0,0,2,0,0,0,2012,reg
Marky Delgado,Toronto FC,M,1,0,17,0,0,1,0,0,0,0,0,1,0,0,0,2012,reg
Cristhian Hernandez,Philadelphia Union,F,2,0,26,0,0,1,0,0,0,0,0,0,0,0,0,2012,reg
Servando Carrasco,FC Dallas,M,9,2,235,0,0,1,0,0,0,0,0,4,2,1,0,2012,reg
Freddie Braun ,Portland Timbers,M,3,0,86,0,0,1,0,0,0,0,0,1,0,0,0,2012,reg
Korede Aiyegbusi,Sporting Kansas City ,D,1,0,19,0,0,1,0,0,0,0,0,0,0,0,0,2012,reg
Michael Nanchoff,Vancouver Whitecaps,M,9,1,145,0,0,2,0,0,0,0,0,2,2,1,0,2012,reg
Bobby Warshaw,FC Dallas,D,6,2,298,0,0,2,1,0,0,0,0,3,4,0,0,2012,reg
Tyler Ruthven,New York Red Bulls ,D,5,4,379,0,0,2,0,0,0,0,0,3,1,1,0,2012,reg
Chandler Hoffman,Philadelphia Union,F,7,2,204,0,0,2,0,0,0,0,0,1,1,0,0,2012,reg
Adrian Cann,Toronto FC,D,10,8,735,0,0,2,1,0,0,0,0,6,6,1,0,2012,reg
Leonardo González,FC Dallas,D,19,15,1377,0,0,2,0,0,0,0,0,24,5,3,0,2012,reg
Roger Levesque,FC Dallas,M,4,2,183,0,0,2,1,0,0,0,0,2,1,0,0,2012,reg
Steve Purdy,Portland Timbers,D,3,3,188,0,0,2,0,0,0,0,0,3,2,1,0,2012,reg
Ty Harden,Toronto FC,D,5,5,379,0,0,2,1,0,0,0,0,4,1,1,0,2012,reg
Mike Chabala,DC United ,D,12,8,800,0,0,2,1,0,0,0,0,8,4,2,0,2012,reg
Andy O'Brien,Vancouver Whitecaps,D,8,7,660,0,0,2,1,0,0,0,0,6,7,0,0,2012,reg
Cory Gibbs,Chicago Fire FC,D,3,3,270,0,0,2,0,0,0,0,0,4,2,1,0,2012,reg
Carlos Mendes,Columbus Crew SC,D,12,12,949,0,0,2,0,0,0,0,0,21,7,2,0,2012,reg
Ante Jazic,Chivas USA,D,27,27,2379,0,0,2,0,0,0,0,0,8,10,0,0,2012,reg
Sercan Güvenisik,San Jose Earthquakes ,F,5,1,87,0,0,3,0,0,0,0,0,2,2,0,0,2012,reg
Danny O'Rourke,Columbus Crew SC,D,21,18,1603,0,0,3,0,0,0,0,0,30,8,5,0,2012,reg
Nathan Sturgis,Houston Dynamo,M,5,4,332,0,0,3,0,0,0,0,0,5,3,0,0,2012,reg
Juan Toja,New England Revolution ,M,5,0,148,0,0,3,1,0,0,0,0,7,10,1,0,2012,reg
Victor Palsson,New York Red Bulls ,M,16,4,463,0,0,3,0,0,0,0,0,12,2,3,1,2012,reg
Kevan George,Columbus Crew SC,M,7,4,427,0,0,3,0,0,0,0,0,7,2,2,0,2012,reg
Calum Mallace,Montreal Impact,M,4,4,289,0,0,3,1,0,0,0,0,3,1,0,0,2012,reg
John Valencia,Chivas USA,D,14,14,1219,0,0,3,1,0,0,0,0,17,11,5,0,2012,reg
Ben Speas,Columbus Crew SC,M-F,1,1,64,0,0,3,1,0,0,0,0,0,0,0,0,2012,reg
Kyle Nakazawa,LA Galaxy,M,5,2,193,0,0,3,1,0,0,0,0,3,0,0,0,2012,reg
James Marcelin,FC Dallas,M,19,6,678,0,0,3,2,0,0,0,0,10,5,1,0,2012,reg
Bryan Leyva,FC Dallas,M,8,6,433,0,0,3,1,0,0,0,0,2,7,0,0,2012,reg
Orr Barouch,Chicago Fire FC,F,9,1,224,0,0,4,1,0,0,0,0,9,4,2,0,2012,reg
Emiliano Dudar,DC United ,D,11,10,898,0,0,4,1,0,0,0,0,10,2,3,1,2012,reg
Mike Fucito,Montreal Impact,F,13,3,424,0,0,4,0,0,0,0,0,7,5,0,0,2012,reg
Abdoulie Mansally,New England Revolution ,D,5,4,364,0,0,4,0,0,0,0,0,6,4,1,0,2012,reg
Julius James,Columbus Crew SC,D,12,7,714,0,0,4,0,0,0,0,0,8,11,2,0,2012,reg
Mamadou Danso,Portland Timbers,D,10,9,853,0,0,5,2,0,0,0,0,5,9,2,0,2012,reg
Aaron Maund,Toronto FC,D,15,9,947,0,0,5,1,0,0,0,0,13,7,2,0,2012,reg
Kwame Watson-Siriboe,Chicago Fire FC,D,12,10,918,0,0,5,1,0,0,0,0,15,5,3,0,2012,reg
Ethan Finlay,Minnesota United FC,M,15,3,426,0,0,5,3,0,0,0,0,5,7,0,0,2012,reg
Brent Richards,Portland Timbers,F,6,2,201,0,0,5,1,0,0,0,0,0,2,0,0,2012,reg
Rafael Robayo,Chicago Fire FC,M,16,3,439,0,0,5,0,0,0,0,0,4,2,1,0,2012,reg
Jun Marques Davidson,Vancouver Whitecaps,M,24,24,2115,0,0,5,0,0,0,0,0,36,16,7,0,2012,reg
Michael Thomas,Sporting Kansas City ,M,7,3,344,0,0,6,1,0,0,0,0,6,2,1,0,2012,reg
Josh Gardner,Montreal Impact,M,6,5,451,0,0,6,0,0,0,0,0,9,4,1,0,2012,reg
Kai Herdling,Philadelphia Union,M-F,4,3,212,0,0,6,0,0,0,0,0,7,8,0,0,2012,reg
Giles Barnes,Houston Dynamo,M,4,1,149,0,0,6,1,0,0,0,0,2,3,0,0,2012,reg
Edu,Colorado Rapids,F,9,3,330,0,0,7,3,0,0,0,0,3,11,0,0,2012,reg
Miguel Montaño,Montreal Impact,F,3,1,115,0,0,7,1,0,0,0,0,1,3,0,0,2012,reg
Lawrence Olum,Sporting Kansas City ,D,21,10,908,0,0,7,0,0,0,0,0,8,1,3,0,2012,reg
Sebastian Velasquez,Real Salt Lake,M,9,5,403,0,0,7,1,0,0,0,0,5,11,0,0,2012,reg
Yordany Álvarez,Real Salt Lake,M,15,5,500,0,0,7,0,0,0,0,0,12,3,1,0,2012,reg
Matt Watson,Vancouver Whitecaps,M,15,10,969,0,0,8,1,0,0,0,0,9,22,1,0,2012,reg
Jorge Perlaza,Philadelphia Union,F,12,7,562,0,0,8,2,0,0,0,0,5,7,0,0,2012,reg
Ike Opara,Minnesota United FC,D,16,7,763,0,0,8,2,0,0,0,0,11,11,0,0,2012,reg
Hendry Thomas,Colorado Rapids,M,8,8,695,0,0,8,0,0,0,0,0,17,10,1,0,2012,reg
Michael Lahoud,Chivas USA,M,24,19,1601,0,0,8,0,0,0,0,0,22,17,4,0,2012,reg
Cam Weaver,Houston Dynamo,F,9,2,253,0,0,9,4,0,0,0,0,6,4,1,0,2012,reg
Diego Chara,Portland Timbers,M,28,28,2473,0,0,9,2,0,0,0,0,72,38,10,1,2012,reg
Logan Emory,Toronto FC,D,23,19,1621,0,0,9,2,0,0,0,0,27,9,1,2,2012,reg
Daniel Hernandez,FC Dallas,M,28,22,1938,0,0,12,2,0,0,0,0,38,24,4,2,2012,reg
George John,FC Dallas,D,23,19,1756,0,0,12,3,0,0,0,0,25,21,4,0,2012,reg
Matteo Ferrari,Montreal Impact,D,25,23,2029,0,0,12,4,0,0,0,0,26,11,3,0,2012,reg
David Júnior Lopes,Chivas USA,D,17,16,1407,0,0,14,3,0,0,0,0,24,19,4,1,2012,reg
Lovel Palmer,Portland Timbers,D,19,15,1331,0,0,15,2,0,0,0,0,12,5,4,1,2012,reg
Je-Vaughn Watson,Houston Dynamo,D,19,13,1096,0,0,18,6,0,0,0,0,16,14,1,0,2012,reg
Joao Plata,Toronto FC,F,10,7,638,0,0,20,2,0,0,0,0,5,12,0,0,2012,reg
Camilo Sanvezzo,Vancouver Whitecaps,F,32,27,2418,22,6,123,55,14,8,3,3,51,43,5,0,2013,reg
Mike Magee,Chicago Fire FC,M,32,32,2793,21,4,114,50,13,8,2,2,31,41,4,0,2013,reg
Marco Di Vaio,Montreal Impact,F,33,31,2746,20,2,118,53,15,5,2,0,14,33,4,0,2013,reg
Robbie Keane,LA Galaxy,F,23,22,1980,16,11,65,29,13,3,6,5,18,27,2,0,2013,reg
Diego Fagundez,New England Revolution,M,31,28,2427,13,7,55,29,8,5,4,3,22,16,3,0,2013,reg
Dominic Oduro,Columbus Crew SC,M,34,34,2854,13,4,92,36,4,9,2,2,25,67,3,1,2013,reg
Alvaro Saborio,Real Salt Lake,F,16,15,1346,12,2,53,21,6,6,2,0,25,17,1,0,2013,reg
Jack McInerney,Philadelphia Union,F,31,25,2209,12,0,86,30,4,8,0,0,34,27,4,0,2013,reg
Federico Higuain,DC United,F,29,29,2592,11,9,86,31,8,3,3,6,20,20,6,1,2013,reg
Tim Cahill,New York Red Bulls ,M,27,27,2243,11,5,55,21,5,6,4,1,78,43,4,0,2013,reg
Blas Pérez,FC Dallas,F,25,21,2019,11,3,56,29,5,6,0,3,39,48,5,1,2013,reg
Chris Wondolowski,San Jose Earthquakes,F,29,29,2610,11,3,101,44,9,2,3,0,33,33,5,0,2013,reg
Diego Valeri,Portland Timbers,M,31,28,2277,10,13,72,26,5,5,9,4,39,43,2,0,2013,reg
Landon Donovan,LA Galaxy,M-F,22,21,1874,10,9,38,19,4,6,3,6,24,28,1,0,2013,reg
Thierry Henry,New York Red Bulls ,F,30,27,2519,10,9,92,29,8,2,5,4,20,31,3,0,2013,reg
Conor Casey,Philadelphia Union,F,31,25,2201,10,5,64,26,6,4,2,3,58,26,9,0,2013,reg
Claudio Bieler,Sporting Kansas City ,F,28,25,2109,10,4,70,27,8,2,3,1,35,32,4,0,2013,reg
Deshorn Brown,Colorado Rapids,F,31,24,2169,10,4,97,30,6,4,3,1,24,17,1,0,2013,reg
Will Johnson,Portland Timbers,D,28,28,2520,9,5,55,20,4,5,3,2,23,45,4,0,2013,reg
Ryan Johnson,Portland Timbers,F,29,21,1770,9,4,43,22,7,2,1,3,25,29,2,0,2013,reg
Darlington Nagbe,Columbus Crew SC,M,34,34,2848,9,4,62,24,3,6,3,1,8,83,1,0,2013,reg
Giles Barnes,Houston Dynamo,M,33,32,2561,9,4,94,29,7,2,2,2,26,35,2,0,2013,reg
Juan Agudelo,,F,20,15,1402,9,2,30,13,5,4,0,2,54,36,2,0,2013,reg
Fabian Espindola,New York Red Bulls ,F,28,23,2054,9,2,48,26,6,3,2,0,41,58,3,0,2013,reg
Eddie Johnson,FC Dallas,F,21,20,1725,9,2,51,27,5,4,1,1,19,35,6,0,2013,reg
Javier Morales,Real Salt Lake,M,28,25,2281,8,10,46,18,6,2,6,4,23,78,5,0,2013,reg
Will Bruin,FC Dallas,F,30,30,2596,8,7,98,30,5,3,4,3,24,19,0,0,2013,reg
Obafemi Martins,FC Dallas,F,20,17,1466,8,4,43,16,6,2,4,0,17,28,0,1,2013,reg
Lamar Neagle,FC Dallas,M,30,27,2409,8,4,61,25,8,0,3,1,54,32,1,1,2013,reg
Kenny Miller,Vancouver Whitecaps,F,21,19,1643,8,1,41,15,5,3,0,1,20,21,0,0,2013,reg
Robert Earnshaw,Toronto FC,F,26,23,1883,8,0,69,22,5,3,0,0,16,22,1,0,2013,reg
Kelyn Rowe,New England Revolution,M,33,26,2528,7,8,74,21,5,2,6,2,27,46,4,0,2013,reg
Rodney Wallace,Portland Timbers,D,27,21,1972,7,6,49,18,3,4,5,1,35,16,3,0,2013,reg
Kei Kamara,Colorado Rapids,F,15,10,1022,7,2,42,13,6,1,2,0,16,14,0,0,2013,reg
Erick Torres,Chivas USA,F,15,15,1349,7,1,45,21,4,3,1,0,28,30,3,0,2013,reg
Graham Zusi,Sporting Kansas City,M,27,26,2357,6,8,50,19,3,3,1,7,28,54,1,0,2013,reg
Robbie Findley,Real Salt Lake,F,25,17,1260,6,2,36,15,4,2,2,0,8,29,1,0,2013,reg
Kekuta Manneh,FC Cincinnati,F,20,6,764,6,2,38,15,2,4,2,0,1,9,1,0,2013,reg
Kenny Cooper,FC Dallas,F,31,19,1741,6,1,45,21,4,2,0,1,22,24,2,1,2013,reg
Felipe,DC United,M,32,28,2350,5,8,55,24,3,2,5,3,32,58,6,0,2013,reg
Dillon Powers,Colorado Rapids,M,30,29,2457,5,6,27,11,3,2,4,2,29,62,4,0,2013,reg
Jonny Steele,New York Red Bulls ,M,33,32,2665,5,6,46,15,3,2,4,2,42,18,4,0,2013,reg
Ned Grabavoy,Real Salt Lake,M,32,29,2688,5,5,29,10,1,4,4,1,37,63,5,0,2013,reg
Saer Sene,New England Revolution ,M,24,14,1218,5,5,41,18,4,1,3,2,17,7,1,1,2013,reg
Olmes Garcia,Real Salt Lake,F,24,8,996,5,4,33,15,2,3,2,2,26,26,5,0,2013,reg
Luis Gil,Real Salt Lake,M,30,24,2060,5,3,36,13,5,0,1,2,20,21,2,0,2013,reg
Edson Buddle,Colorado Rapids,F,24,19,1664,5,3,56,17,2,3,3,0,37,21,1,0,2013,reg
Lloyd Sam,New York Red Bulls ,M-F,22,8,814,5,1,7,5,2,3,0,1,10,13,0,1,2013,reg
Jonathan Osorio,Toronto FC,M,28,18,1697,5,1,28,8,5,0,1,0,15,31,1,0,2013,reg
Atiba Harris,Colorado Rapids,D,29,24,2012,5,1,51,16,4,1,0,1,52,43,2,1,2013,reg
Brad Davis,Houston Dynamo,M,26,25,2204,4,9,40,19,2,2,6,3,27,35,2,1,2013,reg
Patrice Bernier,Montreal Impact,M,31,28,2474,4,8,23,7,2,2,7,1,50,43,4,0,2013,reg
Mauro Rosales,FC Dallas,M,33,26,2175,4,8,24,7,2,2,4,4,20,43,2,0,2013,reg
Joao Plata,Real Salt Lake,F,29,19,1645,4,8,50,19,2,2,5,3,16,16,1,0,2013,reg
Lee Nguyen,,M,33,32,2838,4,7,56,22,3,1,4,3,63,64,6,0,2013,reg
Kyle Beckerman,Real Salt Lake,M,26,26,2281,4,6,46,17,3,1,3,3,26,17,7,0,2013,reg
Marcelo Sarvas,LA Galaxy,M,33,33,2897,4,6,53,15,2,2,3,3,80,62,9,0,2013,reg
Brad Evans,FC Dallas,D-M,24,21,1761,4,5,37,11,3,1,4,1,22,25,3,0,2013,reg
Dax McCarty,Nashville SC,M,30,29,2582,4,4,17,6,3,1,1,3,28,36,2,0,2013,reg
Patrick Nyarko,Chicago Fire FC,F-M,30,24,2153,4,4,40,16,2,2,2,2,33,70,1,0,2013,reg
Ricardo Clark,Houston Dynamo,M,30,29,2517,4,4,46,11,3,1,2,2,36,51,2,0,2013,reg
Soony Saad,Sporting Kansas City ,F,23,15,1353,4,4,58,15,3,1,4,0,18,31,1,0,2013,reg
Gyasi Zardes,Columbus Crew SC,F,27,23,2170,4,4,78,23,2,2,4,0,26,31,1,0,2013,reg
Alan Gordon,San Jose Earthquakes ,F,24,17,1436,4,3,40,14,2,2,1,2,53,33,7,1,2013,reg
Dilly Duka,Chicago Fire FC,M,31,24,1788,4,3,62,28,2,2,1,2,39,23,3,0,2013,reg
Eric Alexander,New York Red Bulls ,M,34,30,2504,4,2,33,9,2,2,2,0,19,18,2,0,2013,reg
CJ Sapong,Chicago Fire FC,F,25,16,1551,4,2,33,13,2,2,1,1,39,49,1,1,2013,reg
Steven Lenhart,San Jose Earthquakes ,F,21,14,1322,4,2,35,13,1,3,2,0,36,39,7,1,2013,reg
Jordan Harvey,LAFC,D,24,23,2082,4,1,10,6,2,2,1,0,25,18,5,0,2013,reg
Nathan Sturgis,Colorado Rapids,M,25,23,2037,4,1,27,7,3,1,0,1,34,22,6,0,2013,reg
Bernardo Añor,Columbus Crew SC,M,20,19,1663,4,1,53,17,2,2,1,0,34,35,4,0,2013,reg
Chris Rolfe,Chicago Fire FC,F,31,26,2135,4,1,69,19,3,1,0,1,17,20,3,0,2013,reg
Jámison Olave,New York Red Bulls ,D,29,27,2368,4,0,11,6,1,3,0,0,38,13,4,1,2013,reg
Adam Jahn,Atlanta United FC,F,22,11,1059,4,0,29,10,4,0,0,0,16,9,1,0,2013,reg
Sébastien Le Toux,Philadelphia Union,F,32,25,2222,3,12,34,13,1,2,10,2,11,25,0,0,2013,reg
David Ferreira,FC Dallas,M,30,26,2419,3,9,32,10,0,3,6,3,24,76,4,0,2013,reg
Michel Garbini Pereira,FC Dallas,M-D,31,26,2284,3,8,29,10,2,1,5,3,30,26,3,0,2013,reg
Boniek Garcia,Houston Dynamo,M,22,21,1899,3,6,18,5,2,1,4,2,27,35,4,0,2013,reg
Hector Jimenez,Columbus Crew SC,M,26,14,1178,3,4,20,7,1,2,0,4,10,13,0,0,2013,reg
Dimitry Imbongo,New England Revolution ,F,21,11,1041,3,4,30,10,1,2,3,1,37,30,5,3,2013,reg
Benny Feilhaber,Sporting Kansas City ,M,27,22,1774,3,4,33,12,2,1,4,0,26,45,4,0,2013,reg
Luis Silva,DC United ,F,27,24,1982,3,4,45,16,2,1,3,1,20,29,3,0,2013,reg
Jairo Arrieta,Columbus Crew SC,F,26,21,1862,3,4,64,18,0,3,3,1,44,28,6,0,2013,reg
Hassoun Camara,Montreal Impact,D,32,32,2874,3,3,20,6,1,2,1,2,35,35,7,0,2013,reg
Amobi Okugo,Philadelphia Union,D-M,32,32,2879,3,3,25,6,2,1,0,3,36,24,6,1,2013,reg
Gershon Koffie,Vancouver Whitecaps,M,26,21,1911,3,3,25,9,3,0,3,0,33,46,6,0,2013,reg
Kalif Alhassan,Portland Timbers,M,30,15,1324,3,3,34,11,3,0,3,0,20,28,2,0,2013,reg
Jackson Goncalves,FC Dallas,M,30,29,2375,3,3,61,17,3,0,1,2,57,44,5,2,2013,reg
Mauro Diaz,FC Dallas,M,10,5,423,3,2,11,6,2,1,2,0,3,8,0,0,2013,reg
Antoine Hoppenot,Philadelphia Union,F,30,2,732,3,2,20,8,1,2,0,2,15,23,3,0,2013,reg
Eric Avila,Chivas USA,M,28,24,2183,3,2,27,10,1,2,1,1,25,50,1,1,2013,reg
Danny Cruz,Philadelphia Union,M-F,32,32,2190,3,2,56,19,2,1,0,2,31,45,5,0,2013,reg
Dwayne De Rosario,DC United ,M,24,17,1603,3,2,59,22,2,1,1,1,25,38,2,0,2013,reg
Gabriel Torres,Colorado Rapids,M-F,7,5,507,3,1,15,4,3,0,1,0,2,5,0,0,2013,reg
Warren Creavalle,Philadelphia Union,M,27,17,1629,3,1,22,7,1,2,1,0,22,17,3,0,2013,reg
Andrew Driver,Houston Dynamo,M,26,20,1694,3,1,24,11,0,3,0,1,25,9,5,0,2013,reg
Aurelien Collin,Philadelphia Union,D,29,29,2565,3,1,33,9,1,2,1,0,54,24,13,0,2013,reg
Adam Moffat,Houston Dynamo,M,32,28,2332,3,1,36,6,0,3,1,0,32,18,4,0,2013,reg
Andrew Jacobson,FC Dallas,M,27,27,2292,3,1,40,9,2,1,1,0,46,38,3,0,2013,reg
Kyle Porter,DC United ,M,27,18,1594,3,1,41,13,3,0,0,1,22,24,3,0,2013,reg
Darren Mattocks,Vancouver Whitecaps,F,20,8,911,3,1,45,14,2,1,1,0,14,12,0,0,2013,reg
Quincy Amarikwa,Chicago Fire FC,F,14,0,299,3,0,12,7,0,3,0,0,17,10,0,0,2013,reg
Ike Opara,Minnesota United FC,D,18,15,1397,3,0,13,6,0,3,0,0,25,4,3,0,2013,reg
Matt Hedges,FC Dallas,D,33,32,2793,3,0,13,4,2,1,0,0,19,16,1,0,2013,reg
Darel Russell,Toronto FC,D,18,10,924,3,0,16,9,3,0,0,0,21,17,5,0,2013,reg
Drew Moor,Colorado Rapids,D,32,31,2793,3,0,18,6,1,2,0,0,17,24,1,1,2013,reg
Devon Sandoval,Real Salt Lake,F,17,10,885,3,0,18,9,1,2,0,0,13,12,1,0,2013,reg
Josh Williams,Columbus Crew SC,D,27,25,2284,3,0,21,8,1,2,0,0,18,13,2,0,2013,reg
Russell Teibert,Vancouver Whitecaps,M,24,19,1777,2,9,29,7,2,0,5,4,16,23,4,0,2013,reg
Sheanon Williams,Philadelphia Union,D-M,32,32,2867,2,8,14,3,2,0,5,3,42,42,6,1,2013,reg
Joel Lindpere,Chicago Fire FC,M,25,17,1444,2,8,18,6,2,0,3,5,13,17,2,0,2013,reg
Justin Mapp,Montreal Impact,M,27,25,2137,2,8,34,15,0,2,7,1,21,43,2,0,2013,reg
Shea Salinas,San Jose Earthquakes,M,28,24,1982,2,8,35,16,2,0,5,3,21,30,1,0,2013,reg
Fabian Castillo,FC Dallas,M-F,33,26,2176,2,6,45,16,2,0,2,4,30,21,7,0,2013,reg
Daigo Kobayashi,Vancouver Whitecaps,M,30,21,1651,2,4,18,6,1,1,1,3,15,24,1,0,2013,reg
Sam Cronin,San Jose Earthquakes ,M,34,34,2971,2,4,28,7,1,1,4,0,48,25,4,0,2013,reg
Jeff Larentowicz,Atlanta United FC,M,32,31,2807,2,4,45,13,1,1,4,0,47,30,6,1,2013,reg
Daniel Paladini,Chicago Fire FC,M,20,7,823,2,3,12,6,2,0,2,1,11,9,5,1,2013,reg
Chance Myers,Sporting Kansas City ,D,27,26,2383,2,3,24,7,2,0,1,2,38,24,3,0,2013,reg
Carlos Alvarez,Chivas USA,M,29,26,2182,2,3,35,10,1,1,1,2,24,22,5,0,2013,reg
Chris Pontius,DC United ,M,22,19,1754,2,3,40,11,2,0,3,0,21,44,0,0,2013,reg
Chad Barrett,New England Revolution ,F,19,8,622,2,2,11,5,1,1,2,0,5,8,1,0,2013,reg
Justin Braun,Toronto FC,F,21,8,779,2,2,12,5,1,1,2,0,22,15,4,0,2013,reg
Jeb Brovsky,Montreal Impact,D,30,29,2610,2,2,14,6,1,1,2,0,21,14,5,0,2013,reg
Walter Martinez,San Jose Earthquakes,M,15,10,919,2,2,16,5,2,0,2,0,15,30,1,0,2013,reg
Andres Romero,Montreal Impact,M,30,20,1672,2,2,18,7,1,1,1,1,27,31,4,0,2013,reg
Maicon Santos,Chicago Fire FC,F,15,1,379,2,2,20,5,2,0,2,0,7,7,1,0,2013,reg
Je-Vaughn Watson,FC Dallas,D,24,15,1372,2,2,20,10,2,0,1,1,26,17,4,1,2013,reg
Dom Dwyer,Orlando City SC,F,16,7,674,2,2,28,7,2,0,1,1,14,15,0,0,2013,reg
Tristan Bowen,Chivas USA,F,22,15,1173,2,2,32,7,1,1,2,0,23,19,6,1,2013,reg
Blake Smith,Montreal Impact,D,16,0,276,2,1,7,3,2,0,1,0,2,5,1,0,2013,reg
Brian Carroll,Philadelphia Union,M,33,33,2969,2,1,16,5,2,0,1,0,40,14,6,0,2013,reg
Conor Doyle,DC United ,F,14,8,805,2,1,23,11,1,1,1,0,3,9,0,0,2013,reg
Andrew Wiedeman,Toronto FC,F,14,9,821,2,1,25,5,2,0,1,0,5,6,0,0,2013,reg
Daniele Paponi,Montreal Impact,F,16,8,800,2,1,29,11,2,0,1,0,9,16,2,0,2013,reg
Hendry Thomas,Colorado Rapids,M,27,27,2301,2,1,33,5,2,0,1,0,59,35,7,0,2013,reg
Juan Luis Anangono,Chicago Fire FC,F,13,9,839,2,1,34,10,1,1,0,1,23,12,1,0,2013,reg
Jose Villarreal,LA Galaxy,M,22,12,1109,2,1,37,12,1,1,0,1,22,20,0,0,2013,reg
Nick DeLeon,Toronto FC,M,25,23,1912,2,1,37,13,1,1,0,1,13,18,2,0,2013,reg
Ibrahim Sekagya,New York Red Bulls ,D,8,8,702,2,0,3,2,1,1,0,0,11,5,1,1,2013,reg
Walker Zimmerman,Nashville SC,D,7,4,411,2,0,4,3,1,1,0,0,2,1,0,0,2013,reg
Bryan de la Fuente,Chivas USA,F,11,11,884,2,0,8,3,2,0,0,0,18,12,0,0,2013,reg
José Gonçalves,New England Revolution ,D,34,34,3060,2,0,9,6,0,2,0,0,32,38,3,0,2013,reg
George John,FC Dallas,D,24,24,2070,2,0,13,5,2,0,0,0,27,22,3,0,2013,reg
Jared Jeffrey,DC United ,M,10,10,796,2,0,16,5,1,1,0,0,24,6,3,0,2013,reg
Julio Morales,Chivas USA,F,17,9,768,2,0,17,8,1,1,0,0,14,16,2,0,2013,reg
Lionard Pajoy,DC United ,F,20,11,1130,2,0,21,5,2,0,0,0,26,15,2,0,2013,reg
Cam Weaver,Houston Dynamo,F,22,6,709,2,0,21,5,2,0,0,0,22,15,1,0,2013,reg
Peguy Luyindula,New York Red Bulls ,F,22,9,863,1,7,21,12,1,0,4,3,8,15,1,0,2013,reg
Davy Arnaud,Montreal Impact,M,24,21,1766,1,5,13,6,0,1,3,2,34,43,5,0,2013,reg
Chris Tierney,New England Revolution ,D-M,29,26,2352,1,5,19,3,1,0,3,2,15,14,2,0,2013,reg
Frederic Piquionne,Portland Timbers,F,21,7,783,1,5,30,9,1,0,1,4,20,13,0,0,2013,reg
Perry Kitchen,LA Galaxy,M,31,31,2773,1,4,10,3,1,0,2,2,42,43,6,0,2013,reg
Vicente Sanchez,Colorado Rapids,F,8,7,623,1,4,12,5,1,0,3,1,10,11,0,0,2013,reg
Edgar Mejia,Chivas USA,M,28,27,2266,1,4,12,4,0,1,2,2,16,23,2,1,2013,reg
Sean Franklin,LA Galaxy,D,33,29,2736,1,4,15,3,1,0,3,1,29,22,3,0,2013,reg
Jorge Villafaña,Portland Timbers,F,20,15,1432,1,4,16,2,1,0,2,2,13,21,2,0,2013,reg
Nigel Reo-Coker,Vancouver Whitecaps,M,32,31,2817,1,4,17,5,0,1,4,0,62,39,9,0,2013,reg
Bobby Convey,Sporting Kansas City ,M,24,22,1908,1,4,17,3,0,1,4,0,22,32,4,0,2013,reg
Juninho,LA Galaxy,M,32,32,2770,1,4,50,14,1,0,3,1,42,32,6,0,2013,reg
Steven Beitashour,San Jose Earthquakes ,D,27,27,2426,1,3,5,1,0,1,2,1,23,22,0,0,2013,reg
Ramon Nunez,FC Dallas,M,10,0,253,1,3,11,3,0,1,2,1,2,4,0,0,2013,reg
Jalil Anibaba,Nashville SC,D,34,34,3060,1,3,16,7,0,1,2,1,15,13,3,0,2013,reg
Martin Rivero,Colorado Rapids,M,16,6,705,1,3,16,5,0,1,2,1,9,17,1,0,2013,reg
José Adolfo Valencia,Portland Timbers,F,21,5,636,1,3,20,6,0,1,2,1,16,11,1,0,2013,reg
Andrew Wenger,Montreal Impact,D-M,24,8,853,1,3,24,8,1,0,2,1,17,9,1,0,2013,reg
Nick LaBrocca,Colorado Rapids,M,24,16,1214,1,3,27,10,1,0,2,1,13,12,3,0,2013,reg
Jeremy Brockie,Toronto FC,F-M,15,11,1072,1,3,31,12,1,0,3,0,18,16,1,0,2013,reg
Justin Morrow,Toronto FC,D,26,21,1937,1,2,7,1,0,1,1,1,16,14,1,1,2013,reg
Ben Zemanski,Portland Timbers,M,25,9,989,1,2,8,2,0,1,2,0,21,6,5,1,2013,reg
Fabinho,Philadelphia Union,D,14,10,980,1,2,9,1,0,1,2,0,10,18,0,1,2013,reg
Nat Borchers,Real Salt Lake,D,28,28,2520,1,2,9,4,0,1,0,2,13,16,1,0,2013,reg
Andy Rose,Vancouver Whitecaps,M,18,9,888,1,2,10,4,1,0,2,0,17,4,2,0,2013,reg
DeAndre Yedlin,Seattle Sounders FC,D,31,30,2710,1,2,13,4,1,0,1,1,35,27,2,1,2013,reg
Austin Berry,Chicago Fire FC,D,34,34,3060,1,2,14,5,1,0,1,1,17,16,2,0,2013,reg
Jack McBean,LA Galaxy,F,15,7,554,1,2,19,8,1,0,0,2,6,17,0,0,2013,reg
Cordell Cato,San Jose Earthquakes ,F,20,10,1030,1,2,19,5,0,1,0,2,13,19,0,0,2013,reg
Omar Gonzalez,Toronto FC,D,27,27,2368,1,2,19,4,1,0,2,0,17,14,2,0,2013,reg
Jose Kleberson,Philadelphia Union,M,11,7,532,1,2,24,4,1,0,0,2,6,6,1,0,2013,reg
Oriol Rosell,Orlando City SC,M-D,31,31,2691,1,2,24,5,0,1,2,0,66,34,10,0,2013,reg
Hunter Jumper,Chicago Fire FC,D,2,2,180,1,1,2,1,1,0,1,0,5,0,1,0,2013,reg
Maxim Tissot,Montreal Impact,D,6,3,303,1,1,2,2,0,1,1,0,2,2,1,0,2013,reg
Michael Stephens,LA Galaxy,M,21,8,775,1,1,3,1,0,1,1,0,9,3,0,0,2013,reg
Matias Sanchez,Columbus Crew SC,M,14,10,820,1,1,6,1,1,0,0,1,32,12,5,0,2013,reg
Lawrence Olum,Sporting Kansas City ,D,20,9,1002,1,1,6,2,0,1,0,1,16,6,4,0,2013,reg
Tom Heinemann,Vancouver Whitecaps,F,14,3,286,1,1,7,2,1,0,1,0,11,6,0,0,2013,reg
Jeremy Hall,Toronto FC,D-M,31,26,2280,1,1,7,2,1,0,1,0,34,22,5,0,2013,reg
Jair Benítez,FC Dallas,D,31,28,2473,1,1,7,1,1,0,0,1,17,32,5,0,2013,reg
Matteo Ferrari,Montreal Impact,D,31,31,2790,1,1,8,2,1,0,1,0,27,19,8,0,2013,reg
Corey Hertzog,Vancouver Whitecaps,F,7,6,428,1,1,8,4,0,1,1,0,2,11,0,0,2013,reg
Aaron Wheeler,Philadelphia Union,F,10,1,129,1,1,8,5,1,0,0,1,4,1,1,0,2013,reg
Aaron Schoenfeld ,Minnesota United FC,F,10,3,310,1,1,10,3,0,1,0,1,15,7,2,0,2013,reg
Andrea Pisanu,Montreal Impact,M,14,8,631,1,1,10,4,1,0,1,0,10,22,2,0,2013,reg
Steven Caldwell,Toronto FC,D,23,23,2066,1,1,12,4,1,0,0,1,31,14,4,1,2013,reg
Bradley Wright-Phillips,LAFC,F,7,4,337,1,1,12,6,0,1,0,1,5,5,1,0,2013,reg
Alvaro Rey,Toronto FC,M,13,9,770,1,1,12,4,1,0,1,0,8,22,1,0,2013,reg
Servando Carrasco,Houston Dynamo,M,22,13,1256,1,1,13,2,1,0,1,0,30,18,2,0,2013,reg
Darren O'Dea,Toronto FC,D,17,17,1530,1,1,13,4,1,0,0,1,19,11,3,0,2013,reg
Laurent Courtois ,Chivas USA,M,11,3,348,1,1,15,4,1,0,1,0,5,9,1,0,2013,reg
Andrew Jean-Baptiste,Portland Timbers,D,26,22,2142,1,1,15,5,1,0,0,1,29,15,4,0,2013,reg
Víctor Bernárdez,San Jose Earthquakes ,D,25,25,2233,1,1,17,4,1,0,1,0,24,18,9,2,2013,reg
Ben Speas,Columbus Crew SC,M-F,19,10,935,1,1,18,4,0,1,0,1,4,14,0,0,2013,reg
Ryan Finley,Columbus Crew SC,F,14,3,430,1,1,18,5,1,0,1,0,3,6,0,0,2013,reg
Sanna Nyassi,Montreal Impact,M,22,11,1162,1,1,20,9,0,1,0,1,12,19,2,0,2013,reg
Khari Stephenson,Real Salt Lake,M,19,9,791,1,1,21,7,1,0,0,1,17,3,2,0,2013,reg
Justin Meram,Real Salt Lake,M,19,9,781,1,1,21,6,1,0,1,0,13,12,1,0,2013,reg
Marvin Chávez,San Jose Earthquakes ,M,15,12,1053,1,1,22,4,1,0,1,0,22,18,2,1,2013,reg
Alex,Chicago Fire FC,M,30,18,1625,1,1,34,9,1,0,0,1,25,29,2,0,2013,reg
Michael Farfan,Philadelphia Union,M,29,22,1991,1,1,40,18,1,0,0,1,41,45,6,0,2013,reg
Cole Grossman,Real Salt Lake,M,4,2,160,1,0,2,1,0,1,0,0,1,2,0,0,2013,reg
Charlie Rugg,LA Galaxy,F,4,2,151,1,0,2,1,0,1,0,0,3,1,0,0,2013,reg
Kofi Opare,LA Galaxy,D,6,6,534,1,0,2,1,1,0,0,0,4,5,1,0,2013,reg
Sal Zizzo,Portland Timbers,D,10,2,255,1,0,2,2,0,1,0,0,1,7,0,0,2013,reg
Stephen Keel,FC Dallas,D,8,5,497,1,0,3,1,0,1,0,0,3,5,1,0,2013,reg
Giovani Casillas,Chivas USA,F,5,2,182,1,0,3,1,1,0,0,0,0,0,0,0,2013,reg
A.J. Soares,New England Revolution ,D,18,17,1476,1,0,5,1,1,0,0,0,13,24,3,0,2013,reg
Karl Ouimette,Montreal Impact,D,7,6,547,1,0,5,1,1,0,0,0,4,2,0,0,2013,reg
Gláuber ,Columbus Crew SC,D,13,13,1169,1,0,5,2,1,0,0,0,26,6,5,0,2013,reg
Joaquin Velazquez,Chivas USA,D,12,12,985,1,0,5,4,0,1,0,0,14,5,3,1,2013,reg
Bakary Soumare,Chicago Fire FC,D,25,25,2180,1,0,6,2,0,1,0,0,35,13,5,2,2013,reg
Shalrie Joseph,FC Dallas,M,10,6,592,1,0,6,3,0,1,0,0,11,9,1,1,2013,reg
Oswaldo Minda,Chivas USA,M,16,15,1224,1,0,6,1,1,0,0,0,35,12,6,0,2013,reg
Maximiliano Urruti,Montreal Impact,F,7,4,351,1,0,6,2,1,0,0,0,8,6,1,0,2013,reg
Rafael,DC United ,F,7,4,331,1,0,7,2,1,0,0,0,2,9,1,0,2013,reg
Bright Dike,Portland Timbers,F,7,5,430,1,0,7,3,1,0,0,0,10,5,1,0,2013,reg
Matias Laba,Toronto FC,M,16,16,1414,1,0,7,4,0,1,0,0,19,31,5,0,2013,reg
Jamie Smith,Colorado Rapids,M,6,1,168,1,0,7,3,1,0,0,0,4,2,0,0,2013,reg
Mario De Luna,Chivas USA,D,30,30,2637,1,0,7,2,1,0,0,0,29,27,6,0,2013,reg
Djimi Traore,FC Dallas,D,27,25,2235,1,0,9,1,0,1,0,0,16,22,5,0,2013,reg
Ryan Guy,New England Revolution ,M,11,8,636,1,0,10,2,1,0,0,0,4,6,0,0,2013,reg
Collen Warner,Colorado Rapids,M,17,9,876,1,0,10,3,0,1,0,0,24,8,2,0,2013,reg
Yordany Álvarez,Real Salt Lake,M,18,11,981,1,0,10,5,0,1,0,0,21,7,5,2,2013,reg
Jaime Castrillón,Colorado Rapids,M,11,2,371,1,0,12,5,1,0,0,0,7,2,0,0,2013,reg
Juan Toja,New England Revolution ,M,18,11,905,1,0,12,3,0,1,0,0,35,14,3,0,2013,reg
Tony Cascio,Colorado Rapids,M,13,4,530,1,0,14,5,0,1,0,0,7,16,1,1,2013,reg
Jason Johnson,Houston Dynamo,F,13,4,428,1,0,17,9,1,0,0,0,8,8,0,0,2013,reg
José Erick Correa,Chivas USA,F,16,12,1054,1,0,18,11,0,1,0,0,18,4,0,0,2013,reg
Jerry Bengtson,New England Revolution,F,16,12,1055,1,0,20,8,0,1,0,0,28,13,2,0,2013,reg
Chad Marshall,Columbus Crew SC,D,30,30,2638,1,0,21,8,0,1,0,0,22,28,2,0,2013,reg
Clint Dempsey,FC Dallas,M-F,9,6,651,1,0,32,7,1,0,0,0,4,23,1,0,2013,reg
Chris Klute,Colorado Rapids,D,31,30,2696,0,7,5,2,0,0,5,2,26,4,2,0,2013,reg
Lee Young-Pyo,Vancouver Whitecaps,D,32,30,2747,0,6,12,3,0,0,2,4,24,34,3,0,2013,reg
Brandon Barklage,New York Red Bulls ,D,26,20,1723,0,5,12,3,0,0,3,2,31,16,1,1,2013,reg
Eddie Gaven,Columbus Crew SC,M,10,10,900,0,4,7,4,0,0,2,2,13,38,1,0,2013,reg
Marc Burch,FC Dallas,D,20,13,1158,0,4,8,0,0,0,2,2,13,13,0,0,2013,reg
Kofi Sarkodie,Houston Dynamo,D,33,33,2948,0,4,12,2,0,0,2,2,38,24,7,0,2013,reg
Juninho Pernambucano,New York Red Bulls ,M,13,10,984,0,4,19,3,0,0,3,1,14,12,5,1,2013,reg
Diego Chara,Portland Timbers,M,31,31,2737,0,3,10,3,0,0,2,1,74,39,7,0,2013,reg
Seth Sinovic,New England Revolution,D,32,31,2773,0,3,16,5,0,0,1,2,34,15,5,0,2013,reg
Sebastian Velasquez,Real Salt Lake,M,19,9,892,0,3,20,8,0,0,3,0,15,15,0,0,2013,reg
Carlos Borja,Chivas USA,D,26,22,2010,0,2,2,0,0,0,1,1,35,11,5,0,2013,reg
Brian Mullan,Colorado Rapids,D,16,15,1359,0,2,2,0,0,0,2,0,13,15,1,0,2013,reg
Kosuke Kimura,New York Red Bulls ,D,24,15,1575,0,2,2,0,0,0,0,2,11,9,0,0,2013,reg
Heath Pearce,New York Red Bulls ,D,14,11,1083,0,2,2,1,0,0,1,1,7,4,0,0,2013,reg
Andre Akpan,Colorado Rapids,F,8,1,134,0,2,4,0,0,0,1,1,0,2,0,0,2013,reg
Carlyle Mitchell,Vancouver Whitecaps,D,15,13,1179,0,2,5,1,0,0,1,1,12,11,3,0,2013,reg
Scott Caldwell,New England Revolution,M,29,23,2174,0,2,6,1,0,0,1,1,35,20,2,0,2013,reg
Marvell Wynne,Colorado Rapids,D,28,27,2315,0,2,6,2,0,0,2,0,22,14,1,0,2013,reg
Corey Ashe,Houston Dynamo,M,30,29,2585,0,2,6,1,0,0,1,1,14,25,4,0,2013,reg
Matt Besler,Sporting Kansas City,D,23,23,2070,0,2,6,0,0,0,1,1,18,14,2,0,2013,reg
Doneil Henry,Toronto FC,D,20,19,1651,0,2,7,0,0,0,1,1,27,8,6,2,2013,reg
Todd Dunivant,LA Galaxy,D,25,25,2228,0,2,8,3,0,0,2,0,18,10,2,0,2013,reg
Erik Hurtado,Sporting Kansas City,F,15,4,489,0,2,13,3,0,0,1,1,13,5,0,0,2013,reg
Ramiro Corrales,San Jose Earthquakes ,M,12,11,870,0,2,14,2,0,0,1,1,13,13,3,0,2013,reg
Rafael Baca,San Jose Earthquakes ,M,31,28,2379,0,2,30,7,0,0,0,2,17,35,6,1,2013,reg
Michael Bustamante,New York Red Bulls ,M,4,1,95,0,1,0,0,0,0,1,0,1,1,1,0,2013,reg
Clyde Simms,New England Revolution ,M,10,9,668,0,1,0,0,0,0,0,1,5,3,1,0,2013,reg
Roy Miller,New York Red Bulls ,D,17,16,1367,0,1,1,0,0,0,0,1,16,6,2,0,2013,reg
Darrius Barnes,New England Revolution ,D,6,4,416,0,1,1,0,0,0,0,1,3,5,0,0,2013,reg
Mark Bloom,Toronto FC,D,6,6,540,0,1,1,1,0,0,1,0,4,5,0,0,2013,reg
Alexander Lopez,Houston Dynamo,M,2,1,88,0,1,1,1,0,0,1,0,0,0,0,0,2013,reg
Wandrille Lefevre,Montreal Impact,D,6,4,397,0,1,2,1,0,0,1,0,3,3,2,0,2013,reg
Ruben Bover,New York Red Bulls ,M,7,1,125,0,1,2,0,0,0,0,1,2,0,0,0,2013,reg
Walter Vilchez,Chivas USA,D,11,11,970,0,1,2,1,0,0,1,0,13,10,3,0,2013,reg
Alessandro Nesta,Montreal Impact,D,23,23,1939,0,1,2,0,0,0,1,0,11,19,0,1,2013,reg
Pablo Mastroeni,Colorado Rapids,M,16,8,571,0,1,3,0,0,0,1,0,7,6,1,0,2013,reg
Dan Gargan,San Jose Earthquakes ,D,8,6,592,0,1,3,0,0,0,1,0,8,8,1,0,2013,reg
Tyson Wahl,Columbus Crew SC,D,25,24,2155,0,1,3,2,0,0,0,1,29,12,4,0,2013,reg
Michael Harrington,Portland Timbers,D,33,33,2951,0,1,3,0,0,0,0,1,26,23,2,0,2013,reg
Josh Gardner,Sporting Kansas City ,M,8,2,244,0,1,3,0,0,0,1,0,3,4,0,0,2013,reg
Chad Barson,Columbus Crew SC,D,20,18,1612,0,1,3,0,0,0,0,1,14,18,0,0,2013,reg
Jun Marques Davidson,Vancouver Whitecaps,M,26,24,1961,0,1,4,0,0,0,0,1,22,19,1,1,2013,reg
Ashtone Morgan,Real Salt Lake,D,22,20,1805,0,1,4,1,0,0,0,1,27,24,4,1,2013,reg
Mechack Jérôme,Sporting Kansas City ,D,10,8,677,0,1,5,3,0,0,1,0,2,3,2,0,2013,reg
Andy Dorman,New England Revolution ,M,12,3,400,0,1,5,2,0,0,1,0,8,9,0,2,2013,reg
Daniel Woolard,DC United ,D,27,27,2235,0,1,5,3,0,0,1,0,21,25,3,0,2013,reg
Brian Ching,Houston Dynamo,F,14,0,232,0,1,5,2,0,0,0,1,7,3,1,0,2013,reg
Abdoulie Mansally,Real Salt Lake,D,14,9,774,0,1,5,1,0,0,0,1,25,11,3,1,2013,reg
Nana Attakora,San Jose Earthquakes ,D,8,7,657,0,1,6,0,0,0,0,1,5,8,0,0,2013,reg
Marky Delgado,Toronto FC,M,16,13,1247,0,1,6,0,0,0,1,0,14,11,2,0,2013,reg
Collin Martin,DC United ,M,7,4,359,0,1,6,1,0,0,1,0,8,2,1,0,2013,reg
Mamadou Danso,Portland Timbers,D,16,15,1360,0,1,6,0,0,0,0,1,20,6,2,1,2013,reg
Ryan Richter,Toronto FC,D,13,12,1118,0,1,7,1,0,0,1,0,17,14,1,0,2013,reg
Leonardo González,FC Dallas,D,27,27,2318,0,1,7,0,0,0,0,1,38,18,4,1,2013,reg
James Riley,DC United ,D,21,19,1760,0,1,7,3,0,0,1,0,24,6,4,0,2013,reg
Jermaine Taylor,Houston Dynamo,D,26,26,2142,0,1,8,0,0,0,1,0,20,12,0,1,2013,reg
Lovel Palmer,Real Salt Lake,D,17,14,1198,0,1,8,0,0,0,0,1,16,8,4,1,2013,reg
Lewis Neal,DC United ,M,9,5,491,0,1,8,3,0,0,1,0,4,3,1,0,2013,reg
Markus Holgersson,New York Red Bulls ,D,32,32,2866,0,1,8,1,0,0,1,0,41,16,3,0,2013,reg
Wil Trapp,,M,16,16,1389,0,1,8,0,0,0,1,0,17,9,3,0,2013,reg
Andrew Farrell,New England Revolution,D,32,32,2813,0,1,9,2,0,0,1,0,12,37,3,1,2013,reg
Danny Mwanga,Colorado Rapids,F,13,5,556,0,1,9,4,0,0,0,1,6,8,0,0,2013,reg
Tony Tchani,Columbus Crew SC,M,22,13,1324,0,1,9,1,0,0,1,0,26,27,3,0,2013,reg
Tony Beltran,Real Salt Lake,D,25,24,2230,0,1,9,3,0,0,0,1,18,22,2,1,2013,reg
Steve Zakuani,FC Dallas,M,8,6,492,0,1,10,2,0,0,1,0,7,8,0,0,2013,reg
Teal Bunbury,New England Revolution,F,12,1,214,0,1,10,2,0,0,0,1,5,5,1,0,2013,reg
Reggie Lambe,Toronto FC,M,28,20,1799,0,1,11,0,0,0,0,1,29,33,3,1,2013,reg
Sherjill MacDonald,Chicago Fire FC,F,13,7,579,0,1,11,5,0,0,1,0,7,12,0,0,2013,reg
Jeff Parke,Philadelphia Union,D,31,31,2744,0,1,11,2,0,0,1,0,23,24,3,0,2013,reg
Gonzalo Segares,Chicago Fire FC,D,32,32,2855,0,1,12,3,0,0,1,0,43,27,8,0,2013,reg
John Thorrington,DC United ,M,14,12,1052,0,1,12,4,0,0,1,0,17,21,4,0,2013,reg
Brandon McDonald,DC United ,D,15,14,1235,0,1,12,4,0,0,1,0,14,6,1,0,2013,reg
Mario Martinez,FC Dallas,M,10,5,503,0,1,14,5,0,0,0,1,1,12,0,0,2013,reg
Matt Watson,Vancouver Whitecaps,M,21,15,1292,0,1,14,2,0,0,1,0,18,17,1,0,2013,reg
Eric Hassli,FC Dallas,F,15,4,429,0,1,16,4,0,0,1,0,10,6,2,0,2013,reg
Bobby Boswell,Houston Dynamo,D,32,32,2830,0,1,16,3,0,0,0,1,29,15,3,1,2013,reg
Jack Jewsbury,Portland Timbers,M,26,26,2240,0,1,17,2,0,0,0,1,24,16,0,0,2013,reg
Paulo Nagamura,Sporting Kansas City ,M,17,17,1468,0,1,17,4,0,0,1,0,25,20,3,0,2013,reg
Jacob Peterson,Sporting Kansas City ,F,16,10,844,0,1,17,4,0,0,1,0,11,11,0,0,2013,reg
Robbie Rogers,LA Galaxy,D,11,7,602,0,1,18,6,0,0,1,0,12,16,0,0,2013,reg
Keon Daniel,Philadelphia Union,M,24,20,1721,0,1,27,5,0,0,1,0,35,24,4,0,2013,reg
Osvaldo Alonso,Minnesota United FC,M,26,26,2179,0,1,33,4,0,0,1,0,54,37,3,2,2013,reg
Phillip Lund,FC Dallas,M,1,0,16,0,0,0,0,0,0,0,0,0,0,0,0,2013,reg
Yann Ekra,Philadelphia Union,F,0,0,0,0,0,0,0,0,0,0,0,0,0,0,0,2013,reg
Michael Videira,Chicago Fire FC,M,2,1,84,0,0,0,0,0,0,0,0,1,0,0,0,2013,reg
Josué Martínez,New York Red Bulls ,F,1,0,11,0,0,0,0,0,0,0,0,1,0,0,0,2013,reg
Blair Gavin,FC Dallas,M,0,0,0,0,0,0,0,0,0,0,0,0,0,0,0,2013,reg
Michael Thomas,Sporting Kansas City ,M,1,0,12,0,0,0,0,0,0,0,0,0,0,0,0,2013,reg
David Horst,Portland Timbers,D,2,2,108,0,0,0,0,0,0,0,0,4,1,0,0,2013,reg
Federico Bessone,Sporting Kansas City ,D,0,0,0,0,0,0,0,0,0,0,0,0,0,0,0,2013,reg
Adam Johansson,FC Dallas,D,0,0,0,0,0,0,0,0,0,0,0,0,0,0,0,2013,reg
Diego Calderon,Colorado Rapids,D,4,4,304,0,0,0,0,0,0,0,0,4,4,0,0,2013,reg
Rauwshan McKenzie,Portland Timbers,D,1,1,90,0,0,0,0,0,0,0,0,1,1,0,0,2013,reg
Ryan Miller,Portland Timbers,D,7,4,350,0,0,0,0,0,0,0,0,4,3,0,0,2013,reg
Charlie Davies,New England Revolution ,F,4,0,23,0,0,0,0,0,0,0,0,0,0,0,0,2013,reg
Adrian Lopez,Montreal Impact,D,0,0,0,0,0,0,0,0,0,0,0,0,0,0,0,2013,reg
Nelson Rivas,Montreal Impact,D,0,0,0,0,0,0,0,0,0,0,0,0,0,0,0,2013,reg
Jason Hernandez,San Jose Earthquakes ,D,21,19,1679,0,0,0,0,0,0,0,0,13,9,2,0,2013,reg
Anthony Wallace,Colorado Rapids,D,6,0,107,0,0,0,0,0,0,0,0,4,4,1,0,2013,reg
Calen Carr,Houston Dynamo,F,0,0,0,0,0,0,0,0,0,0,0,0,0,0,0,2013,reg
Ante Jazic,Chivas USA,D,0,0,0,0,0,0,0,0,0,0,0,0,0,0,0,2013,reg
Ugo Ihemelu,FC Dallas,D,0,0,0,0,0,0,0,0,0,0,0,0,0,0,0,2013,reg
Sinisa Ubiparipovic,Montreal Impact,F-M,1,0,5,0,0,0,0,0,0,0,0,0,0,0,0,2013,reg
Arne Friedrich,Chicago Fire FC,D,0,0,0,0,0,0,0,0,0,0,0,0,0,0,0,2013,reg
Júlio César,Toronto FC,D,0,0,0,0,0,0,0,0,0,0,0,0,0,0,0,2013,reg
Freddy Adu,Philadelphia Union,F,0,0,0,0,0,0,0,0,0,0,0,0,0,0,0,2013,reg
Chris Albright,Philadelphia Union,D,2,0,4,0,0,0,0,0,0,0,0,1,0,1,0,2013,reg
Robbie Russell,DC United ,D,1,0,6,0,0,0,0,0,0,0,0,0,0,0,0,2013,reg
Andrew Duran,FC Dallas,D,0,0,0,0,0,0,0,0,0,0,0,0,0,0,0,2013,reg
Chandler Hoffman,LA Galaxy,F,0,0,0,0,0,0,0,0,0,0,0,0,0,0,0,2013,reg
Greg Jordan,Philadelphia Union,M,0,0,0,0,0,0,0,0,0,0,0,0,0,0,0,2013,reg
Bryan Gaul,LA Galaxy,D,0,0,0,0,0,0,0,0,0,0,0,0,0,0,0,2013,reg
Brent Richards,Portland Timbers,F,0,0,0,0,0,0,0,0,0,0,0,0,0,0,0,2013,reg
Jacob Hustedt,San Jose Earthquakes ,M,0,0,0,0,0,0,0,0,0,0,0,0,0,0,0,2013,reg
Kenney Walker,LA Galaxy,M,0,0,0,0,0,0,0,0,0,0,0,0,0,0,0,2013,reg
Tyler Polak,New England Revolution ,D,0,0,0,0,0,0,0,0,0,0,0,0,0,0,0,2013,reg
Brendan King,Chicago Fire FC,M,0,0,0,0,0,0,0,0,0,0,0,0,0,0,0,2013,reg
Calum Mallace,Montreal Impact,M,2,0,36,0,0,0,0,0,0,0,0,0,0,0,0,2013,reg
Enzo Martinez,Real Salt Lake,M,0,0,0,0,0,0,0,0,0,0,0,0,0,0,0,2013,reg
Matt Stinson,Toronto FC,M,0,0,0,0,0,0,0,0,0,0,0,0,0,0,0,2013,reg
Bilal Duckett,New England Revolution ,D,1,1,90,0,0,0,0,0,0,0,0,0,1,0,0,2013,reg
O'Brian Woodbine,New England Revolution ,D,0,0,0,0,0,0,0,0,0,0,0,0,0,0,0,2013,reg
Gilberto Souza Jr.,Philadelphia Union,M,0,0,0,0,0,0,0,0,0,0,0,0,0,0,0,2013,reg
Aaron Horton,Columbus Crew SC,F,0,0,0,0,0,0,0,0,0,0,0,0,0,0,0,2013,reg
Connor Lade,New York Red Bulls ,D,5,2,166,0,0,0,0,0,0,0,0,0,1,0,0,2013,reg
Bryce Alderson,Vancouver Whitecaps,M,0,0,0,0,0,0,0,0,0,0,0,0,0,0,0,2013,reg
Yann Songo'o,Sporting Kansas City ,D,0,0,0,0,0,0,0,0,0,0,0,0,0,0,0,2013,reg
Maximiliano Rodriguez,Montreal Impact,M,0,0,0,0,0,0,0,0,0,0,0,0,0,0,0,2013,reg
Jimmy McLaughlin,FC Cincinnati,M,0,0,0,0,0,0,0,0,0,0,0,0,0,0,0,2013,reg
Corben Bone,Chicago Fire FC,M,1,0,3,0,0,0,0,0,0,0,0,0,0,0,0,2013,reg
Daniel Antunez,Chivas USA,M,3,1,81,0,0,0,0,0,0,0,0,3,1,0,0,2013,reg
Digao,New York Red Bulls ,D,0,0,0,0,0,0,0,0,0,0,0,0,0,0,0,2013,reg
Paulo Jr.,Vancouver Whitecaps,F,0,0,0,0,0,0,0,0,0,0,0,0,0,0,0,2013,reg
Abu Tommy,San Jose Earthquakes ,M,0,0,0,0,0,0,0,0,0,0,0,0,0,0,0,2013,reg
Rich Balchan,Real Salt Lake,D,0,0,0,0,0,0,0,0,0,0,0,0,0,0,0,2013,reg
Victor Ulloa,,M,0,0,0,0,0,0,0,0,0,0,0,0,0,0,0,2013,reg
Jonathan Top,FC Dallas,F,0,0,0,0,0,0,0,0,0,0,0,0,0,0,0,2013,reg
Omar Salgado,Vancouver Whitecaps,F,0,0,0,0,0,0,0,0,0,0,0,0,0,0,0,2013,reg
Davy Armstrong,Colorado Rapids,M,0,0,0,0,0,0,0,0,0,0,0,0,0,0,0,2013,reg
Victor Pineda,Chicago Fire FC,M,0,0,0,0,0,0,0,0,0,0,0,0,0,0,0,2013,reg
Michael Nanchoff,Portland Timbers,M,1,0,8,0,0,0,0,0,0,0,0,1,0,0,0,2013,reg
Donnie Smith,New England Revolution ,M,1,1,53,0,0,0,0,0,0,0,0,0,0,0,0,2013,reg
Paolo DelPiccolo,Montreal Impact,M,0,0,0,0,0,0,0,0,0,0,0,0,0,0,0,2013,reg
Dylan Remick,FC Dallas,D,1,0,25,0,0,0,0,0,0,0,0,1,0,0,0,2013,reg
Emery Welshman,Toronto FC,F,1,0,5,0,0,0,0,0,0,0,0,0,1,0,0,2013,reg
Anthony Arena,Houston Dynamo,D,1,0,70,0,0,0,0,0,0,0,0,0,0,0,0,2013,reg
Ashton Bennett,Toronto FC,F,0,0,0,0,0,0,0,0,0,0,0,0,0,0,0,2013,reg
Brenton Griffiths,Colorado Rapids,D,1,0,1,0,0,0,0,0,0,0,0,0,0,0,0,2013,reg
Adam Clement,Vancouver Whitecaps,D,0,0,0,0,0,0,0,0,0,0,0,0,0,0,0,2013,reg
Colin Mitchell,San Jose Earthquakes ,D,0,0,0,0,0,0,0,0,0,0,0,0,0,0,0,2013,reg
Taylor Morgan,Toronto FC,F,1,0,15,0,0,0,0,0,0,0,0,1,0,0,0,2013,reg
Gabe Latigue,New England Revolution ,M,0,0,0,0,0,0,0,0,0,0,0,0,0,0,0,2013,reg
Emilio Orozco,Chivas USA,D,0,0,0,0,0,0,0,0,0,0,0,0,0,0,0,2013,reg
Bryan Salazar,Houston Dynamo,F,0,0,0,0,0,0,0,0,0,0,0,0,0,0,0,2013,reg
Zakaria Messoudi,Montreal Impact,M,0,0,0,0,0,0,0,0,0,0,0,0,0,0,0,2013,reg
Dylan Tucker-Gangnes,Portland Timbers,D,0,0,0,0,0,0,0,0,0,0,0,0,0,0,0,2013,reg
Kyle Hyland,Columbus Crew SC,D-M,0,0,0,0,0,0,0,0,0,0,0,0,0,0,0,2013,reg
Christian Duke,Sporting Kansas City ,M,0,0,0,0,0,0,0,0,0,0,0,0,0,0,0,2013,reg
Shawn Sloan,Columbus Crew SC,M,0,0,0,0,0,0,0,0,0,0,0,0,0,0,0,2013,reg
Peter McGlynn,San Jose Earthquakes ,M,0,0,0,0,0,0,0,0,0,0,0,0,0,0,0,2013,reg
Alam Syamsir,DC United ,M-F,0,0,0,0,0,0,0,0,0,0,0,0,0,0,0,2013,reg
Matt Horth,New England Revolution ,F,0,0,0,0,0,0,0,0,0,0,0,0,0,0,0,2013,reg
Rafinha,New York Red Bulls ,F,0,0,0,0,0,0,0,0,0,0,0,0,0,0,0,2013,reg
Sam Adekugbe,Vancouver Whitecaps,D,1,1,90,0,0,0,0,0,0,0,0,1,1,0,0,2013,reg
Benji Lopez,Real Salt Lake,F,0,0,0,0,0,0,0,0,0,0,0,0,0,0,0,2013,reg
Ashani Fairclough,FC Dallas,D,0,0,0,0,0,0,0,0,0,0,0,0,0,0,0,2013,reg
Alexandre Gonzalez Emerson,San Jose Earthquakes ,F,0,0,0,0,0,0,0,0,0,0,0,0,0,0,0,2013,reg
Aminu Abdallah,Vancouver Whitecaps,M,0,0,0,0,0,0,0,0,0,0,0,0,0,0,0,2013,reg
Matt Miazga,New York Red Bulls,D,1,0,14,0,0,0,0,0,0,0,0,1,0,0,0,2013,reg
Caleb Calvert,Chivas USA,F,0,0,0,0,0,0,0,0,0,0,0,0,0,0,0,2013,reg
Jaime Frias Flores,Chivas USA,D,4,3,261,0,0,0,0,0,0,0,0,3,0,0,0,2013,reg
Erik Palmer-Brown,Sporting Kansas City ,D,0,0,0,0,0,0,0,0,0,0,0,0,0,0,0,2013,reg
Manny Aparicio,Toronto FC,M,0,0,0,0,0,0,0,0,0,0,0,0,0,0,0,2013,reg
Brendan Ruiz,Sporting Kansas City ,D,0,0,0,0,0,0,0,0,0,0,0,0,0,0,0,2013,reg
Bradlee Baladez,FC Dallas,M-F,1,0,27,0,0,0,0,0,0,0,0,2,0,0,0,2013,reg
Steven Evans,Portland Timbers,M,0,0,0,0,0,0,0,0,0,0,0,0,0,0,0,2013,reg
Michael Seaton,DC United ,F,3,1,114,0,0,0,0,0,0,0,0,4,2,0,0,2013,reg
Drew Beckie,Columbus Crew SC,D,0,0,0,0,0,0,0,0,0,0,0,0,0,0,0,2013,reg
Kory Kindle,Colorado Rapids,D,0,0,0,0,0,0,0,0,0,0,0,0,0,0,0,2013,reg
Ian Christianson,New York Red Bulls ,M,0,0,0,0,0,0,0,0,0,0,0,0,0,0,0,2013,reg
Tommy Muller,San Jose Earthquakes ,D,0,0,0,0,0,0,0,0,0,0,0,0,0,0,0,2013,reg
Mikey Lopez,Sporting Kansas City ,M,0,0,0,0,0,0,0,0,0,0,0,0,0,0,0,2013,reg
David Viana,Real Salt Lake,M,0,0,0,0,0,0,0,0,0,0,0,0,0,0,0,2013,reg
Amando Moreno,New York Red Bulls ,M-F,2,0,2,0,0,0,0,0,0,0,0,0,0,0,0,2013,reg
Oscar Sorto,LA Galaxy,D,0,0,0,0,0,0,0,0,0,0,0,0,0,0,0,2013,reg
Mobi Fehr,Portland Timbers,D,0,0,0,0,0,0,0,0,0,0,0,0,0,0,0,2013,reg
Sebastián Rincón,Portland Timbers,F,0,0,0,0,0,0,0,0,0,0,0,0,0,0,0,2013,reg
Will Bates,FC Dallas,F,0,0,0,0,0,0,0,0,0,0,0,0,0,0,0,2013,reg
Cristhian Hernandez,Philadelphia Union,F,0,0,0,0,0,0,0,0,0,0,0,0,0,0,0,2013,reg
Kellen Gulley,Chicago Fire FC,F,0,0,0,0,0,0,0,0,0,0,0,0,0,0,0,2013,reg
Caleb Clarke,Vancouver Whitecaps,F,0,0,0,0,0,0,0,0,0,0,0,0,0,0,0,2013,reg
Hanyer Mosquera ,Portland Timbers,D,0,0,0,0,0,0,0,0,0,0,0,0,0,0,0,2013,reg
Ryan Kawulok,Portland Timbers,D,0,0,0,0,0,0,0,0,0,0,0,0,0,0,0,2013,reg
Kyle Miller,Sporting Kansas City ,M,0,0,0,0,0,0,0,0,0,0,0,0,0,0,0,2013,reg
Greg Klazura ,Vancouver Whitecaps,D-M,2,1,85,0,0,0,0,0,0,0,0,1,0,0,0,2013,reg
Logan Emory,Toronto FC,D,3,3,238,0,0,1,0,0,0,0,0,4,8,1,0,2013,reg
Taylor Kemp,DC United ,D,8,6,530,0,0,1,0,0,0,0,0,7,4,0,0,2013,reg
London Woodberry,FC Dallas,D,8,3,363,0,0,1,1,0,0,0,0,1,3,1,0,2013,reg
Yazid Atouba,Chicago Fire FC,M,3,0,55,0,0,1,0,0,0,0,0,1,3,0,0,2013,reg
Jimmy Medranda ,Nashville SC,D,1,0,1,0,0,1,1,0,0,0,0,0,0,0,0,2013,reg
Dillon Serna,Colorado Rapids,M,1,0,13,0,0,1,0,0,0,0,0,1,0,0,0,2013,reg
Carlos Salcedo,Real Salt Lake,D,13,12,1070,0,0,1,0,0,0,0,0,18,4,3,0,2013,reg
Don Anding,Philadelphia Union,D,1,0,30,0,0,1,0,0,0,0,0,0,0,0,0,2013,reg
Kevin Ellis,Sporting Kansas City ,D,2,1,113,0,0,1,0,0,0,0,0,4,2,0,0,2013,reg
Matt Kassel,Philadelphia Union,D-M,5,0,90,0,0,1,0,0,0,0,0,0,1,0,0,2013,reg
Shaun Francis,Chicago Fire FC,D,1,1,90,0,0,1,0,0,0,0,0,3,0,0,0,2013,reg
Steven Kinney,Chicago Fire FC,D,2,2,180,0,0,1,0,0,0,0,0,1,2,0,0,2013,reg
Luiz Camargo,Houston Dynamo,M,7,0,109,0,0,1,0,0,0,0,0,6,6,2,0,2013,reg
Jaime Alas,San Jose Earthquakes ,M,5,1,117,0,0,1,0,0,0,0,0,0,3,0,0,2013,reg
Tommy Meyer,LA Galaxy,D,7,5,494,0,0,1,0,0,0,0,0,7,4,0,0,2013,reg
Rafael Garcia ,LA Galaxy,D,9,1,222,0,0,1,1,0,0,0,0,4,5,0,0,2013,reg
Danny Califf,Toronto FC,D,4,4,354,0,0,1,0,0,0,0,0,4,3,2,0,2013,reg
Marcelo Saragosa,DC United ,M,8,4,410,0,0,1,0,0,0,0,0,7,7,2,0,2013,reg
Logan Pause,Chicago Fire FC,M,15,11,904,0,0,1,0,0,0,0,0,7,2,1,0,2013,reg
Mehdi Ballouchy,San Jose Earthquakes ,M,5,1,118,0,0,1,0,0,0,0,0,2,3,1,0,2013,reg
Jonas Elmer,Toronto FC,D,3,1,128,0,0,1,0,0,0,0,0,2,0,0,0,2013,reg
Roger Torres,Philadelphia Union,M,5,0,68,0,0,1,0,0,0,0,0,1,1,0,0,2013,reg
Aaron Maund,Real Salt Lake,D,3,3,270,0,0,1,0,0,0,0,0,5,1,1,0,2013,reg
Kwame Watson-Siriboe,Real Salt Lake,D,7,7,630,0,0,1,0,0,0,0,0,10,3,1,0,2013,reg
Dejan Jakovic,LAFC,D,18,17,1575,0,0,1,0,0,0,0,0,18,15,3,0,2013,reg
Brad Ring,Portland Timbers,D,4,3,271,0,0,1,0,0,0,0,0,1,1,0,0,2013,reg
Kevin Alston,New England Revolution ,D,9,6,523,0,0,2,1,0,0,0,0,7,11,0,0,2013,reg
A.J. DeLaGarza,,D,28,28,2399,0,0,2,1,0,0,0,0,22,22,3,0,2013,reg
Marcus Tracy,San Jose Earthquakes ,F,5,0,58,0,0,2,1,0,0,0,0,3,0,0,0,2013,reg
Sammy Ochoa,FC Dallas,F,4,2,175,0,0,2,0,0,0,0,0,4,1,0,0,2013,reg
Mike Chabala,Houston Dynamo,D,4,1,158,0,0,2,0,0,0,0,0,0,1,0,0,2013,reg
Eric Brunner,Houston Dynamo,D,13,9,889,0,0,2,0,0,0,0,0,8,9,1,0,2013,reg
Hernan Bernardello,Montreal Impact,M,8,8,626,0,0,2,0,0,0,0,0,10,20,1,0,2013,reg
Kalifa Cissé,New England Revolution ,M,6,6,456,0,0,2,1,0,0,0,0,11,2,2,0,2013,reg
Jay DeMerit,Vancouver Whitecaps,D,8,7,607,0,0,2,1,0,0,0,0,8,3,1,0,2013,reg
Peter Luccin,FC Dallas,M,3,2,201,0,0,2,0,0,0,0,0,5,3,3,0,2013,reg
Mikael Silvestre,Portland Timbers,D,8,8,688,0,0,2,0,0,0,0,0,11,5,2,0,2013,reg
Danny Koevermans,Toronto FC,F,4,1,78,0,0,2,2,0,0,0,0,3,1,1,0,2013,reg
Gale Agbossoumonde,Toronto FC,D,13,12,1081,0,0,2,0,0,0,0,0,21,7,4,0,2013,reg
Eric Gehrig,Columbus Crew SC,D,6,6,540,0,0,2,1,0,0,0,0,4,0,0,0,2013,reg
Bobby Warshaw,FC Dallas,D,9,1,130,0,0,2,0,0,0,0,0,1,1,0,0,2013,reg
Conor Shanosky,DC United ,M-D,5,3,355,0,0,2,0,0,0,0,0,3,4,0,0,2013,reg
Eriq Zavaleta,Toronto FC,D,5,0,31,0,0,2,1,0,0,0,0,0,1,0,0,2013,reg
Marius Obekop,New York Red Bulls ,M,5,0,69,0,0,2,0,0,0,0,0,2,2,0,0,2013,reg
John Stertzer,Real Salt Lake,M,2,0,33,0,0,2,0,0,0,0,0,1,0,0,0,2013,reg
Alex Caskey,FC Dallas,M,10,5,430,0,0,3,0,0,0,0,0,4,6,0,0,2013,reg
Dennis Iapichino,DC United ,D,15,11,1096,0,0,3,0,0,0,0,0,12,7,4,0,2013,reg
Raphael Augusto,DC United ,M,7,5,395,0,0,3,1,0,0,0,0,6,3,0,0,2013,reg
Marvin Iraheta,Chivas USA,M,13,5,551,0,0,3,0,0,0,0,0,16,4,2,0,2013,reg
Josue Soto,Chivas USA,D-M,18,12,1158,0,0,3,3,0,0,0,0,11,5,2,1,2013,reg
Sam Garza,San Jose Earthquakes ,M,5,0,93,0,0,3,1,0,0,0,0,0,0,0,0,2013,reg
Kevan George,Columbus Crew SC,M,11,3,435,0,0,3,1,0,0,0,0,8,4,3,0,2013,reg
Danny O'Rourke,Columbus Crew SC,D,22,19,1723,0,0,3,0,0,0,0,0,45,17,6,0,2013,reg
Ty Harden,San Jose Earthquakes ,D,7,7,596,0,0,3,0,0,0,0,0,5,3,1,0,2013,reg
Brian Ownby,Houston Dynamo,M,3,0,52,0,0,3,1,0,0,0,0,1,1,0,0,2013,reg
Kevin Harbottle,Colorado Rapids,F,4,4,269,0,0,3,0,0,0,0,0,1,1,1,0,2013,reg
Steve Purdy,Chivas USA,D,8,5,478,0,0,4,1,0,0,0,0,6,2,1,0,2013,reg
Terry Dunfield,Toronto FC,M,4,4,311,0,0,4,1,0,0,0,0,7,5,1,0,2013,reg
Andy O'Brien,Vancouver Whitecaps,D,16,16,1400,0,0,4,2,0,0,0,0,10,5,0,0,2013,reg
Jordan Stewart,San Jose Earthquakes ,D-M,12,12,1080,0,0,4,1,0,0,0,0,12,13,0,0,2013,reg
Ethan Finlay,Minnesota United FC,M,19,3,391,0,0,4,2,0,0,0,0,8,6,2,0,2013,reg
Casey Townsend,DC United ,F,9,3,316,0,0,4,1,0,0,0,0,6,0,1,0,2013,reg
Raymon Gaddis,Philadelphia Union,D,31,31,2703,0,0,4,2,0,0,0,0,25,23,3,0,2013,reg
Ethan White,DC United ,D,14,13,1099,0,0,4,0,0,0,0,0,11,12,2,0,2013,reg
Martin Ponce,Chivas USA,M,5,1,170,0,0,4,1,0,0,0,0,3,2,1,0,2013,reg
Alvas Powell,,D,5,4,382,0,0,4,0,0,0,0,0,3,4,1,0,2013,reg
Greg Cochrane,LA Galaxy,D,12,9,848,0,0,5,0,0,0,0,0,0,4,0,0,2013,reg
Zach Loyd,FC Dallas,D,25,24,2132,0,0,5,2,0,0,0,0,25,24,1,0,2013,reg
Chris Schuler,Real Salt Lake,D,16,16,1440,0,0,5,1,0,0,0,0,14,11,2,0,2013,reg
Hogan Ephraim ,Toronto FC,M,11,9,775,0,0,5,3,0,0,0,0,5,11,2,0,2013,reg
Kamani Hill,Colorado Rapids,F,6,2,188,0,0,5,0,0,0,0,0,5,1,0,0,2013,reg
John Bostock,Toronto FC,M,7,4,388,0,0,5,2,0,0,0,0,4,6,0,0,2013,reg
Patrick Ianni,FC Dallas,D-M,9,7,705,0,0,5,1,0,0,0,0,9,7,1,0,2013,reg
Michael Lahoud,Philadelphia Union,M,9,3,464,0,0,5,1,0,0,0,0,8,5,1,0,2013,reg
David Estrada,FC Dallas,M-F,17,4,498,0,0,5,3,0,0,0,0,4,6,0,0,2013,reg
Leonardo,LA Galaxy,D,14,12,1106,0,0,6,3,0,0,0,0,13,9,1,1,2013,reg
Wells Thompson,Chicago Fire FC,D,8,6,542,0,0,6,0,0,0,0,0,7,11,2,1,2013,reg
Colin Clark,LA Galaxy,M,11,4,334,0,0,6,2,0,0,0,0,3,6,0,0,2013,reg
Carlos Bocanegra,Chivas USA,D,12,12,1052,0,0,6,2,0,0,0,0,9,10,2,1,2013,reg
Jose Manuel Rivera,Chivas USA,F,9,3,266,0,0,6,1,0,0,0,0,7,4,1,0,2013,reg
Marcos Sanchez,DC United ,M,9,6,508,0,0,6,0,0,0,0,0,4,8,0,0,2013,reg
Kellyn Acosta,Colorado Rapids,M,13,11,1004,0,0,6,0,0,0,0,0,12,10,2,0,2013,reg
Leo Fernandes,Philadelphia Union,M,7,3,281,0,0,6,1,0,0,0,0,8,4,1,0,2013,reg
German Mera,Colorado Rapids,D,13,6,577,0,0,7,0,0,0,0,0,7,0,2,0,2013,reg
Erick Neres da Cruz,FC Dallas,M,9,8,652,0,0,7,0,0,0,0,0,13,16,1,0,2013,reg
David Carney,New York Red Bulls ,D-M,7,7,630,0,0,7,0,0,0,0,0,9,1,2,0,2013,reg
Pa-Modou Kah,Portland Timbers,D,20,20,1721,0,0,7,4,0,0,0,0,23,16,7,1,2013,reg
Zach Scott,FC Dallas,D,21,16,1458,0,0,7,4,0,0,0,0,33,6,5,2,2013,reg
Jhon Kennedy Hurtado,FC Dallas,D,27,25,2243,0,0,8,0,0,0,0,0,28,9,5,0,2013,reg
Mike Fucito,San Jose Earthquakes ,F,7,2,228,0,0,8,1,0,0,0,0,8,2,2,0,2013,reg
Johnny Leveron,Vancouver Whitecaps,D,18,18,1620,0,0,8,1,0,0,0,0,8,10,3,0,2013,reg
Richard Eckersley,Toronto FC,D,16,16,1438,0,0,8,3,0,0,0,0,26,17,4,0,2013,reg
Chris Wingert,Real Salt Lake,D,21,20,1742,0,0,8,1,0,0,0,0,29,6,6,1,2013,reg
Omar Cummings,Houston Dynamo,F,11,1,190,0,0,8,3,0,0,0,0,4,3,0,0,2013,reg
Stephen McCarthy,New England Revolution ,D,19,17,1564,0,0,8,2,0,0,0,0,20,16,2,0,2013,reg
Shane O'Neill,FC Dallas,D,26,24,2196,0,0,8,4,0,0,0,0,28,24,6,1,2013,reg
Brad Rusin,Vancouver Whitecaps,D,19,16,1391,0,0,9,2,0,0,0,0,8,7,1,0,2013,reg
Clarence Goodson,San Jose Earthquakes ,D,9,9,791,0,0,9,3,0,0,0,0,4,9,4,0,2013,reg
Peterson Joseph,Sporting Kansas City ,M,23,14,1174,0,0,9,1,0,0,0,0,31,14,7,0,2013,reg
Sainey Nyassi,DC United ,M,14,7,676,0,0,10,1,0,0,0,0,15,12,1,0,2013,reg
Alain Rochat,DC United ,D,17,15,1373,0,0,10,2,0,0,0,0,16,14,3,0,2013,reg
Miller Bolaños,Chivas USA,M,5,2,239,0,0,10,3,0,0,0,0,2,12,0,0,2013,reg
Konrad Warzycha,Columbus Crew SC,M,13,2,272,0,0,10,0,0,0,0,0,6,4,1,0,2013,reg
Kyle Bekker,Toronto FC,M,9,3,335,0,0,11,1,0,0,0,0,5,2,0,0,2013,reg
Arevalo Rios,Chicago Fire FC,M,9,9,780,0,0,11,3,0,0,0,0,5,15,0,0,2013,reg
Bobby Burling,Chivas USA,D,23,18,1651,0,0,11,4,0,0,0,0,36,13,6,0,2013,reg
Agustin Viana,Columbus Crew SC,M-D,20,20,1519,0,0,12,1,0,0,0,0,33,29,4,0,2013,reg
Matthew Fondy,Chivas USA,F,7,1,236,0,0,12,2,0,0,0,0,6,6,0,0,2013,reg
Chris Korb,DC United ,D,30,30,2700,0,0,12,2,0,0,0,0,24,17,5,0,2013,reg
Gabriel Farfan,Chivas USA,M,20,13,1157,0,0,17,4,0,0,0,0,28,22,3,1,2013,reg
Carlos Ruiz,DC United ,F,13,5,528,0,0,20,9,0,0,0,0,3,8,0,0,2013,reg
Bradley Wright-Phillips,LAFC,F,32,29,2573,27,2,109,57,18,9,1,1,45,38,3,0,2014,reg
Dom Dwyer,Orlando City SC,F,33,31,2724,22,1,113,48,12,10,0,1,64,66,6,0,2014,reg
Robbie Keane,LA Galaxy,F,29,28,2549,19,14,122,54,12,7,8,6,23,38,2,0,2014,reg
Lee Nguyen,,M,32,32,2750,18,5,83,41,9,9,2,3,49,77,5,0,2014,reg
Obafemi Martins,FC Dallas,F,31,29,2600,17,13,77,36,7,10,7,6,25,67,4,2,2014,reg
Gyasi Zardes,Columbus Crew SC,F,32,26,2392,16,2,74,30,10,6,2,0,13,37,0,0,2014,reg
Clint Dempsey,FC Dallas,M-F,26,23,2132,15,10,113,47,6,9,4,6,34,52,4,0,2014,reg
Erick Torres,Chivas USA,F,29,29,2510,15,1,95,32,6,9,0,1,50,55,4,1,2014,reg
Chris Wondolowski,San Jose Earthquakes,F,26,26,2340,14,4,77,36,7,7,3,1,24,33,2,0,2014,reg
Joao Plata,Real Salt Lake,F,26,24,1985,13,6,56,32,8,5,4,2,14,23,0,0,2014,reg
Sébastien Le Toux,Philadelphia Union,F,29,23,2050,12,7,50,21,8,4,5,2,12,20,2,0,2014,reg
Diego Valeri,Portland Timbers,M,33,32,2763,11,14,104,42,7,4,10,4,24,45,6,0,2014,reg
Fabian Espindola,DC United ,F,27,24,2124,11,9,68,31,6,5,6,3,49,45,5,1,2014,reg
Ethan Finlay,Minnesota United FC,M,29,21,1898,11,7,50,22,4,7,2,5,19,36,2,0,2014,reg
Federico Higuain,DC United,F,29,28,2488,11,7,73,25,3,8,4,3,22,45,8,0,2014,reg
Blas Pérez,FC Dallas,F,29,24,2061,11,6,55,21,7,4,2,4,46,51,4,2,2014,reg
Giles Barnes,Houston Dynamo,M,34,34,3028,11,5,113,42,8,3,3,2,52,48,4,0,2014,reg
Luis Silva,DC United ,F,27,22,1523,11,4,39,17,5,6,1,3,20,18,2,0,2014,reg
Jermain Defoe,Toronto FC,F,19,17,1529,11,2,58,25,8,3,0,2,22,23,5,0,2014,reg
Landon Donovan,LA Galaxy,M-F,31,30,2720,10,19,66,24,7,3,11,8,31,32,7,0,2014,reg
Thierry Henry,New York Red Bulls ,F,30,30,2651,10,14,86,28,8,2,11,3,33,26,3,0,2014,reg
Pedro Morales,Vancouver Whitecaps,M,33,28,2554,10,12,105,39,7,3,8,4,19,29,4,0,2014,reg
Fabian Castillo,FC Dallas,M-F,27,26,2282,10,4,74,32,7,3,1,3,30,29,5,0,2014,reg
Maximiliano Urruti,Montreal Impact,F,30,12,1181,10,2,47,15,5,5,1,1,27,21,1,0,2014,reg
Will Bruin,FC Dallas,F,27,24,2074,10,1,68,31,8,2,1,0,18,10,3,0,2014,reg
Deshorn Brown,Colorado Rapids,F,30,26,2288,10,0,121,46,6,4,0,0,31,30,2,0,2014,reg
Javier Morales,Real Salt Lake,M,30,30,2645,9,12,64,19,3,6,7,5,52,73,6,0,2014,reg
Lamar Neagle,FC Dallas,M,32,27,2248,9,9,49,28,4,5,5,4,41,46,3,0,2014,reg
Fanendo Adi,Columbus Crew SC,F,24,18,1512,9,4,53,24,4,5,3,1,27,41,1,0,2014,reg
Marco Di Vaio,Montreal Impact,F,26,17,1739,9,4,75,32,7,2,3,1,11,25,1,0,2014,reg
Michel Garbini Pereira,FC Dallas,M-D,25,20,1787,8,5,36,13,3,5,4,1,31,20,6,1,2014,reg
Quincy Amarikwa,Chicago Fire FC,F,32,29,2549,8,5,76,29,2,6,4,1,57,101,6,1,2014,reg
Justin Meram,Real Salt Lake,M,32,19,1683,8,4,52,21,5,3,2,2,27,30,2,0,2014,reg
Conor Casey,Philadelphia Union,F,25,18,1434,8,2,39,17,5,3,2,0,37,24,1,0,2014,reg
Alvaro Saborio,Real Salt Lake,F,16,13,1148,8,2,47,18,6,2,0,2,25,18,3,0,2014,reg
Jack McInerney,Montreal Impact,F,30,25,2116,8,2,56,19,6,2,1,1,21,19,2,0,2014,reg
Harry Shipp,Chicago Fire FC,M,33,26,2346,7,6,40,16,3,4,4,2,10,22,0,0,2014,reg
Gilberto,Toronto FC,F,28,21,1955,7,5,73,22,2,5,4,1,45,44,3,0,2014,reg
Mike Magee,Chicago Fire FC,M,17,17,1519,7,4,40,16,6,1,2,2,15,25,4,0,2014,reg
Andrew Wenger,Montreal Impact,D-M,32,22,2120,7,4,66,27,5,2,2,2,35,22,1,1,2014,reg
Tesho Akindele,Orlando City SC,F-M,26,18,1748,7,3,30,16,2,5,2,1,18,21,2,0,2014,reg
Eddie Johnson,DC United ,F,26,22,1957,7,3,42,18,5,2,3,0,34,49,3,1,2014,reg
Gaston Fernandez,Portland Timbers,M,32,17,1562,7,2,37,17,5,2,0,2,23,43,3,0,2014,reg
Chad Barrett,FC Dallas,F,26,8,867,7,1,30,14,3,4,0,1,19,6,2,0,2014,reg
Luke Mulholland,Real Salt Lake,M,31,24,1987,6,7,41,13,3,3,5,2,25,49,4,1,2014,reg
Chris Rolfe,Chicago Fire FC,F,23,21,1755,6,6,34,13,4,2,4,2,12,21,0,0,2014,reg
Marco Pappa,FC Dallas,M,29,24,1931,6,5,62,21,5,1,3,2,34,34,3,0,2014,reg
Luke Moore,Chivas USA,F,33,24,2164,6,4,58,23,3,3,1,3,34,47,2,1,2014,reg
Andres Romero,Montreal Impact,M,29,25,2185,6,3,31,20,4,2,1,2,37,20,3,0,2014,reg
Jeff Larentowicz,Atlanta United FC,M,33,33,2970,6,3,43,19,5,1,2,1,51,23,2,0,2014,reg
Darren Mattocks,Vancouver Whitecaps,F,30,20,1802,6,3,54,23,4,2,2,1,24,33,2,0,2014,reg
Will Johnson,Portland Timbers,D,29,29,2526,6,2,59,21,4,2,2,0,25,43,4,0,2014,reg
Bernardo Añor,Columbus Crew SC,M,27,18,1672,6,1,53,19,6,0,0,1,32,21,5,2,2014,reg
Vicente Sanchez,Colorado Rapids,F,17,12,1011,6,0,25,11,5,1,0,0,12,18,2,0,2014,reg
Dillon Powers,Colorado Rapids,M,30,27,2328,5,9,33,12,4,1,5,4,25,63,2,0,2014,reg
Graham Zusi,Sporting Kansas City,M,25,24,2151,5,8,32,13,2,3,4,4,24,43,3,0,2014,reg
Stefan Ishizaki,LA Galaxy,M,30,22,1898,5,7,35,15,1,4,5,2,21,20,2,0,2014,reg
Kelyn Rowe,New England Revolution,M,27,21,1960,5,5,59,15,2,3,4,1,19,40,3,0,2014,reg
Perry Kitchen,LA Galaxy,M,31,31,2790,5,4,18,11,2,3,3,1,65,30,11,0,2014,reg
Baggio Husidic,LA Galaxy,M,34,26,2197,5,4,44,9,4,1,3,1,23,29,3,0,2014,reg
Diego Fagundez,New England Revolution,M,31,25,2142,5,4,67,23,4,1,3,1,22,14,2,0,2014,reg
Erik Hurtado,Sporting Kansas City,F,30,19,1805,5,3,55,22,1,4,2,1,31,21,1,0,2014,reg
Peguy Luyindula,New York Red Bulls ,F,26,15,1385,5,1,23,12,2,3,1,0,15,23,2,0,2014,reg
Rodney Wallace,Portland Timbers,D,17,12,1058,5,1,24,11,2,3,1,0,25,12,2,0,2014,reg
Alan Gordon,LA Galaxy,F,29,11,1176,5,1,39,17,3,2,1,0,33,35,3,0,2014,reg
Jairo Arrieta,Columbus Crew SC,F,23,14,1236,5,1,44,16,3,2,0,1,26,14,1,0,2014,reg
Sebastian Fernandez,Vancouver Whitecaps,F,32,24,1968,5,0,54,17,4,1,0,0,22,64,6,0,2014,reg
Brad Davis,Houston Dynamo,M,25,25,2071,4,11,39,15,1,3,7,4,23,30,1,0,2014,reg
Lloyd Sam,New York Red Bulls ,M-F,32,32,2832,4,9,37,16,4,0,5,4,30,60,6,0,2014,reg
Benny Feilhaber,Sporting Kansas City ,M,31,30,2607,4,6,47,13,1,3,3,3,44,73,6,0,2014,reg
Teal Bunbury,New England Revolution,F,31,28,2446,4,6,53,28,3,1,3,3,48,27,5,0,2014,reg
Ricardo Clark,Houston Dynamo,M,25,24,2087,4,4,50,15,2,2,4,0,33,18,5,0,2014,reg
Omar Gonzalez,Toronto FC,D,22,22,1902,4,2,18,10,2,2,0,2,28,19,5,1,2014,reg
Je-Vaughn Watson,FC Dallas,D,31,29,2481,4,2,29,8,2,2,2,0,43,20,4,2,2014,reg
Atiba Harris,San Jose Earthquakes ,D,24,19,1585,4,2,31,15,2,2,1,1,46,34,4,0,2014,reg
Kekuta Manneh,FC Cincinnati,F,29,13,1198,4,2,54,22,2,2,2,0,13,22,2,0,2014,reg
Ignacio Piatti,Montreal Impact,M,6,6,450,4,1,16,7,3,1,1,0,3,9,2,0,2014,reg
José Mari,Colorado Rapids,M,20,20,1745,4,1,34,11,0,4,0,1,22,28,3,1,2014,reg
Patrick Mullins,Toronto FC,F,21,14,1198,4,1,37,16,2,2,1,0,26,27,1,0,2014,reg
Jackson Goncalves,Toronto FC,M,26,21,1842,4,1,54,19,3,1,1,0,36,32,5,1,2014,reg
David Texeira,FC Dallas,F,19,9,839,4,0,19,10,4,0,0,0,21,22,3,0,2014,reg
Marcelo Sarvas,LA Galaxy,M,28,25,2218,3,11,39,15,3,0,6,5,57,43,6,0,2014,reg
Gonzalo Pineda,FC Dallas,M,28,24,2233,3,7,16,9,2,1,3,4,39,43,9,0,2014,reg
Felipe,DC United,M,31,28,2456,3,6,60,17,2,1,4,2,43,51,5,0,2014,reg
Sheanon Williams,Philadelphia Union,D-M,24,23,2088,3,4,17,6,3,0,2,2,24,34,2,0,2014,reg
Charlie Davies,New England Revolution ,F,18,13,1143,3,4,17,8,2,1,2,2,17,15,3,0,2014,reg
Jonathan Osorio,Toronto FC,M,27,24,2039,3,4,17,6,1,2,2,2,16,35,1,1,2014,reg
Kenny Cooper,FC Dallas,F,22,12,989,3,4,29,9,2,1,1,3,18,17,1,0,2014,reg
Dillon Serna,Colorado Rapids,M,27,18,1623,3,4,39,14,0,3,2,2,15,15,2,0,2014,reg
Mauro Diaz,FC Dallas,M,17,9,917,3,3,20,6,2,1,1,2,11,35,2,0,2014,reg
Dax McCarty,Nashville SC,M,31,29,2661,3,3,24,7,2,1,2,1,26,36,2,0,2014,reg
Dilly Duka,Chicago Fire FC,M,20,15,1354,3,3,29,9,1,2,3,0,24,18,3,0,2014,reg
Omar Cummings,Houston Dynamo,F,26,14,1270,3,3,35,14,2,1,3,0,12,7,0,0,2014,reg
Kyle Beckerman,Real Salt Lake,M,28,28,2520,3,3,49,21,1,2,2,1,38,19,4,0,2014,reg
Cordell Cato,San Jose Earthquakes ,F,27,16,1577,3,2,20,8,2,1,1,1,14,12,2,0,2014,reg
Danny Cruz,Philadelphia Union,M-F,26,16,1352,3,2,35,16,1,2,2,0,27,23,3,0,2014,reg
Yannick Djalo,San Jose Earthquakes ,M,18,13,1136,3,2,36,7,3,0,2,0,11,36,2,0,2014,reg
Maurice Edu,Philadelphia Union,M,31,31,2789,3,2,37,9,1,2,0,2,46,41,5,1,2014,reg
Andy Rose,Vancouver Whitecaps,M,16,5,552,3,1,8,6,1,2,1,0,3,2,0,0,2014,reg
Chris Schuler,Real Salt Lake,D,25,25,2154,3,1,14,6,3,0,1,0,32,9,4,0,2014,reg
Kenny Miller,Vancouver Whitecaps,F,9,7,637,3,1,15,7,3,0,1,0,10,8,0,0,2014,reg
Matt Hedges,FC Dallas,D,32,32,2790,3,1,19,6,2,1,1,0,29,17,4,0,2014,reg
Aaron Schoenfeld ,Minnesota United FC,F,15,7,748,3,1,24,11,1,2,1,0,19,15,1,0,2014,reg
Gabriel Torres,Colorado Rapids,M-F,23,11,1090,3,1,26,12,2,1,0,1,5,18,2,0,2014,reg
Soony Saad,Sporting Kansas City ,F,22,9,906,3,1,31,12,1,2,1,0,14,13,1,0,2014,reg
Robert Earnshaw,Chicago Fire FC,F,5,1,174,3,0,10,6,1,2,0,0,2,1,0,0,2014,reg
Felix Borja,Chivas USA,F,12,12,1009,3,0,24,12,3,0,0,0,14,14,0,0,2014,reg
Olmes Garcia,Real Salt Lake,F,23,12,1191,3,0,31,12,2,1,0,0,27,28,4,0,2014,reg
Cristian Maidana,Philadelphia Union,M,26,23,1889,2,11,36,11,0,2,8,3,4,22,0,1,2014,reg
Eric Alexander,New York Red Bulls ,M,34,30,2641,2,9,25,12,1,1,7,2,11,28,3,0,2014,reg
Diego Chara,Portland Timbers,M,31,31,2745,2,5,9,5,2,0,2,3,83,52,8,0,2014,reg
Dominic Oduro,Columbus Crew SC,M,35,23,2107,2,5,39,13,1,1,1,4,16,60,3,0,2014,reg
Nick DeLeon,Toronto FC,M,32,31,2707,2,5,47,18,0,2,4,1,31,25,3,0,2014,reg
Jermaine Jones,New England Revolution ,M,10,7,613,2,4,17,7,1,1,3,1,11,13,3,0,2014,reg
Andrés Escobar,FC Dallas,F,23,18,1590,2,4,23,8,2,0,3,1,16,52,0,0,2014,reg
Michael Bradley,Toronto FC,M,25,25,2198,2,4,52,12,1,1,2,2,26,28,6,0,2014,reg
Nick Hagglund,FC Cincinnati,D,25,23,2088,2,3,22,6,2,0,1,2,22,21,2,2,2014,reg
Ned Grabavoy,Real Salt Lake,M,33,30,2711,2,3,28,10,2,0,2,1,29,45,2,0,2014,reg
Paulo Nagamura,Sporting Kansas City ,M,21,21,1745,2,3,28,10,1,1,2,1,31,22,5,0,2014,reg
Vincent Nogueira,Philadelphia Union,M,29,28,2498,2,3,59,14,2,0,2,1,14,43,1,0,2014,reg
Alvas Powell,,D,15,11,1052,2,2,14,7,1,1,1,1,21,10,1,1,2014,reg
Luis Gil,Real Salt Lake,M,26,16,1386,2,2,20,6,1,1,1,1,12,12,0,0,2014,reg
Jacob Peterson,Sporting Kansas City ,F,22,13,1301,2,2,24,10,1,1,1,1,12,15,2,0,2014,reg
Tim Cahill,New York Red Bulls ,M,23,18,1516,2,2,26,8,2,0,1,1,51,17,4,1,2014,reg
Amobi Okugo,Philadelphia Union,D-M,32,31,2798,2,2,31,7,1,1,1,1,39,20,3,1,2014,reg
Khari Stephenson,San Jose Earthquakes ,M,19,11,1080,2,2,34,8,2,0,1,1,15,12,0,0,2014,reg
Brian Brown,Philadelphia Union,F,8,1,230,2,1,5,3,1,1,1,0,2,4,0,0,2014,reg
Víctor Bernárdez,San Jose Earthquakes ,D,26,25,2231,2,1,8,4,2,0,1,0,29,22,6,0,2014,reg
Mark Sherrod,Houston Dynamo,F,9,3,223,2,1,9,2,2,0,1,0,5,1,1,0,2014,reg
Liam Ridgewell,Portland Timbers,D,15,15,1350,2,1,10,4,1,1,0,1,16,14,3,0,2014,reg
Marky Delgado,Toronto FC,M,20,12,1121,2,1,12,4,1,1,0,1,24,6,4,1,2014,reg
Lawrence Olum,Sporting Kansas City ,D,25,21,1853,2,1,14,4,1,1,1,0,18,4,6,0,2014,reg
Drew Moor,Colorado Rapids,D,23,23,1994,2,1,15,7,1,1,0,1,16,19,2,0,2014,reg
Sanna Nyassi,Chicago Fire FC,M,14,10,739,2,1,18,7,0,2,1,0,23,22,2,0,2014,reg
Leo Fernandes,Philadelphia Union,M,13,7,697,2,1,20,7,0,2,1,0,8,15,0,0,2014,reg
A.J. Soares,New England Revolution ,D,32,32,2806,2,1,21,4,1,1,1,0,44,30,5,1,2014,reg
Boniek Garcia,Houston Dynamo,M,27,26,2206,2,1,25,9,2,0,0,1,39,58,4,0,2014,reg
Edson Buddle,Colorado Rapids,F,18,12,1116,2,1,33,9,1,1,1,0,24,13,1,0,2014,reg
Maxim Tissot,Montreal Impact,D,20,7,762,2,0,10,4,1,1,0,0,7,13,2,0,2014,reg
Pedro Ribeiro,Philadelphia Union,M-F,9,3,351,2,0,11,3,2,0,0,0,6,5,0,0,2014,reg
Marvin Chávez,Chivas USA,M,16,8,742,2,0,11,3,0,2,0,0,18,17,2,1,2014,reg
Nicolas Mezquida,Colorado Rapids,F-M,14,4,418,2,0,11,5,0,2,0,0,11,6,0,0,2014,reg
Claudio Bieler,Sporting Kansas City ,F,13,4,421,2,0,12,3,1,1,0,0,9,7,1,0,2014,reg
Kendall Waston,FC Cincinnati,D,10,9,821,2,0,12,2,2,0,0,0,18,9,5,0,2014,reg
Adam Bedell,Columbus Crew SC,F,16,7,632,2,0,14,10,1,1,0,0,12,5,0,0,2014,reg
CJ Sapong,Chicago Fire FC,F,20,7,811,2,0,14,5,1,1,0,0,21,22,1,0,2014,reg
Issey Nakajima-Farran,Montreal Impact,M,18,7,775,2,0,17,5,0,2,0,0,13,15,1,1,2014,reg
Jordan Harvey,LAFC,D,33,33,2939,2,0,17,4,1,1,0,0,33,26,6,1,2014,reg
Kamani Hill,Colorado Rapids,F,15,11,866,2,0,17,7,2,0,0,0,17,16,2,0,2014,reg
Juan Luis Anangono,Chicago Fire FC,F,15,4,472,2,0,18,5,2,0,0,0,10,13,0,0,2014,reg
Davy Arnaud,DC United ,M,31,30,2626,2,0,21,6,1,1,0,0,47,53,8,0,2014,reg
Aurelien Collin,Philadelphia Union,D,26,25,2104,2,0,24,6,2,0,0,0,42,27,2,2,2014,reg
Sam Cronin,San Jose Earthquakes ,M,31,30,2627,2,0,26,6,1,1,0,0,36,18,5,0,2014,reg
Shea Salinas,San Jose Earthquakes,M,31,30,2470,1,8,26,9,1,0,5,3,31,30,3,1,2014,reg
Darlington Nagbe,Columbus Crew SC,M,32,30,2681,1,7,42,17,0,1,4,3,13,93,0,0,2014,reg
Chris Tierney,New England Revolution ,D-M,24,21,1930,1,5,21,9,0,1,3,2,11,9,4,0,2014,reg
Hector Jimenez,Columbus Crew SC,M,24,19,1694,1,5,23,6,1,0,1,4,17,14,2,0,2014,reg
Wil Trapp,,M,28,28,2486,1,4,11,3,0,1,4,0,37,23,6,2,2014,reg
Sean Franklin,DC United ,D,29,28,2532,1,4,16,3,1,0,2,2,19,15,0,0,2014,reg
Kevin Alston,New England Revolution ,D,11,9,683,1,3,3,2,1,0,1,2,10,7,1,1,2014,reg
Patrick Nyarko,Chicago Fire FC,F-M,17,9,846,1,3,10,5,0,1,0,3,11,27,3,1,2014,reg
Marc Burch,Colorado Rapids,D,22,21,1899,1,3,11,1,1,0,2,1,21,12,3,0,2014,reg
Calum Mallace,Montreal Impact,M,23,12,1122,1,3,13,3,0,1,1,2,18,7,3,0,2014,reg
Chad Marshall,FC Dallas,D,31,31,2790,1,3,14,4,1,0,1,2,20,36,1,0,2014,reg
Bobby Boswell,DC United ,D,34,34,3045,1,3,19,5,1,0,2,1,36,11,2,0,2014,reg
Ben Speas,Columbus Crew SC,M-F,13,8,704,1,3,20,3,1,0,2,1,1,8,0,0,2014,reg
Antonio Dovale,Sporting Kansas City ,M,19,14,1033,1,3,29,8,1,0,2,1,15,13,3,1,2014,reg
Jorge Villafaña,Portland Timbers,F,19,17,1577,1,2,4,1,0,1,1,1,23,21,1,0,2014,reg
Sebastian Velasquez,Real Salt Lake,M,10,1,222,1,2,4,2,1,0,1,1,5,6,0,0,2014,reg
Taylor Kemp,DC United ,D,13,12,1083,1,2,5,2,0,1,2,0,14,7,2,0,2014,reg
Darrius Barnes,New England Revolution ,D,22,16,1628,1,2,6,2,0,1,1,1,29,11,4,0,2014,reg
José Gonçalves,New England Revolution ,D,27,27,2381,1,2,10,2,0,1,2,0,33,29,3,0,2014,reg
Grant Ward,Chicago Fire FC,M,23,12,1051,1,2,15,4,0,1,1,1,14,20,2,0,2014,reg
Jonny Steele,New York Red Bulls ,M,15,6,624,1,2,16,5,0,1,1,1,9,4,1,0,2014,reg
Leandro Barrera,Chivas USA,M,32,24,2071,1,2,36,16,0,1,1,1,18,43,3,0,2014,reg
Kristopher Tyrpak,Chivas USA,F,9,0,156,1,1,1,1,1,0,0,1,1,2,1,0,2014,reg
Bradley Orr,Toronto FC,D,19,14,1144,1,1,3,2,0,1,1,0,9,12,1,0,2014,reg
Mamadou Danso,Montreal Impact,D,13,12,1097,1,1,8,1,1,0,0,1,13,5,1,0,2014,reg
Matías Pérez García,San Jose Earthquakes ,F,6,4,384,1,1,10,3,0,1,0,1,5,16,0,0,2014,reg
Hassoun Camara,Montreal Impact,D,28,26,2365,1,1,11,4,0,1,1,0,56,29,11,1,2014,reg
Marlon Hairston,Minnesota United FC,M,22,9,988,1,1,12,4,1,0,1,0,12,21,1,0,2014,reg
Kalif Alhassan,Portland Timbers,M,15,5,590,1,1,14,4,1,0,1,0,6,15,1,0,2014,reg
David Horst,Houston Dynamo,D,31,31,2653,1,1,15,1,0,1,1,0,37,26,3,1,2014,reg
Gershon Koffie,Vancouver Whitecaps,M,21,17,1541,1,1,20,5,1,0,1,0,36,38,4,0,2014,reg
Matt Watson,Chicago Fire FC,M,27,22,2034,1,1,25,9,1,0,0,1,26,19,4,0,2014,reg
Lovel Palmer,Chicago Fire FC,D,30,29,2625,1,1,30,8,1,0,0,1,31,14,7,0,2014,reg
Steven Lenhart,San Jose Earthquakes ,F,11,10,905,1,1,31,12,0,1,0,1,16,42,5,0,2014,reg
Nick LaBrocca,Colorado Rapids,M,31,29,2584,1,1,32,7,1,0,0,1,38,28,9,0,2014,reg
Zach Pfeffer,Philadelphia Union,M,5,1,98,1,0,2,2,0,1,0,0,4,3,0,0,2014,reg
Warren Creavalle,Philadelphia Union,M,26,17,1502,1,0,3,3,1,0,0,0,25,19,4,0,2014,reg
Jerry Bengtson,New England Revolution,F,7,1,238,1,0,4,1,1,0,0,0,9,6,1,0,2014,reg
Carlos Salcedo,Real Salt Lake,D,12,8,800,1,0,4,2,1,0,0,0,10,5,2,0,2014,reg
John Neeskens,Colorado Rapids,D,5,3,273,1,0,5,1,0,1,0,0,5,6,0,0,2014,reg
Ruben Bover,New York Red Bulls ,M,15,2,243,1,0,5,4,1,0,0,0,6,4,1,0,2014,reg
Carlyle Mitchell,Vancouver Whitecaps,D,8,8,720,1,0,5,2,1,0,0,0,7,3,2,0,2014,reg
Zach Loyd,FC Dallas,D,29,28,2414,1,0,5,2,1,0,0,0,20,25,2,1,2014,reg
Agustin Viana,Columbus Crew SC,M-D,4,4,300,1,0,5,1,0,1,0,0,10,8,1,0,2014,reg
Pa-Modou Kah,Portland Timbers,D,20,20,1744,1,0,5,1,1,0,0,0,23,16,5,0,2014,reg
Jhon Kennedy Hurtado,Chicago Fire FC,D,25,24,2082,1,0,6,3,0,1,0,0,37,17,3,1,2014,reg
Chris Pontius,DC United ,M,6,3,276,1,0,6,4,1,0,0,0,1,6,0,0,2014,reg
Shane O'Neill,FC Dallas,D,21,21,1890,1,0,6,4,1,0,0,0,25,12,6,0,2014,reg
Thomas McNamara,Houston Dynamo,M,6,6,467,1,0,6,3,1,0,0,0,6,6,1,0,2014,reg
Leonardo,LA Galaxy,D,24,20,1837,1,0,8,1,1,0,0,0,19,7,1,0,2014,reg
Fred,Philadelphia Union,M,11,3,343,1,0,8,2,1,0,0,0,13,11,0,0,2014,reg
Bobby Burling,Chivas USA,D,22,20,1807,1,0,8,1,1,0,0,0,29,16,7,1,2014,reg
Florent Sinama-Pongolle,Chicago Fire FC,F,7,4,391,1,0,9,4,1,0,0,0,3,5,0,0,2014,reg
Saer Sene,New England Revolution ,M,15,5,485,1,0,9,4,1,0,0,0,3,3,1,0,2014,reg
Giancarlo Gonzalez,LA Galaxy,D,17,17,1530,1,0,9,1,1,0,0,0,15,11,3,0,2014,reg
Agustín Pelletieri,Chivas USA,M,27,22,1684,1,0,10,4,0,1,0,0,36,4,4,1,2014,reg
Nat Borchers,Real Salt Lake,D,32,32,2856,1,0,12,3,0,1,0,0,19,14,3,1,2014,reg
Ryan Finley,Chivas USA,F,16,4,437,1,0,13,4,1,0,0,0,4,9,0,0,2014,reg
Doneil Henry,Toronto FC,D,21,19,1802,1,0,14,3,1,0,0,0,37,18,8,0,2014,reg
Benji Joya,Chicago Fire FC,M,12,9,651,1,0,16,3,0,1,0,0,16,12,2,0,2014,reg
Jean-Baptiste Pierazzi,San Jose Earthquakes ,M,24,23,1982,1,0,17,6,0,1,0,0,24,12,3,0,2014,reg
Dwayne De Rosario,Toronto FC,M,19,4,506,1,0,19,10,0,1,0,0,9,9,1,0,2014,reg
Robbie Findley,Real Salt Lake,F,16,8,764,1,0,24,9,1,0,0,0,11,21,0,0,2014,reg
Mauro Rosales,Chivas USA,M,32,26,2366,0,11,28,7,0,0,5,6,32,73,5,0,2014,reg
Justin Mapp,Montreal Impact,M,23,20,1726,0,8,25,8,0,0,4,4,11,24,1,0,2014,reg
Waylon Francis,Columbus Crew SC,D,24,24,2111,0,6,11,3,0,0,3,3,32,12,5,1,2014,reg
Tony Tchani,Columbus Crew SC,M,33,33,2942,0,6,35,8,0,0,2,4,56,46,7,0,2014,reg
Dan Gargan,LA Galaxy,D,29,27,2400,0,5,7,1,0,0,0,5,37,21,7,1,2014,reg
Brad Evans,FC Dallas,D-M,26,22,1896,0,5,8,2,0,0,1,4,28,24,4,0,2014,reg
Kofi Sarkodie,Houston Dynamo,D,32,32,2872,0,4,5,1,0,0,3,1,43,34,7,1,2014,reg
DeAndre Yedlin,Seattle Sounders FC,D,25,25,2220,0,4,7,2,0,0,2,2,45,25,4,0,2014,reg
Jair Benítez,FC Dallas,D,26,19,1716,0,4,10,2,0,0,3,1,16,32,1,0,2014,reg
Daigo Kobayashi,New England Revolution ,M,34,23,1867,0,4,24,6,0,0,2,2,21,23,4,0,2014,reg
Juninho,LA Galaxy,M,34,31,2758,0,4,55,15,0,0,1,3,35,29,3,0,2014,reg
Kosuke Kimura,New York Red Bulls ,D,13,10,884,0,3,0,0,0,0,2,1,12,7,0,0,2014,reg
Steven Beitashour,Vancouver Whitecaps,D,27,27,2371,0,3,3,0,0,0,2,1,23,33,3,0,2014,reg
Chris Korb,DC United ,D,19,15,1376,0,3,4,2,0,0,3,0,15,6,3,0,2014,reg
Martin Rivero,Chivas USA,M,7,6,577,0,3,4,1,0,0,0,3,9,12,1,0,2014,reg
Kevin Ellis,Sporting Kansas City ,D,20,16,1538,0,3,6,1,0,0,2,1,22,14,3,0,2014,reg
Ambroise Oyongo,New York Red Bulls ,D,13,11,1045,0,3,8,5,0,0,1,2,10,12,0,0,2014,reg
Justin Morrow,Toronto FC,D,31,30,2676,0,3,8,1,0,0,0,3,29,22,6,0,2014,reg
Chris Wingert,Real Salt Lake,D,30,30,2537,0,3,8,2,0,0,2,1,29,15,6,0,2014,reg
Corey Ashe,Houston Dynamo,M,21,20,1879,0,3,8,2,0,0,2,1,11,24,2,0,2014,reg
Roy Miller,New York Red Bulls ,D,23,22,1943,0,3,10,0,0,0,3,0,26,9,2,0,2014,reg
Patrice Bernier,Montreal Impact,M,26,20,1802,0,3,11,2,0,0,2,1,32,20,2,0,2014,reg
Steve Zakuani,Portland Timbers,M,17,9,739,0,3,19,3,0,0,2,1,4,14,0,0,2014,reg
Sal Zizzo,Sporting Kansas City ,D,19,13,1097,0,3,19,7,0,0,1,2,8,9,0,0,2014,reg
A.J. DeLaGarza,,D,29,28,2491,0,2,2,2,0,0,2,0,24,31,4,0,2014,reg
Michael Harrington,Portland Timbers,D,25,21,1749,0,2,3,0,0,0,1,1,22,7,1,1,2014,reg
David Estrada,DC United ,M-F,10,3,306,0,2,4,1,0,0,1,1,4,8,0,0,2014,reg
Greg Cochrane,Chicago Fire FC,D,12,12,1063,0,2,4,1,0,0,1,1,6,3,2,0,2014,reg
Daniel Lovitz,Nashville SC,D,18,5,631,0,2,5,4,0,0,2,0,12,16,2,0,2014,reg
Scott Caldwell,New England Revolution,M,26,14,1553,0,2,6,1,0,0,0,2,29,12,6,0,2014,reg
Jack Jewsbury,Portland Timbers,M,19,16,1428,0,2,6,2,0,0,2,0,17,11,1,0,2014,reg
Nigel Reo-Coker,Chivas USA,M,21,17,1467,0,2,7,2,0,0,1,1,31,18,4,1,2014,reg
Fabinho,Philadelphia Union,D,19,19,1636,0,2,7,0,0,0,2,0,30,21,6,0,2014,reg
Raymon Gaddis,Philadelphia Union,D,34,34,3051,0,2,8,2,0,0,1,1,37,26,3,0,2014,reg
Robbie Rogers,LA Galaxy,D,19,15,1372,0,2,13,4,0,0,1,1,24,14,2,0,2014,reg
Russell Teibert,Vancouver Whitecaps,M,29,22,1971,0,2,15,1,0,0,0,2,29,16,4,0,2014,reg
Igor Juliao,Sporting Kansas City ,D,23,23,1992,0,2,15,4,0,0,0,2,25,52,4,0,2014,reg
Collen Warner,Colorado Rapids,M,29,28,2295,0,2,21,1,0,0,0,2,49,30,4,1,2014,reg
Seth Sinovic,New England Revolution,D,31,31,2755,0,2,21,7,0,0,0,2,51,22,6,0,2014,reg
Osvaldo Alonso,Minnesota United FC,M,33,33,2952,0,2,33,4,0,0,1,1,45,58,7,0,2014,reg
Akira Kaji,Chivas USA,D,15,14,1270,0,1,0,0,0,0,1,0,20,6,1,0,2014,reg
Matt Dunn,Chivas USA,M,7,4,407,0,1,0,0,0,0,1,0,9,6,0,0,2014,reg
Bradford Jamieson IV,LA Galaxy,F,2,0,23,0,1,0,0,0,0,0,1,1,0,0,0,2014,reg
Matt Miazga,New York Red Bulls,D,7,6,500,0,1,1,0,0,0,1,0,6,1,2,1,2014,reg
Tony Lochhead,Chivas USA,D,20,19,1697,0,1,1,0,0,0,1,0,37,9,6,0,2014,reg
Stephen Keel,FC Dallas,D,16,14,1307,0,1,1,0,0,0,1,0,13,7,2,0,2014,reg
Chance Myers,Sporting Kansas City ,D,7,7,576,0,1,1,0,0,0,0,1,3,7,1,0,2014,reg
Krzysztof Krol,Montreal Impact,D,12,11,961,0,1,2,0,0,0,0,1,24,8,4,1,2014,reg
Andy O'Brien,Vancouver Whitecaps,D,26,25,2258,0,1,2,1,0,0,1,0,25,6,3,0,2014,reg
Chris Duvall,Portland Timbers,D,19,18,1604,0,1,2,0,0,0,0,1,8,19,0,0,2014,reg
Austin Berry,Philadelphia Union,D,6,6,497,0,1,2,0,0,0,1,0,6,3,2,0,2014,reg
Wandrille Lefevre,Montreal Impact,D,15,13,1220,0,1,3,1,0,0,0,1,20,8,3,0,2014,reg
Adolfo Bautista,Chivas USA,F,7,1,148,0,1,3,0,0,0,0,1,7,4,1,0,2014,reg
Lewis Neal,DC United ,M,26,7,899,0,1,3,1,0,0,0,1,8,10,4,0,2014,reg
Marvell Wynne,Colorado Rapids,D,28,27,2404,0,1,3,0,0,0,1,0,20,9,2,1,2014,reg
Nathan Sturgis,Chivas USA,M,22,13,1201,0,1,3,0,0,0,0,1,20,11,5,0,2014,reg
Hendry Thomas,FC Dallas,M,10,9,770,0,1,4,0,0,0,1,0,19,9,2,1,2014,reg
Matt Besler,Sporting Kansas City,D,24,24,2145,0,1,4,0,0,0,0,1,37,13,4,1,2014,reg
Michael Lahoud,Philadelphia Union,M,8,4,437,0,1,4,1,0,0,0,1,9,4,2,1,2014,reg
Abdoulie Mansally,Real Salt Lake,D,11,6,655,0,1,5,2,0,0,0,1,9,8,1,0,2014,reg
Chris Klute,Colorado Rapids,D,25,24,2132,0,1,6,2,0,0,1,0,20,4,1,0,2014,reg
Kellyn Acosta,Colorado Rapids,M,15,9,843,0,1,7,0,0,0,1,0,13,8,2,0,2014,reg
Jared Watts,Colorado Rapids,D-M,17,13,1149,0,1,8,2,0,0,0,1,25,6,2,1,2014,reg
Andrew Jean-Baptiste,Chivas USA,D,10,8,731,0,1,8,0,0,0,0,1,10,4,2,0,2014,reg
Jalil Anibaba,Nashville SC,D,16,14,1283,0,1,8,1,0,0,0,1,14,6,1,0,2014,reg
Matias Laba,Vancouver Whitecaps,M,32,31,2738,0,1,8,1,0,0,0,1,61,39,8,1,2014,reg
Clarence Goodson,San Jose Earthquakes ,D,10,10,900,0,1,8,1,0,0,1,0,10,15,2,0,2014,reg
Cristian Fernández Salas,DC United ,D,15,15,1342,0,1,9,3,0,0,0,1,14,20,3,0,2014,reg
Jordan Stewart,San Jose Earthquakes ,D-M,30,29,2593,0,1,9,0,0,0,1,0,36,26,5,0,2014,reg
Mark Bloom,Toronto FC,D,26,26,2290,0,1,9,3,0,0,0,1,21,27,2,0,2014,reg
Devon Sandoval,Real Salt Lake,F,15,7,633,0,1,9,3,0,0,1,0,16,10,0,0,2014,reg
Eric Miller,Nashville SC,D,21,18,1646,0,1,10,3,0,0,1,0,18,9,0,0,2014,reg
Andy Dorman,New England Revolution ,M,16,15,1237,0,1,10,3,0,0,1,0,21,9,6,0,2014,reg
Josh Williams,Columbus Crew SC,D,14,13,1123,0,1,11,2,0,0,0,1,14,2,1,0,2014,reg
Victor Ulloa,,M,28,26,2365,0,1,13,3,0,0,1,0,16,21,4,0,2014,reg
Jámison Olave,New York Red Bulls ,D,28,28,2519,0,1,13,0,0,0,1,0,42,29,8,0,2014,reg
Rob Friend,LA Galaxy,F,10,4,376,0,1,14,3,0,0,0,1,4,16,0,0,2014,reg
Brian Carroll,Philadelphia Union,M,21,17,1467,0,1,14,2,0,0,1,0,11,6,0,0,2014,reg
Eric Avila,Chivas USA,M,29,26,2171,0,1,16,5,0,0,1,0,23,26,2,0,2014,reg
Charles Eloundou,Colorado Rapids,F,11,4,417,0,1,20,10,0,0,0,1,9,7,2,0,2014,reg
Alex,Chicago Fire FC,M,28,24,1986,0,1,28,7,0,0,0,1,33,35,3,0,2014,reg
Carlos Alvarez,Chivas USA,M,21,13,1262,0,1,29,7,0,0,1,0,28,9,4,0,2014,reg
Andrew Driver,Houston Dynamo,M,34,22,1897,0,1,29,7,0,0,0,1,25,10,1,0,2014,reg
Brian Mullan,Colorado Rapids,D,0,0,0,0,0,0,0,0,0,0,0,0,0,0,0,2014,reg
Shalrie Joseph,New England Revolution ,M,0,0,0,0,0,0,0,0,0,0,0,0,0,0,0,2014,reg
Andreas Gorlitz,San Jose Earthquakes ,D,3,3,224,0,0,0,0,0,0,0,0,2,2,1,0,2014,reg
Emanuel Pogatetz,Columbus Crew SC,D,2,0,52,0,0,0,0,0,0,0,0,1,1,0,0,2014,reg
Onyekachi Apam,FC Dallas,D,0,0,0,0,0,0,0,0,0,0,0,0,0,0,0,2014,reg
James Riley,LA Galaxy,D,4,3,254,0,0,0,0,0,0,0,0,11,4,2,0,2014,reg
Jason Hernandez,San Jose Earthquakes ,D,20,20,1732,0,0,0,0,0,0,0,0,18,14,4,0,2014,reg
Carlos Borja,Chivas USA,D,0,0,0,0,0,0,0,0,0,0,0,0,0,0,0,2014,reg
Lyle Martin,Chivas USA,F,0,0,0,0,0,0,0,0,0,0,0,0,0,0,0,2014,reg
Nana Attakora,DC United ,D,0,0,0,0,0,0,0,0,0,0,0,0,0,0,0,2014,reg
Keon Daniel,Philadelphia Union,M,0,0,0,0,0,0,0,0,0,0,0,0,0,0,0,2014,reg
Damien Perrinelle,New York Red Bulls ,D,2,0,7,0,0,0,0,0,0,0,0,0,0,0,0,2014,reg
Nelson Rivas,Montreal Impact,D,0,0,0,0,0,0,0,0,0,0,0,0,0,0,0,2014,reg
Eric Brunner,Houston Dynamo,D,6,3,297,0,0,0,0,0,0,0,0,4,3,1,0,2014,reg
Adrian Lopez,Montreal Impact,D,0,0,0,0,0,0,0,0,0,0,0,0,0,0,0,2014,reg
George John,FC Dallas,D,0,0,0,0,0,0,0,0,0,0,0,0,0,0,0,2014,reg
Cam Weaver,FC Dallas,F,3,0,31,0,0,0,0,0,0,0,0,4,2,0,0,2014,reg
Mike Fucito,San Jose Earthquakes ,F,8,0,95,0,0,0,0,0,0,0,0,5,1,1,0,2014,reg
James Bissue,Montreal Impact,M,0,0,0,0,0,0,0,0,0,0,0,0,0,0,0,2014,reg
Andre Akpan,New England Revolution ,F,5,0,16,0,0,0,0,0,0,0,0,4,1,1,0,2014,reg
Peterson Joseph,Sporting Kansas City ,M,0,0,0,0,0,0,0,0,0,0,0,0,0,0,0,2014,reg
Gale Agbossoumonde,Colorado Rapids,D,0,0,0,0,0,0,0,0,0,0,0,0,0,0,0,2014,reg
Kwame Watson-Siriboe,Real Salt Lake,D,0,0,0,0,0,0,0,0,0,0,0,0,0,0,0,2014,reg
Corben Bone,Philadelphia Union,M,2,0,13,0,0,0,0,0,0,0,0,4,0,1,1,2014,reg
Geoffrey Castillion,New England Revolution ,F,1,0,14,0,0,0,0,0,0,0,0,0,0,0,0,2014,reg
Tony Taylor,New England Revolution ,F-M,1,0,9,0,0,0,0,0,0,0,0,0,0,0,0,2014,reg
Charlie Rugg,LA Galaxy,F,0,0,0,0,0,0,0,0,0,0,0,0,0,0,0,2014,reg
Jossimar Sanchez,New England Revolution ,D,0,0,0,0,0,0,0,0,0,0,0,0,0,0,0,2014,reg
Michael Bustamante,New York Red Bulls ,M,0,0,0,0,0,0,0,0,0,0,0,0,0,0,0,2014,reg
Christian Duke,Sporting Kansas City ,M,0,0,0,0,0,0,0,0,0,0,0,0,0,0,0,2014,reg
Andrew Ribeiro,Chivas USA,D,0,0,0,0,0,0,0,0,0,0,0,0,0,0,0,2014,reg
Donnie Smith,New England Revolution ,M,1,1,45,0,0,0,0,0,0,0,0,0,0,0,0,2014,reg
Anthony Arena,Houston Dynamo,D,0,0,0,0,0,0,0,0,0,0,0,0,0,0,0,2014,reg
Brenton Griffiths,Colorado Rapids,D,0,0,0,0,0,0,0,0,0,0,0,0,0,0,0,2014,reg
Andre Lewis,Vancouver Whitecaps,M,0,0,0,0,0,0,0,0,0,0,0,0,0,0,0,2014,reg
Zakaria Messoudi,Montreal Impact,M,0,0,0,0,0,0,0,0,0,0,0,0,0,0,0,2014,reg
Bryan Salazar,Houston Dynamo,F,0,0,0,0,0,0,0,0,0,0,0,0,0,0,0,2014,reg
Caleb Calvert,Chivas USA,F,0,0,0,0,0,0,0,0,0,0,0,0,0,0,0,2014,reg
Erik Palmer-Brown,Sporting Kansas City ,D,3,2,235,0,0,0,0,0,0,0,0,4,1,2,1,2014,reg
Manny Aparicio,Toronto FC,M,0,0,0,0,0,0,0,0,0,0,0,0,0,0,0,2014,reg
Aminu Abdallah,Vancouver Whitecaps,M,0,0,0,0,0,0,0,0,0,0,0,0,0,0,0,2014,reg
Jimmy Ockford,FC Dallas,D,0,0,0,0,0,0,0,0,0,0,0,0,0,0,0,2014,reg
Ben Sweat,,D,0,0,0,0,0,0,0,0,0,0,0,0,0,0,0,2014,reg
Aaron Long,New York Red Bulls,D,0,0,0,0,0,0,0,0,0,0,0,0,0,0,0,2014,reg
Eric Stevenson,New York Red Bulls ,M,1,0,1,0,0,0,0,0,0,0,0,0,0,0,0,2014,reg
Grant Van De Casteele,Colorado Rapids,D,1,0,29,0,0,0,0,0,0,0,0,0,0,0,0,2014,reg
Kyle Venter,LA Galaxy,D,0,0,0,0,0,0,0,0,0,0,0,0,0,0,0,2014,reg
Fabio Pereira,FC Dallas,M,0,0,0,0,0,0,0,0,0,0,0,0,0,0,0,2014,reg
Sam Adekugbe,Vancouver Whitecaps,D,4,1,193,0,0,0,0,0,0,0,0,3,3,1,0,2014,reg
Benji Lopez,Real Salt Lake,F,0,0,0,0,0,0,0,0,0,0,0,0,0,0,0,2014,reg
Jeremy Gagnon-Lapare,Montreal Impact,M,5,3,270,0,0,0,0,0,0,0,0,6,3,2,0,2014,reg
Aaron Kovar,FC Dallas,M,3,0,25,0,0,0,0,0,0,0,0,0,1,0,0,2014,reg
Fifi Baiden,Columbus Crew SC,M,1,0,17,0,0,0,0,0,0,0,0,0,0,0,0,2014,reg
Taylor Peay,Portland Timbers,D,0,0,0,0,0,0,0,0,0,0,0,0,0,0,0,2014,reg
Kianz Froese,Vancouver Whitecaps,M,1,0,45,0,0,0,0,0,0,0,0,2,1,0,0,2014,reg
Mamadou Diouf,Vancouver Whitecaps,F,0,0,0,0,0,0,0,0,0,0,0,0,0,0,0,2014,reg
George Fochive,Portland Timbers,M,0,0,0,0,0,0,0,0,0,0,0,0,0,0,0,2014,reg
Michael Kafari,Sporting Kansas City ,M,0,0,0,0,0,0,0,0,0,0,0,0,0,0,0,2014,reg
Marco Franco,Chicago Fire FC,D-M,0,0,0,0,0,0,0,0,0,0,0,0,0,0,0,2014,reg
Ross Friedman,Columbus Crew SC,D,0,0,0,0,0,0,0,0,0,0,0,0,0,0,0,2014,reg
Justen Glad,Real Salt Lake,D,0,0,0,0,0,0,0,0,0,0,0,0,0,0,0,2014,reg
Richie Marquez,Philadelphia Union,D,0,0,0,0,0,0,0,0,0,0,0,0,0,0,0,2014,reg
Bryan Gallego,Portland Timbers,D,0,0,0,0,0,0,0,0,0,0,0,0,0,0,0,2014,reg
Giuseppe Gentile,Chicago Fire FC,F,0,0,0,0,0,0,0,0,0,0,0,0,0,0,0,2014,reg
Nicholas Walker,FC Dallas,D,1,0,3,0,0,0,0,0,0,0,0,0,0,0,0,2014,reg
Michael Nwiloh,Chivas USA,D,0,0,0,0,0,0,0,0,0,0,0,0,0,0,0,2014,reg
Walter Cabrera,FC Dallas,D,0,0,0,0,0,0,0,0,0,0,0,0,0,0,0,2014,reg
Louis Beland-Goyette,Montreal Impact,M,1,0,15,0,0,0,0,0,0,0,0,0,3,0,0,2014,reg
Chris Mannella,Toronto FC,M,0,0,0,0,0,0,0,0,0,0,0,0,0,0,0,2014,reg
Gege Soriola,Montreal Impact,D,0,0,0,0,0,0,0,0,0,0,0,0,0,0,0,2014,reg
Coy Craft,FC Dallas,F-M,1,0,6,0,0,0,0,0,0,0,0,0,0,0,0,2014,reg
Romain Gall,Columbus Crew SC,M,3,0,43,0,0,0,0,0,0,0,0,2,1,0,0,2014,reg
Connor Lade,New York Red Bulls ,D,6,0,11,0,0,0,0,0,0,0,0,0,0,0,0,2014,reg
Bryce Alderson,Vancouver Whitecaps,M,0,0,0,0,0,0,0,0,0,0,0,0,0,0,0,2014,reg
Dimitry Imbongo,New England Revolution ,F,2,0,32,0,0,0,0,0,0,0,0,1,0,0,0,2014,reg
Jimmy McLaughlin,FC Cincinnati,M,1,0,1,0,0,0,0,0,0,0,0,0,0,0,0,2014,reg
O'Brian Woodbine,New England Revolution ,D,0,0,0,0,0,0,0,0,0,0,0,0,0,0,0,2014,reg
Sam Garza,San Jose Earthquakes ,M,1,0,10,0,0,0,0,0,0,0,0,0,0,0,0,2014,reg
Hunter Jumper,Chicago Fire FC,D,0,0,0,0,0,0,0,0,0,0,0,0,0,0,0,2014,reg
Jonathan Top,FC Dallas,F,0,0,0,0,0,0,0,0,0,0,0,0,0,0,0,2014,reg
Ethan White,Philadelphia Union,D,12,12,1042,0,0,0,0,0,0,0,0,12,4,0,0,2014,reg
Jack McBean,LA Galaxy,F,0,0,0,0,0,0,0,0,0,0,0,0,0,0,0,2014,reg
Orr Barouch,Chicago Fire FC,F,0,0,0,0,0,0,0,0,0,0,0,0,0,0,0,2014,reg
Ashtone Morgan,Real Salt Lake,D,3,2,168,0,0,0,0,0,0,0,0,1,2,0,1,2014,reg
Davy Armstrong,Colorado Rapids,M,2,0,57,0,0,0,0,0,0,0,0,3,0,0,0,2014,reg
Stephen McCarthy,New England Revolution ,D,1,1,90,0,0,0,0,0,0,0,0,1,0,0,0,2014,reg
Conor Shanosky,DC United ,M-D,0,0,0,0,0,0,0,0,0,0,0,0,0,0,0,2014,reg
Ryan Richter,Toronto FC,D,0,0,0,0,0,0,0,0,0,0,0,0,0,0,0,2014,reg
London Woodberry,FC Dallas,D,0,0,0,0,0,0,0,0,0,0,0,0,0,0,0,2014,reg
Jordan Hamilton,Columbus Crew SC,F,1,0,1,0,0,0,0,0,0,0,0,0,0,0,0,2014,reg
Brian Span,FC Dallas,M,0,0,0,0,0,0,0,0,0,0,0,0,0,0,0,2014,reg
Jose Villarreal,LA Galaxy,M,5,0,19,0,0,0,0,0,0,0,0,2,3,0,0,2014,reg
Caleb Clarke,Vancouver Whitecaps,F,0,0,0,0,0,0,0,0,0,0,0,0,0,0,0,2014,reg
Sean Okoli,FC Dallas,F,3,0,19,0,0,0,0,0,0,0,0,0,1,0,0,2014,reg
Jalen Robinson,DC United ,D,0,0,0,0,0,0,0,0,0,0,0,0,0,0,0,2014,reg
Matt Walker,Columbus Crew SC,M,0,0,0,0,0,0,0,0,0,0,0,0,0,0,0,2014,reg
Ian Christianson,New York Red Bulls ,M,3,0,9,0,0,0,0,0,0,0,0,1,0,0,0,2014,reg
Tommy Muller,San Jose Earthquakes ,D,0,0,0,0,0,0,0,0,0,0,0,0,0,0,0,2014,reg
Ryan Neil,San Jose Earthquakes ,D,0,0,0,0,0,0,0,0,0,0,0,0,0,0,0,2014,reg
Alec Sundly,New England Revolution ,M,0,0,0,0,0,0,0,0,0,0,0,0,0,0,0,2014,reg
Christian Dean,Vancouver Whitecaps,D,4,1,123,0,0,0,0,0,0,0,0,0,0,0,0,2014,reg
Matt Wiet,Columbus Crew SC,D,0,0,0,0,0,0,0,0,0,0,0,0,0,0,0,2014,reg
Victor Munoz,Sporting Kansas City ,M,0,0,0,0,0,0,0,0,0,0,0,0,0,0,0,2014,reg
Steven Evans,Portland Timbers,M,0,0,0,0,0,0,0,0,0,0,0,0,0,0,0,2014,reg
Oscar Sorto,LA Galaxy,D,1,0,15,0,0,0,0,0,0,0,0,0,0,0,0,2014,reg
Christiano François,DC United ,F,0,0,0,0,0,0,0,0,0,0,0,0,0,0,0,2014,reg
Schillo Tshuma,Portland Timbers,F,0,0,0,0,0,0,0,0,0,0,0,0,0,0,0,2014,reg
Mechack Jérôme,Sporting Kansas City ,D,2,1,91,0,0,1,0,0,0,0,0,1,0,0,0,2014,reg
Victor Pineda,Chicago Fire FC,M,4,0,40,0,0,1,0,0,0,0,0,0,0,0,0,2014,reg
Josh Gardner,Sporting Kansas City ,M,1,1,89,0,0,1,0,0,0,0,0,4,1,0,0,2014,reg
Tommy Meyer,LA Galaxy,D,12,10,926,0,0,1,0,0,0,0,0,7,5,0,0,2014,reg
Rafael Garcia ,LA Galaxy,D,1,0,16,0,0,1,1,0,0,0,0,1,0,0,0,2014,reg
Jorge Claros,Sporting Kansas City ,M,7,4,419,0,0,1,0,0,0,0,0,7,3,1,0,2014,reg
Ethen Sampson,Vancouver Whitecaps,D,2,2,144,0,0,1,0,0,0,0,0,4,3,0,0,2014,reg
Dylan Remick,FC Dallas,D,13,8,693,0,0,1,0,0,0,0,0,4,4,0,0,2014,reg
Blake Smith,Montreal Impact,D,3,0,43,0,0,1,1,0,0,0,0,0,2,0,0,2014,reg
Brian Ownby,Houston Dynamo,M,19,0,329,0,0,1,1,0,0,0,0,9,13,1,1,2014,reg
Daniel Fragoso,Chivas USA,M,2,0,11,0,0,1,0,0,0,0,0,0,0,0,0,2014,reg
Rich Balchan,Real Salt Lake,D,4,2,233,0,0,1,0,0,0,0,0,5,1,0,0,2014,reg
Bright Dike,Toronto FC,F,2,0,19,0,0,1,1,0,0,0,0,1,0,0,0,2014,reg
Jeremy Hall,Toronto FC,D-M,3,2,185,0,0,1,0,0,0,0,0,1,4,0,0,2014,reg
Martin Steuble,Sporting Kansas City ,M,3,1,69,0,0,1,0,0,0,0,0,3,1,0,0,2014,reg
Mehdi Ballouchy,Vancouver Whitecaps,M,9,3,297,0,0,1,0,0,0,0,0,4,5,1,0,2014,reg
Jeff Parke,DC United ,D,13,13,1162,0,0,1,1,0,0,0,0,15,2,1,0,2014,reg
Danny O'Rourke,Portland Timbers,D,12,10,975,0,0,1,0,0,0,0,0,12,11,2,0,2014,reg
Tyson Wahl,Columbus Crew SC,D,18,15,1396,0,0,1,0,0,0,0,0,21,5,3,0,2014,reg
Djimi Traore,FC Dallas,D,15,13,1159,0,0,1,1,0,0,0,0,10,9,1,1,2014,reg
Frederic Piquionne,Portland Timbers,F,3,0,13,0,0,1,0,0,0,0,0,1,0,0,0,2014,reg
Jay DeMerit,Vancouver Whitecaps,D,11,11,924,0,0,2,0,0,0,0,0,9,3,0,0,2014,reg
Gonzalo Segares,Chicago Fire FC,D,21,20,1741,0,0,2,1,0,0,0,0,29,13,6,0,2014,reg
Logan Pause,Chicago Fire FC,M,12,6,654,0,0,2,0,0,0,0,0,5,6,1,0,2014,reg
Todd Dunivant,LA Galaxy,D,7,5,370,0,0,2,0,0,0,0,0,0,1,0,0,2014,reg
Patrick Ianni,Chicago Fire FC,D-M,12,11,1013,0,0,2,1,0,0,0,0,15,5,3,0,2014,reg
Richard Eckersley,New York Red Bulls ,D,9,8,704,0,0,2,1,0,0,0,0,13,4,2,0,2014,reg
Luis Bolanos,Chivas USA,F,3,0,51,0,0,2,0,0,0,0,0,0,2,0,0,2014,reg
Rauwshan McKenzie,Portland Timbers,D,7,6,496,0,0,2,0,0,0,0,0,8,6,2,0,2014,reg
Andrew Jacobson,FC Dallas,M,13,5,542,0,0,2,0,0,0,0,0,6,9,1,0,2014,reg
Zach Scott,FC Dallas,D,18,16,1389,0,0,2,0,0,0,0,0,26,14,6,0,2014,reg
Brandon Barklage,San Jose Earthquakes ,D,13,10,909,0,0,2,0,0,0,0,0,12,7,2,0,2014,reg
Andrew Wiedeman,Toronto FC,F,7,0,90,0,0,2,0,0,0,0,0,2,1,0,0,2014,reg
Carlos Valdés,Philadelphia Union,D,8,8,706,0,0,2,0,0,0,0,0,10,1,1,0,2014,reg
Steven Kinney,Chicago Fire FC,D,2,2,135,0,0,2,0,0,0,0,0,2,0,0,0,2014,reg
Leonardo González,FC Dallas,D,23,20,1836,0,0,2,1,0,0,0,0,30,15,3,0,2014,reg
Eriq Zavaleta,Toronto FC,D,17,15,1323,0,0,2,1,0,0,0,0,14,1,1,0,2014,reg
Kofi Opare,DC United ,D,6,5,495,0,0,2,0,0,0,0,0,4,6,2,0,2014,reg
Walker Zimmerman,Nashville SC,D,10,9,770,0,0,2,2,0,0,0,0,3,4,0,0,2014,reg
Raul Mendiola,LA Galaxy,M,3,0,57,0,0,2,0,0,0,0,0,2,0,0,0,2014,reg
Kevan George,Columbus Crew SC,M,4,2,204,0,0,2,0,0,0,0,0,3,3,0,0,2014,reg
Cole Grossman,Real Salt Lake,M,17,5,532,0,0,2,0,0,0,0,0,6,2,1,0,2014,reg
Jeb Brovsky,Montreal Impact,D,7,7,596,0,0,2,2,0,0,0,0,4,2,1,0,2014,reg
Kenney Walker,LA Galaxy,M,8,4,329,0,0,2,0,0,0,0,0,5,6,0,0,2014,reg
Karl Ouimette,Montreal Impact,D,11,9,834,0,0,2,0,0,0,0,0,21,8,3,0,2014,reg
Danny Garcia,FC Dallas,M-F,4,4,282,0,0,2,2,0,0,0,0,3,13,0,0,2014,reg
Chad Barson,Columbus Crew SC,D,13,8,766,0,0,3,2,0,0,0,0,10,11,1,0,2014,reg
Collin Martin,DC United ,M,6,2,198,0,0,3,0,0,0,0,0,3,3,0,0,2014,reg
John Stertzer,Real Salt Lake,M,9,3,273,0,0,3,0,0,0,0,0,5,6,2,0,2014,reg
Alex Caskey,DC United ,M,11,2,198,0,0,3,1,0,0,0,0,4,5,0,1,2014,reg
Antoine Hoppenot,Philadelphia Union,F,13,1,205,0,0,3,1,0,0,0,0,2,13,0,0,2014,reg
Anthony Jackson-Hamel,Montreal Impact,F,4,1,132,0,0,3,1,0,0,0,0,2,5,0,0,2014,reg
Michael Seaton,DC United ,F,2,1,60,0,0,3,2,0,0,0,0,1,1,0,0,2014,reg
Marius Obekop,New York Red Bulls ,M,2,0,41,0,0,3,2,0,0,0,0,0,0,0,0,2014,reg
Santiago Gonzalez,Montreal Impact,F,9,0,80,0,0,3,0,0,0,0,0,3,3,0,0,2014,reg
Aaron Maund,Real Salt Lake,D,6,5,432,0,0,3,1,0,0,0,0,10,4,0,1,2014,reg
Alvaro Rey,Columbus Crew SC,M,9,6,491,0,0,3,1,0,0,0,0,10,12,1,0,2014,reg
Kyle Porter,DC United ,M,5,0,65,0,0,3,1,0,0,0,0,2,2,0,0,2014,reg
Tristan Bowen,FC Dallas,F,2,0,60,0,0,3,1,0,0,0,0,1,1,0,0,2014,reg
Armando,New York Red Bulls ,M,19,14,1350,0,0,3,1,0,0,0,0,16,19,6,0,2014,reg
Bobby Convey,New York Red Bulls ,M,13,9,743,0,0,3,0,0,0,0,0,8,4,0,0,2014,reg
Heath Pearce,Montreal Impact,D,23,20,1822,0,0,3,0,0,0,0,0,12,13,0,1,2014,reg
Matteo Ferrari,Montreal Impact,D,25,25,2148,0,0,3,0,0,0,0,0,36,22,6,0,2014,reg
Zat Knight,Colorado Rapids,D,4,3,315,0,0,4,1,0,0,0,0,1,1,1,0,2014,reg
Carlos Bocanegra,Chivas USA,D,18,18,1620,0,0,4,1,0,0,0,0,13,11,1,0,2014,reg
Thomas Piermayr,Colorado Rapids,D,14,14,1146,0,0,4,0,0,0,0,0,18,8,4,1,2014,reg
Bakary Soumare,Chicago Fire FC,D,26,25,2275,0,0,4,1,0,0,0,0,33,19,5,0,2014,reg
Michael Parkhurst,Columbus Crew SC,D,33,32,2806,0,0,4,1,0,0,0,0,11,19,1,0,2014,reg
Daniel Paladini,Columbus Crew SC,M,4,3,221,0,0,4,1,0,0,0,0,4,2,1,0,2014,reg
Jared Jeffrey,DC United ,M,10,2,329,0,0,4,1,0,0,0,0,12,1,2,0,2014,reg
Conor Doyle,DC United ,F,17,1,301,0,0,4,2,0,0,0,0,11,10,1,0,2014,reg
Ike Opara,Minnesota United FC,D,3,2,152,0,0,4,2,0,0,0,0,4,2,0,0,2014,reg
Pablo Pintos,San Jose Earthquakes ,D,6,6,476,0,0,4,1,0,0,0,0,6,4,1,1,2014,reg
Jimmy Medranda ,Nashville SC,D,5,1,131,0,0,4,0,0,0,0,0,5,4,0,0,2014,reg
Adam Jahn,Atlanta United FC,F,4,2,186,0,0,4,0,0,0,0,0,0,6,0,1,2014,reg
Chris Ritter,Chicago Fire FC,M,10,8,636,0,0,4,2,0,0,0,0,17,7,4,0,2014,reg
Chandler Hoffman,LA Galaxy,F,8,0,61,0,0,4,2,0,0,0,0,2,0,1,0,2014,reg
Omar Salgado,Vancouver Whitecaps,F,8,2,198,0,0,4,2,0,0,0,0,3,9,0,0,2014,reg
Michael Nanchoff,Portland Timbers,M,3,1,85,0,0,4,2,0,0,0,0,2,2,0,0,2014,reg
Billy Schuler,San Jose Earthquakes ,F,6,1,137,0,0,4,1,0,0,0,0,0,4,0,0,2014,reg
Jason Johnson,Houston Dynamo,F,8,0,186,0,0,5,2,0,0,0,0,2,4,0,0,2014,reg
Servando Carrasco,Houston Dynamo,M,16,9,784,0,0,5,1,0,0,0,0,9,8,0,1,2014,reg
Matthew Fondy,Chicago Fire FC,F,9,0,126,0,0,5,3,0,0,0,0,4,3,1,0,2014,reg
Johnny Leveron,Vancouver Whitecaps,D,16,15,1394,0,0,5,2,0,0,0,0,15,5,2,1,2014,reg
Danny Mwanga,Colorado Rapids,F,6,2,214,0,0,5,0,0,0,0,0,4,4,0,0,2014,reg
Oswaldo Minda,Chivas USA,M,20,20,1613,0,0,5,0,0,0,0,0,41,21,12,1,2014,reg
Ty Harden,San Jose Earthquakes ,D,17,13,1226,0,0,5,2,0,0,0,0,8,5,1,0,2014,reg
DaMarcus Beasley,Houston Dynamo,D,10,10,821,0,0,5,1,0,0,0,0,2,13,1,0,2014,reg
Steven Caldwell,Toronto FC,D,21,21,1774,0,0,5,0,0,0,0,0,15,8,3,1,2014,reg
Gorka Larrea,Montreal Impact,M,9,5,428,0,0,5,2,0,0,0,0,9,7,2,0,2014,reg
Ibrahim Sekagya,New York Red Bulls ,D,25,23,1947,0,0,6,0,0,0,0,0,26,7,4,1,2014,reg
Andrew Farrell,New England Revolution,D,32,32,2840,0,0,6,3,0,0,0,0,18,34,1,0,2014,reg
Tommy Thompson,San Jose Earthquakes,D,13,8,690,0,0,6,1,0,0,0,0,4,20,0,0,2014,reg
Ryan Hollingshead,FC Dallas,M,11,4,289,0,0,6,1,0,0,0,0,3,3,0,0,2014,reg
Aaron Wheeler,Philadelphia Union,F,15,8,759,0,0,6,1,0,0,0,0,21,21,0,0,2014,reg
Luis Garrido,Houston Dynamo,M,11,11,915,0,0,6,2,0,0,0,0,23,6,2,0,2014,reg
Alexander Lopez,Houston Dynamo,M,10,1,247,0,0,6,2,0,0,0,0,1,2,1,0,2014,reg
Mikey Lopez,Sporting Kansas City ,M,8,5,482,0,0,7,3,0,0,0,0,12,10,2,0,2014,reg
Moises Hernandez,FC Dallas,D,17,13,1116,0,0,7,2,0,0,0,0,30,8,2,2,2014,reg
Oriol Rosell,Orlando City SC,M-D,7,7,594,0,0,7,1,0,0,0,0,11,3,0,1,2014,reg
AJ Cochran,Houston Dynamo,D,19,14,1370,0,0,7,3,0,0,0,0,18,9,3,1,2014,reg
Micheal Azira,Chicago Fire FC,M,14,6,606,0,0,7,1,0,0,0,0,13,6,2,0,2014,reg
Shaun Francis,San Jose Earthquakes ,D,20,16,1436,0,0,7,1,0,0,0,0,29,7,5,0,2014,reg
Hernan Bernardello,Montreal Impact,M,10,10,844,0,0,7,2,0,0,0,0,20,8,3,0,2014,reg
Tony Beltran,Real Salt Lake,D,29,28,2483,0,0,7,0,0,0,0,0,39,17,6,1,2014,reg
Peter Luccin,FC Dallas,M,11,2,245,0,0,8,2,0,0,0,0,9,1,1,0,2014,reg
JJ Koval,San Jose Earthquakes ,M,22,9,954,0,0,8,1,0,0,0,0,15,5,2,0,2014,reg
Tony Cascio,Houston Dynamo,M,6,4,352,0,0,8,1,0,0,0,0,3,3,0,0,2014,reg
Sebastian Jaime,Real Salt Lake,F,6,3,261,0,0,8,5,0,0,0,0,5,6,0,0,2014,reg
Alex Martinez,Sporting Kansas City ,M,10,3,411,0,0,8,3,0,0,0,0,5,17,0,0,2014,reg
Jermaine Taylor,Houston Dynamo,D,24,23,2012,0,0,9,0,0,0,0,0,34,9,7,0,2014,reg
Razvan Cocis,Chicago Fire FC,M,10,8,713,0,0,10,0,0,0,0,0,10,14,2,0,2014,reg
Ben Zemanski,Portland Timbers,M,13,7,734,0,0,10,2,0,0,0,0,19,5,2,0,2014,reg
Eric Gehrig,Columbus Crew SC,D,20,14,1178,0,0,10,2,0,0,0,0,15,4,3,0,2014,reg
Samuel,LA Galaxy,F,8,4,358,0,0,10,2,0,0,0,0,4,6,1,0,2014,reg
Steven Birnbaum,DC United,D,21,21,1890,0,0,11,1,0,0,0,0,10,14,0,0,2014,reg
Donny Toia,Real Salt Lake,D,27,24,2240,0,0,13,3,0,0,0,0,28,8,5,0,2014,reg
Norberto Paparatto,Portland Timbers,D,13,12,1049,0,0,13,4,0,0,0,0,16,9,6,0,2014,reg
Adam Moffat,FC Dallas,M,20,13,1150,0,0,14,1,0,0,0,0,22,6,4,1,2014,reg
Steve Neumann,New England Revolution ,M-F,23,3,538,0,0,15,5,0,0,0,0,7,6,0,0,2014,reg
Kyle Bekker,Toronto FC,M,20,13,1117,0,0,18,4,0,0,0,0,16,8,1,0,2014,reg
Sebastian Giovinco,Toronto FC,F,33,32,2775,22,16,181,73,12,10,9,7,43,90,4,0,2015,reg
Kei Kamara,Colorado Rapids,F,32,31,2761,22,8,135,57,13,9,6,2,59,52,6,0,2015,reg
Robbie Keane,LA Galaxy,F,24,22,2059,20,8,73,39,15,5,8,0,15,22,1,0,2015,reg
David Villa,New York City FC,F,30,29,2514,18,8,138,64,11,7,7,1,29,49,4,0,2015,reg
Bradley Wright-Phillips,LAFC,F,34,33,2865,17,7,113,51,13,4,4,3,47,44,2,0,2015,reg
Cyle Larin,Orlando City SC,F,27,24,1906,17,0,64,29,8,9,0,0,31,30,0,1,2015,reg
Fanendo Adi,Columbus Crew SC,F,33,23,2161,16,3,85,36,8,8,2,1,49,50,2,0,2015,reg
Chris Wondolowski,San Jose Earthquakes,F,31,30,2688,16,2,91,39,6,10,1,1,28,31,3,0,2015,reg
Obafemi Martins,FC Dallas,F,21,20,1805,15,6,42,28,8,7,4,2,18,48,2,0,2015,reg
Jozy Altidore,Toronto FC,F,25,21,1796,13,0,37,18,7,6,0,0,39,45,3,2,2015,reg
Ethan Finlay,Minnesota United FC,M,34,34,2790,12,13,53,28,9,3,9,4,28,25,0,0,2015,reg
Dom Dwyer,Orlando City SC,F,30,28,2546,12,2,96,40,8,4,0,2,59,81,8,1,2015,reg
Will Bruin,FC Dallas,F,33,28,2414,11,4,49,25,7,4,3,1,32,31,2,0,2015,reg
Didier Drogba,Montreal Impact,F,11,9,870,11,1,47,21,9,2,1,0,19,24,1,0,2015,reg
Benny Feilhaber,Sporting Kansas City ,M,32,30,2731,10,15,48,17,6,4,10,5,44,64,8,1,2015,reg
Clint Dempsey,FC Dallas,M-F,20,20,1742,10,10,61,27,7,3,5,5,18,39,1,0,2015,reg
Lloyd Sam,New York Red Bulls,M-F,31,27,2281,10,7,32,20,6,4,6,1,31,42,3,0,2015,reg
Krisztian Nemeth,Sporting Kansas City ,F,28,23,2037,10,6,58,20,5,5,4,2,19,36,3,0,2015,reg
Charlie Davies,New England Revolution ,F,33,25,2163,10,4,49,26,6,4,1,3,32,33,1,0,2015,reg
Chris Rolfe,DC United ,F,31,30,2455,10,4,64,29,8,2,3,1,19,30,0,0,2015,reg
Octavio Rivero,Vancouver Whitecaps,F,34,30,2734,10,3,101,41,7,3,1,2,59,73,3,0,2015,reg
David Accam,Nashville SC,F,24,21,1865,10,2,67,35,4,6,2,0,37,50,4,1,2015,reg
Fabian Castillo,FC Dallas,M-F,30,28,2559,9,9,79,30,7,2,3,6,27,37,2,0,2015,reg
Ignacio Piatti,Montreal Impact,M,26,26,2213,9,8,60,29,4,5,7,1,22,56,3,0,2015,reg
Mike Grella,New York Red Bulls,M,33,30,2364,9,7,52,21,5,4,4,3,30,25,3,0,2015,reg
Kaká,Orlando City SC,M,28,28,2439,9,7,56,21,5,4,2,5,18,36,6,1,2015,reg
CJ Sapong,Chicago Fire FC,F,27,20,1897,9,4,44,21,5,4,1,3,38,52,2,0,2015,reg
Sacha Kljestan,LA Galaxy,M,33,33,2843,8,14,58,22,3,5,9,5,43,58,4,1,2015,reg
Javier Morales,Real Salt Lake,M,26,24,2124,8,12,50,20,5,3,7,5,37,59,3,1,2015,reg
Mauro Diaz,FC Dallas,M,24,24,1992,8,10,49,17,5,3,6,4,26,76,3,0,2015,reg
Federico Higuain,DC United,F,32,32,2724,8,9,73,28,5,3,6,3,27,41,6,1,2015,reg
Sébastien Le Toux,Philadelphia Union,F,31,26,2379,8,6,50,25,4,4,5,1,21,22,4,0,2015,reg
Ricardo Clark,Houston Dynamo,M,30,30,2573,8,1,59,21,4,4,1,0,44,32,5,0,2015,reg
Dominic Oduro,Montreal Impact,M,28,18,1671,8,0,50,20,5,3,0,0,9,36,4,0,2015,reg
Lee Nguyen,,M,32,31,2706,7,10,82,30,3,4,7,3,40,79,4,1,2015,reg
Kelyn Rowe,New England Revolution,M,33,21,1924,7,6,51,24,3,4,3,3,38,35,1,0,2015,reg
Kekuta Manneh,FC Cincinnati,F,32,28,2424,7,6,82,33,2,5,4,2,20,26,3,0,2015,reg
Cristian Techera,Vancouver Whitecaps,M,22,17,1571,7,5,38,18,5,2,3,2,17,33,4,0,2015,reg
Juan Agudelo,,F,32,20,1761,7,3,54,21,4,3,3,0,51,35,4,0,2015,reg
Kennedy Igboananike,Chicago Fire FC,F,31,20,1796,7,3,66,22,4,3,1,2,35,52,4,0,2015,reg
Giles Barnes,Houston Dynamo,M,28,28,2474,7,3,75,22,7,0,2,1,35,62,5,0,2015,reg
Sebastian Lletget,LA Galaxy,M,20,17,1449,7,2,29,13,5,2,2,0,7,26,0,0,2015,reg
Michael Barrios,FC Dallas,M,26,19,1745,7,2,34,19,5,2,2,0,27,33,0,0,2015,reg
Alvaro Saborio,DC United ,F,26,22,1862,7,0,54,28,5,2,0,0,36,33,2,0,2015,reg
Justin Meram,Real Salt Lake,M,31,28,2230,6,5,75,27,4,2,3,2,27,41,3,0,2015,reg
Quincy Amarikwa,Chicago Fire FC,F,31,24,2197,6,5,77,24,0,6,2,3,48,80,2,0,2015,reg
Patrick Mullins,Toronto FC,F,24,11,1040,6,4,38,14,3,3,3,1,18,25,2,0,2015,reg
Pedro Morales,Vancouver Whitecaps,M,23,15,1429,6,4,43,17,3,3,3,1,11,18,3,1,2015,reg
Diego Fagundez,New England Revolution,M,30,19,1735,6,4,44,17,4,2,3,1,30,14,3,0,2015,reg
Gyasi Zardes,Columbus Crew SC,F,29,27,2454,6,4,45,13,3,3,4,0,28,34,3,0,2015,reg
David Texeira,FC Dallas,F,22,19,1402,6,3,36,11,2,4,1,2,26,17,1,0,2015,reg
Jack McInerney,Columbus Crew SC,F,22,15,1359,6,1,35,16,5,1,1,0,19,15,6,0,2015,reg
Jeff Larentowicz,Atlanta United FC,M,29,29,2610,6,0,34,12,3,3,0,0,27,29,5,0,2015,reg
Fabian Espindola,DC United ,F,17,15,1346,5,7,45,17,5,0,6,1,11,17,2,1,2015,reg
Tony Tchani,Columbus Crew SC,M,32,32,2787,5,6,42,16,3,2,2,4,73,40,5,0,2015,reg
Michael Bradley,Toronto FC,M,25,25,2250,5,6,57,17,4,1,6,0,22,22,3,0,2015,reg
Darlington Nagbe,Columbus Crew SC,M,33,33,2842,5,5,50,16,4,1,4,1,11,87,0,0,2015,reg
Thomas McNamara,Houston Dynamo,M,19,15,1324,5,3,23,12,4,1,2,1,18,21,3,0,2015,reg
Sebastian Jaime,Real Salt Lake,F,20,17,1267,5,2,20,8,4,1,1,1,28,22,2,1,2015,reg
Jairo Arrieta,DC United ,F,27,15,1264,5,2,28,16,4,1,1,1,46,22,1,0,2015,reg
Kevin Doyle,Colorado Rapids,F,20,16,1489,5,2,34,13,4,1,0,2,22,24,3,0,2015,reg
Gilberto,Chicago Fire FC,F,10,8,681,5,2,37,16,2,3,2,0,15,8,2,0,2015,reg
Tesho Akindele,Orlando City SC,F-M,28,14,1502,5,1,29,15,3,2,1,0,20,15,2,0,2015,reg
Blas Pérez,FC Dallas,F,23,14,1274,5,1,33,16,5,0,1,0,23,28,2,1,2015,reg
Fernando Aristeguieta,Philadelphia Union,F,21,14,1251,5,1,50,20,1,4,1,0,22,20,3,0,2015,reg
Chad Barrett,FC Dallas,F,18,9,715,5,0,18,8,2,3,0,0,9,4,1,0,2015,reg
Vincent Nogueira,Philadelphia Union,M,27,22,1993,5,0,25,10,4,1,0,0,16,37,6,0,2015,reg
Alan Gordon,LA Galaxy,F,29,7,977,5,0,34,11,3,2,0,0,40,19,7,0,2015,reg
Brad Davis,Houston Dynamo,M,30,29,2596,4,10,45,16,3,1,8,2,28,27,2,0,2015,reg
Kwadwo Poku,New York City FC,M,27,6,978,4,7,18,10,2,2,5,2,18,9,4,0,2015,reg
Juninho,LA Galaxy,M,34,32,2857,4,7,28,13,3,1,6,1,29,33,5,0,2015,reg
Teal Bunbury,New England Revolution,F,30,20,1787,4,5,26,10,3,1,2,3,50,37,6,0,2015,reg
Vicente Sanchez,Colorado Rapids,F,30,16,1399,4,5,41,16,2,2,4,1,18,28,1,0,2015,reg
Joao Plata,Real Salt Lake,F,19,17,1431,4,4,37,14,2,2,2,2,6,23,1,0,2015,reg
Andres Romero,Montreal Impact,M,27,23,1875,4,4,37,16,3,1,1,3,30,33,8,0,2015,reg
Maximiliano Urruti,Montreal Impact,F,30,12,1082,4,3,39,15,3,1,1,2,22,18,3,0,2015,reg
Gabriel Torres,Colorado Rapids,M-F,25,19,1595,4,3,42,14,1,3,1,2,20,29,1,0,2015,reg
Devon Sandoval,Real Salt Lake,F,30,17,1606,4,2,28,13,2,2,1,1,24,22,2,0,2015,reg
Lamar Neagle,FC Dallas,M,31,23,2028,4,2,40,20,1,3,2,0,29,20,2,0,2015,reg
Kevin Ellis,Sporting Kansas City ,D,27,26,2335,4,1,11,7,3,1,1,0,31,19,5,0,2015,reg
Anatole Abang,New York Red Bulls,F,17,3,392,4,1,15,8,1,3,0,1,18,10,1,0,2015,reg
Harry Shipp,Chicago Fire FC,M,33,29,2571,3,8,53,19,2,1,5,3,21,31,2,0,2015,reg
Marco Pappa,FC Dallas,M,20,17,1468,3,6,37,15,3,0,2,4,17,38,2,0,2015,reg
Dillon Powers,Colorado Rapids,M,32,25,2235,3,6,43,16,0,3,3,3,36,51,3,0,2015,reg
Boniek Garcia,Houston Dynamo,M,23,16,1460,3,5,7,4,1,2,3,2,17,29,2,1,2015,reg
Giovani dos Santos,LA Galaxy,M,10,10,803,3,5,22,10,3,0,3,2,10,13,0,0,2015,reg
Shea Salinas,San Jose Earthquakes,M,34,29,2621,3,5,36,10,2,1,2,3,29,30,2,0,2015,reg
Felipe,DC United,M,34,34,2922,3,5,56,13,2,1,3,2,33,63,5,0,2015,reg
Patrick Nyarko,Chicago Fire FC,F-M,19,14,1222,3,4,19,8,1,2,1,3,16,53,4,0,2015,reg
Marky Delgado,Toronto FC,M,20,19,1699,3,3,20,6,2,1,1,2,18,14,3,0,2015,reg
Pa-Modou Kah,Vancouver Whitecaps,D,25,24,2164,3,2,6,3,1,2,2,0,24,13,6,0,2015,reg
Mehdi Ballouchy,New York City FC,M,19,16,1259,3,2,13,7,3,0,1,1,28,27,5,0,2015,reg
Cordell Cato,San Jose Earthquakes ,F,28,18,1814,3,2,18,7,1,2,0,2,23,14,0,0,2015,reg
Shaun Maloney,Chicago Fire FC,M,14,14,1228,3,2,20,5,3,0,1,1,14,16,2,0,2015,reg
Luke Mulholland,Real Salt Lake,M,29,27,2329,3,2,26,9,1,2,1,1,37,36,7,0,2015,reg
Kellyn Acosta,Colorado Rapids,M,21,19,1606,3,2,29,8,3,0,1,1,24,23,4,1,2015,reg
Dillon Serna,Colorado Rapids,M,15,8,680,3,1,13,7,1,2,1,0,9,2,2,0,2015,reg
Conor Casey,Philadelphia Union,F,14,2,340,3,1,14,8,0,3,1,0,8,4,2,0,2015,reg
Perry Kitchen,LA Galaxy,M,33,31,2831,3,1,14,6,3,0,1,0,66,33,6,0,2015,reg
Paulo Nagamura,Sporting Kansas City ,M,21,17,1484,3,1,22,6,3,0,1,0,26,10,6,0,2015,reg
Darren Mattocks,Vancouver Whitecaps,F,22,9,848,3,1,25,9,2,1,1,0,11,16,2,0,2015,reg
Frank Lampard,New York City FC,M,10,9,733,3,1,27,4,1,2,1,0,8,16,0,0,2015,reg
Mix Diskerud,New York City FC,M,27,23,2073,3,1,32,12,2,1,1,0,32,32,3,0,2015,reg
Chris Pontius,DC United ,M,23,17,1534,3,1,35,11,3,0,1,0,18,33,1,0,2015,reg
Bryan Róchez,Orlando City SC,F,16,0,265,3,0,11,7,1,2,0,0,6,7,2,0,2015,reg
Nat Borchers,Portland Timbers,D,31,31,2790,3,0,15,8,1,2,0,0,13,6,0,0,2015,reg
Jack Jewsbury,Portland Timbers,M,26,18,1719,3,0,18,7,1,2,0,0,12,16,2,0,2015,reg
Diego Valeri,Portland Timbers,M,22,20,1713,2,8,67,22,1,1,3,5,30,25,5,0,2015,reg
Matías Pérez García,San Jose Earthquakes ,F,27,25,2032,2,7,31,14,1,1,5,2,27,84,2,2,2015,reg
Chris Tierney,New England Revolution ,D-M,31,29,2613,2,6,25,13,2,0,3,3,16,11,3,1,2015,reg
Scott Caldwell,New England Revolution,M,34,32,2882,2,5,14,5,1,1,4,1,42,34,3,0,2015,reg
Baggio Husidic,LA Galaxy,M,24,21,1924,2,5,21,5,2,0,4,1,24,31,4,0,2015,reg
Graham Zusi,Sporting Kansas City,M,25,22,1986,2,5,28,5,1,1,3,2,19,32,1,0,2015,reg
Nick DeLeon,Toronto FC,M,29,25,2221,2,5,33,8,2,0,5,0,18,18,1,0,2015,reg
Jose Villarreal,LA Galaxy,M,16,9,698,2,4,17,6,2,0,2,2,13,16,1,0,2015,reg
Ryan Hollingshead,FC Dallas,M,33,25,2171,2,3,13,4,0,2,2,1,34,35,4,0,2015,reg
Ned Grabavoy,New York City FC,M,26,22,1884,2,3,15,8,2,0,3,0,23,37,2,1,2015,reg
Razvan Cocis,Chicago Fire FC,M,26,22,2005,2,3,15,6,1,1,2,1,21,29,2,0,2015,reg
Robbie Findley,Toronto FC,F,25,18,1476,2,3,28,8,1,1,2,1,18,35,2,0,2015,reg
Steven Gerrard,LA Galaxy,M,13,13,1164,2,3,30,10,2,0,2,1,11,15,0,0,2015,reg
Justin Morrow,Toronto FC,D,32,31,2756,2,2,9,4,2,0,1,1,31,31,3,1,2015,reg
Collen Warner,Colorado Rapids,M,29,20,1747,2,2,15,4,1,1,0,2,45,17,7,0,2015,reg
Eric Ayuk,Philadelphia Union,M,28,14,1320,2,2,15,5,1,1,1,1,19,56,3,1,2015,reg
Pedro Ribeiro,Orlando City SC,M-F,18,8,732,2,2,19,10,1,1,0,2,11,14,0,0,2015,reg
Fatai Alashe,FC Cincinnati,M,28,27,2317,2,2,19,5,2,0,0,2,32,30,5,1,2015,reg
Sanna Nyassi,San Jose Earthquakes ,M,28,19,1482,2,2,19,5,1,1,0,2,40,21,6,0,2015,reg
Atiba Harris,FC Dallas,D,27,20,1849,2,2,19,3,0,2,0,2,39,8,8,0,2015,reg
Clarence Goodson,San Jose Earthquakes ,D,28,28,2398,2,2,20,7,2,0,1,1,26,32,7,0,2015,reg
Gaston Fernandez,Portland Timbers,M,21,6,721,2,2,25,6,1,1,2,0,12,19,0,0,2015,reg
Darwin Ceren,Houston Dynamo,M,26,25,2254,2,2,29,7,2,0,0,2,53,33,6,0,2015,reg
Jason Johnson,Chicago Fire FC,F,20,5,610,2,2,30,8,1,1,1,1,15,7,1,1,2015,reg
Dilly Duka,Montreal Impact,M,27,19,1789,2,2,34,13,2,0,1,1,20,18,1,0,2015,reg
Laurent Ciman,Toronto FC,D,27,27,2405,2,2,35,8,2,0,0,2,45,19,8,3,2015,reg
Aurelien Collin,Philadelphia Union,D,28,27,2407,2,1,10,3,2,0,0,1,36,30,2,1,2015,reg
Adrian Winter,Orlando City SC,M-F,9,7,600,2,1,11,5,2,0,1,0,15,13,2,1,2015,reg
Diego Chara,Portland Timbers,M,28,28,2479,2,1,11,7,1,1,1,0,63,48,8,1,2015,reg
Leonel Miranda,Houston Dynamo,M,20,11,1015,2,1,14,6,2,0,0,1,11,20,3,0,2015,reg
Victor Ulloa,,M,33,33,2915,2,1,14,5,1,1,0,1,41,19,4,0,2015,reg
Damien Perrinelle,New York Red Bulls,D,28,27,2410,2,1,16,4,0,2,1,0,42,20,11,0,2015,reg
Marcelo Sarvas,Colorado Rapids,M,25,21,1869,2,1,20,6,1,1,0,1,31,33,4,0,2015,reg
Zach Pfeffer,Philadelphia Union,M,21,11,988,2,1,27,10,2,0,0,1,17,13,0,1,2015,reg
Olmes Garcia,Real Salt Lake,F,33,15,1542,2,1,32,15,2,0,1,0,29,34,4,0,2015,reg
Robert Earnshaw,Vancouver Whitecaps,F,9,0,43,2,0,2,2,2,0,0,0,1,1,0,0,2015,reg
Anthony Wallace,New York Red Bulls,D,6,6,540,2,0,5,2,2,0,0,0,6,6,1,0,2015,reg
Ike Opara,Minnesota United FC,D,6,6,534,2,0,7,2,1,1,0,0,6,4,0,0,2015,reg
Bobby Burling,Colorado Rapids,D,22,22,1958,2,0,9,3,2,0,0,0,32,22,9,1,2015,reg
Wandrille Lefevre,Montreal Impact,D,11,11,990,2,0,9,4,1,1,0,0,9,3,1,0,2015,reg
Alex,Chicago Fire FC,M,16,9,827,2,0,12,3,2,0,0,0,12,13,1,0,2015,reg
Raul Rodriguez,Houston Dynamo,D,27,27,2364,2,0,13,4,2,0,0,0,34,13,7,1,2015,reg
Anibal Godoy,Nashville SC,M-D,10,10,894,2,0,14,4,1,1,0,0,23,24,5,0,2015,reg
Steven Birnbaum,DC United,D,22,21,1822,2,0,14,5,1,1,0,0,29,21,5,0,2015,reg
Conor Doyle,DC United ,F,25,10,1148,2,0,16,7,1,1,0,0,33,9,5,0,2015,reg
Dominique Badji,Nashville SC,F,15,9,812,2,0,18,7,0,2,0,0,24,8,1,0,2015,reg
Bobby Boswell,DC United ,D,34,33,2975,2,0,20,4,1,1,0,0,21,14,5,0,2015,reg
Kendall Waston,FC Cincinnati,D,28,28,2486,2,0,36,15,2,0,0,0,47,20,11,1,2015,reg
Cristian Maidana,Philadelphia Union,M,28,25,2121,1,15,37,18,1,0,9,6,9,9,1,1,2015,reg
Dax McCarty,Nashville SC,M,32,32,2777,1,8,18,4,1,0,5,3,35,49,6,0,2015,reg
Jonathan Osorio,Toronto FC,M,29,26,2235,1,7,21,7,0,1,7,0,22,31,1,0,2015,reg
Benoit Cheyrou,Toronto FC,M,28,28,2408,1,7,33,7,0,1,3,4,44,21,5,0,2015,reg
Rodney Wallace,Portland Timbers,D,32,23,1978,1,7,40,12,1,0,3,4,37,18,3,0,2015,reg
Taylor Kemp,DC United ,D,27,25,2261,1,6,7,2,1,0,4,2,30,19,6,0,2015,reg
Jorge Villafaña,Portland Timbers,F,33,33,2929,1,5,15,7,1,0,3,2,26,34,3,0,2015,reg
Marco Donadel,Montreal Impact,M,25,24,2000,1,5,19,8,1,0,5,0,42,20,13,2,2015,reg
Stefan Ishizaki,LA Galaxy,M,20,19,1629,1,5,25,8,1,0,2,3,17,28,3,0,2015,reg
Luke Boden,Orlando City SC,D,25,24,2238,1,4,5,1,0,1,4,0,26,11,6,1,2015,reg
Michel Garbini Pereira,FC Dallas,M-D,18,12,914,1,4,10,4,1,0,3,1,12,15,3,0,2015,reg
Jalil Anibaba,Nashville SC,D,16,14,1265,1,4,11,4,1,0,4,0,10,4,1,0,2015,reg
Kemar Lawrence,New York Red Bulls,D,23,23,2000,1,4,12,4,1,0,3,1,23,21,2,0,2015,reg
Roger Espinoza,Sporting Kansas City,M,17,17,1484,1,4,19,5,0,1,2,2,28,18,3,0,2015,reg
Tyrone Mears,FC Dallas,D,33,33,2960,1,3,7,3,1,0,2,1,29,12,3,0,2015,reg
Mauro Rosales,Vancouver Whitecaps,M,24,19,1512,1,3,11,4,1,0,2,1,15,46,0,0,2015,reg
Luke Moore,Toronto FC,F,15,6,625,1,3,12,6,1,0,2,1,9,9,2,0,2015,reg
Omar Gonzalez,Toronto FC,D,30,29,2577,1,3,13,6,1,0,3,0,34,16,3,0,2015,reg
Robbie Rogers,LA Galaxy,D,27,26,2315,1,3,14,5,1,0,2,1,33,27,6,0,2015,reg
Fabinho,Philadelphia Union,D,26,23,2106,1,3,14,3,1,0,2,1,32,35,3,0,2015,reg
Tranquillo Barnetta,Philadelphia Union,M,11,9,765,1,3,19,7,1,0,1,2,14,24,2,0,2015,reg
Lucas Melano,Portland Timbers,F,13,8,725,1,3,27,10,1,0,2,1,18,19,4,0,2015,reg
Lucas Pittinari,Colorado Rapids,M,29,25,2241,1,3,34,5,1,0,3,0,65,17,6,0,2015,reg
Juan Ramirez,Colorado Rapids,M,27,15,1459,1,3,41,10,1,0,0,3,22,73,3,0,2015,reg
José Gonçalves,New England Revolution ,D,29,28,2480,1,2,6,3,1,0,0,2,33,26,4,2,2015,reg
Ignacio Maganto,LA Galaxy,M,13,6,524,1,2,8,3,0,1,1,1,9,10,0,0,2015,reg
Brad Evans,FC Dallas,D-M,28,27,2345,1,2,9,4,1,0,2,0,23,23,4,0,2015,reg
Nathan Sturgis,Houston Dynamo,M,18,15,1292,1,2,9,3,0,1,2,0,18,19,2,1,2015,reg
Gonzalo Pineda,FC Dallas,M,28,21,1845,1,2,11,1,0,1,1,1,24,22,5,1,2015,reg
Cristian Higuita,Orlando City SC,M,26,25,2228,1,2,12,1,1,0,1,1,73,82,10,1,2015,reg
Eric Avila,Orlando City SC,M,21,15,1326,1,2,17,3,1,0,0,2,16,16,1,0,2015,reg
Jacob Peterson,Sporting Kansas City ,F,26,15,1335,1,2,21,11,0,1,2,0,9,13,2,0,2015,reg
Andrew Jacobson,New York City FC,M,33,33,2837,1,2,26,3,1,0,1,1,46,36,5,1,2015,reg
Andrew Wenger,Philadelphia Union,D-M,26,22,1725,1,2,26,9,1,0,0,2,13,7,0,0,2015,reg
Dairon Asprilla,Portland Timbers,M-F,26,10,1008,1,2,27,6,0,1,2,0,27,9,1,0,2015,reg
Kyle Beckerman,Real Salt Lake,M,26,26,2335,1,2,31,9,0,1,2,0,36,21,9,0,2015,reg
Ty Harden,Chicago Fire FC,D,5,4,393,1,1,2,1,1,0,1,0,3,0,2,0,2015,reg
Leonardo González,FC Dallas,D,16,8,712,1,1,3,2,1,0,1,0,16,7,1,0,2015,reg
Warren Creavalle,Philadelphia Union,M,19,10,896,1,1,4,3,1,0,0,1,20,8,4,1,2015,reg
Jared Watts,Colorado Rapids,D-M,13,12,1050,1,1,5,1,1,0,0,1,15,9,5,0,2015,reg
Nelson Valdez,FC Dallas,F,7,5,413,1,1,5,1,1,0,0,1,8,15,0,0,2015,reg
Andreas Ivanschitz,FC Dallas,M,6,5,439,1,1,5,2,0,1,0,1,4,10,1,0,2015,reg
Damien Perquis,Toronto FC,D,25,24,2069,1,1,6,2,1,0,1,0,25,16,6,0,2015,reg
Abdoulie Mansally,Real Salt Lake,D,19,14,1310,1,1,6,1,0,1,1,0,29,19,5,1,2015,reg
Drew Moor,Colorado Rapids,D,22,22,1980,1,1,7,1,1,0,1,0,23,24,5,0,2015,reg
Aaron Maund,Real Salt Lake,D,22,21,1974,1,1,8,2,0,1,1,0,22,10,3,0,2015,reg
Rob Lovejoy,Houston Dynamo,F,17,2,337,1,1,8,2,1,0,1,0,3,6,0,0,2015,reg
Chris Duvall,Portland Timbers,D,15,14,1283,1,1,9,5,0,1,1,0,18,17,3,0,2015,reg
Thomas,FC Dallas,M,11,7,547,1,1,9,6,1,0,1,0,8,16,1,0,2015,reg
Jámison Olave,Real Salt Lake,D,22,22,1852,1,1,9,4,1,0,1,0,21,16,2,3,2015,reg
Juan Manuel Martínez,Real Salt Lake,M-F,8,7,647,1,1,9,6,0,1,1,0,7,29,2,0,2015,reg
Matt Hedges,FC Dallas,D,31,30,2675,1,1,10,1,0,1,0,1,26,13,4,0,2015,reg
Gonzalo Verón,New York Red Bulls,M-F,13,2,321,1,1,10,4,1,0,1,0,6,11,0,0,2015,reg
Kyle Bekker,FC Dallas,M,11,4,478,1,1,10,5,0,1,0,1,5,0,1,0,2015,reg
Matias Laba,Vancouver Whitecaps,M,30,30,2539,1,1,12,4,0,1,1,0,60,22,6,2,2015,reg
Gershon Koffie,Vancouver Whitecaps,M,28,22,2001,1,1,13,2,1,0,1,0,51,37,7,0,2015,reg
Marcel de Jong,Sporting Kansas City ,D-M,13,11,847,1,1,13,3,0,1,0,1,5,10,1,0,2015,reg
DaMarcus Beasley,Houston Dynamo,D,28,28,2374,1,1,13,7,1,0,1,0,16,58,1,0,2015,reg
Khiry Shelton,Sporting Kansas City,F,17,7,824,1,1,13,4,1,0,1,0,5,10,0,0,2015,reg
Shaun Wright-Phillips,New York Red Bulls,M,12,1,291,1,1,15,3,0,1,0,1,7,7,1,0,2015,reg
Joevin Jones,FC Dallas,D-M,28,26,2257,1,1,16,4,1,0,0,1,26,30,2,0,2015,reg
Matt Miazga,New York Red Bulls,D,26,24,2128,1,1,20,8,0,1,1,0,31,18,5,2,2015,reg
Adam Jahn,Atlanta United FC,F,26,9,1005,1,1,21,6,0,1,0,1,25,14,1,1,2015,reg
Maurice Edu,Philadelphia Union,M,22,22,1980,1,1,22,5,1,0,0,1,37,34,8,0,2015,reg
Jackson Goncalves,Toronto FC,M,26,14,1374,1,1,24,6,0,1,0,1,24,34,2,0,2015,reg
Luis Gil,Real Salt Lake,M,24,16,1475,1,1,27,8,0,1,0,1,8,14,1,0,2015,reg
Nicolas Mezquida,Colorado Rapids,F-M,18,12,932,1,1,28,12,1,0,1,0,29,20,3,0,2015,reg
Ronald Zubar,New York Red Bulls,D,12,8,701,1,0,2,1,0,1,0,0,9,9,2,0,2015,reg
Hérculez Gómez,Toronto FC,F,7,2,223,1,0,3,2,1,0,0,0,6,4,0,0,2015,reg
Kwame Watson-Siriboe,New York City FC,D,11,7,687,1,0,3,1,0,1,0,0,16,3,5,1,2015,reg
Steven Vitória,Philadelphia Union,D,18,18,1575,1,0,3,1,0,1,0,0,29,13,5,0,2015,reg
Cedrick Mabwati,Columbus Crew SC,M,9,1,233,1,0,3,2,1,0,0,0,3,5,0,0,2015,reg
Adaílton,Chicago Fire FC,D,17,17,1505,1,0,4,2,1,0,0,0,22,7,6,0,2015,reg
John Stertzer,Real Salt Lake,M,19,9,860,1,0,4,2,1,0,0,0,15,15,5,0,2015,reg
Kianz Froese,Vancouver Whitecaps,M,9,1,208,1,0,5,1,0,1,0,0,4,4,2,0,2015,reg
Bradford Jamieson IV,LA Galaxy,F,7,6,457,1,0,5,2,0,1,0,0,14,10,1,0,2015,reg
James Riley,Colorado Rapids,D,16,16,1430,1,0,5,2,1,0,0,0,26,4,4,0,2015,reg
Eriq Zavaleta,Toronto FC,D,18,11,1054,1,0,6,2,0,1,0,0,10,4,1,0,2015,reg
Andy Dorman,New England Revolution ,M,18,12,1127,1,0,7,2,0,1,0,0,15,11,8,0,2015,reg
Aaron Schoenfeld ,Minnesota United FC,F,17,1,214,1,0,8,4,1,0,0,0,9,3,1,0,2015,reg
Donny Toia,Real Salt Lake,D,31,29,2699,1,0,9,6,1,0,0,0,28,12,4,0,2015,reg
Kofi Opare,DC United ,D,18,17,1615,1,0,9,1,1,0,0,0,20,6,1,0,2015,reg
Maxim Tissot,Montreal Impact,D,11,7,581,1,0,10,4,0,1,0,0,7,5,1,0,2015,reg
Nick LaBrocca,Colorado Rapids,M,13,6,607,1,0,11,2,1,0,0,0,10,5,2,0,2015,reg
Sean Franklin,DC United ,D,24,23,2089,1,0,11,3,1,0,0,0,22,9,4,0,2015,reg
Innocent Emeghara,San Jose Earthquakes ,F,7,6,494,1,0,11,4,0,1,0,0,8,12,3,0,2015,reg
Maynor Figueroa,Houston Dynamo,D,10,10,900,1,0,12,4,1,0,0,0,10,13,3,0,2015,reg
Javier Calle,New York City FC,D,12,7,542,1,0,12,4,1,0,0,0,7,2,2,0,2015,reg
Ambroise Oyongo,Montreal Impact,D,22,22,1864,1,0,13,3,0,1,0,0,24,30,1,2,2015,reg
Sebastian Hines,Orlando City SC,D,23,21,1925,1,0,14,4,1,0,0,0,27,25,3,0,2015,reg
Sam Cronin,Colorado Rapids,M,26,24,2143,1,0,18,2,1,0,0,0,38,15,9,1,2015,reg
Luis Silva,DC United ,F,24,11,876,1,0,19,9,0,1,0,0,10,14,0,0,2015,reg
Johan Venegas,Montreal Impact,M,12,9,746,1,0,21,7,1,0,0,0,13,23,4,0,2015,reg
Waylon Francis,Columbus Crew SC,D,28,28,2410,0,7,10,3,0,0,6,1,30,23,5,0,2015,reg
Steven Beitashour,Vancouver Whitecaps,D,27,27,2424,0,5,2,0,0,0,1,4,33,28,5,0,2015,reg
Andrea Pirlo,New York City FC,M,13,12,1074,0,5,20,3,0,0,3,2,6,27,3,0,2015,reg
Hector Jimenez,Columbus Crew SC,M,23,12,1112,0,4,3,0,0,0,1,3,12,7,3,0,2015,reg
Michael Stephens,Chicago Fire FC,M,20,16,1314,0,4,4,1,0,0,3,1,8,5,2,0,2015,reg
Angelino,New York City FC,D,14,10,992,0,4,8,2,0,0,3,1,10,15,0,0,2015,reg
Sheanon Williams,Houston Dynamo,D-M,31,27,2428,0,4,9,2,0,0,4,0,22,23,5,0,2015,reg
Brek Shea,,D,19,17,1466,0,4,16,1,0,0,2,2,31,18,7,1,2015,reg
Carlos Rivas,Orlando City SC,F,27,13,1372,0,4,63,16,0,0,1,3,32,32,6,0,2015,reg
Matt Besler,Sporting Kansas City,D,32,32,2830,0,3,0,0,0,0,1,2,28,13,5,1,2015,reg
Corey Ashe,Houston Dynamo,M,9,8,665,0,3,2,1,0,0,3,0,2,10,0,0,2015,reg
Wil Trapp,,M,19,17,1532,0,3,8,1,0,0,2,1,16,13,0,0,2015,reg
Davy Arnaud,DC United ,M,23,21,1915,0,3,12,2,0,0,3,0,37,48,8,0,2015,reg
Andy Rose,Vancouver Whitecaps,M,25,17,1612,0,3,17,7,0,0,2,1,14,13,4,0,2015,reg
Alexander Lopez,Houston Dynamo,M,16,12,947,0,3,18,3,0,0,1,2,10,7,1,0,2015,reg
Calum Mallace,Montreal Impact,M,26,21,1808,0,3,19,4,0,0,2,1,22,11,3,0,2015,reg
Ashtone Morgan,Real Salt Lake,D,19,17,1554,0,2,1,0,0,0,0,2,13,17,2,0,2015,reg
Tyson Wahl,Columbus Crew SC,D,18,14,1413,0,2,2,1,0,0,1,1,9,10,1,0,2015,reg
Mike Magee,Chicago Fire FC,M,12,3,360,0,2,3,0,0,0,0,2,6,7,0,0,2015,reg
Soni Mustivar,Sporting Kansas City ,M,25,20,1838,0,2,3,1,0,0,2,0,31,23,5,0,2015,reg
Harrison Afful,Columbus Crew SC,D,9,9,760,0,2,3,1,0,0,0,2,9,11,0,0,2015,reg
Erik Friberg,FC Dallas,M,13,11,949,0,2,3,1,0,0,1,1,21,10,3,0,2015,reg
Moises Hernandez,FC Dallas,D,14,11,968,0,2,3,2,0,0,2,0,16,6,2,0,2015,reg
London Woodberry,New England Revolution ,D,18,18,1498,0,2,3,1,0,0,2,0,32,9,6,0,2015,reg
RJ Allen,New York City FC,D,14,13,1054,0,2,4,1,0,0,1,1,19,10,5,1,2015,reg
Nigel Reo-Coker,Montreal Impact,M,28,20,1873,0,2,4,3,0,0,2,0,39,15,5,0,2015,reg
Marvell Wynne,San Jose Earthquakes ,D,33,32,2762,0,2,5,1,0,0,0,2,22,17,1,0,2015,reg
Tony Beltran,Real Salt Lake,D,31,31,2774,0,2,6,4,0,0,1,1,32,24,7,0,2015,reg
Daigo Kobayashi,New England Revolution ,M,21,11,1123,0,2,7,1,0,0,2,0,10,14,0,0,2015,reg
Chris Korb,DC United ,D,18,17,1445,0,2,8,1,0,0,2,0,13,7,1,0,2015,reg
Sean St. Ledger,Colorado Rapids,D,27,26,2261,0,2,8,2,0,0,2,0,31,37,1,0,2015,reg
Rafael Ramos,Orlando City SC,D,25,24,1998,0,2,8,3,0,0,2,0,20,12,5,2,2015,reg
Chance Myers,Sporting Kansas City ,D,13,10,840,0,2,9,2,0,0,2,0,15,5,2,0,2015,reg
Servando Carrasco,Sporting Kansas City ,M,21,16,1408,0,2,10,1,0,0,1,1,20,2,3,0,2015,reg
David Horst,Houston Dynamo,D,32,28,2603,0,2,13,2,0,0,0,2,36,30,3,0,2015,reg
Charles Eloundou,Colorado Rapids,F,11,3,341,0,2,15,2,0,0,2,0,2,3,0,0,2015,reg
Sal Zizzo,New York Red Bulls,D,22,10,1032,0,2,16,3,0,0,0,2,9,6,1,0,2015,reg
Luis Solignac,Colorado Rapids,F,15,14,1232,0,2,26,10,0,0,2,0,22,22,0,0,2015,reg
Marius Obekop,New York Red Bulls,M,1,0,4,0,1,0,0,0,0,0,1,0,0,0,0,2015,reg
Patrick Doody,Chicago Fire FC,D,7,6,558,0,1,0,0,0,0,1,0,2,6,1,0,2015,reg
Bright Dike,Toronto FC,F,2,0,20,0,1,0,0,0,0,0,1,0,0,0,0,2015,reg
David Mateos,Orlando City SC,D,6,6,540,0,1,1,1,0,0,1,0,4,5,0,0,2015,reg
Darrius Barnes,New England Revolution ,D,5,4,391,0,1,1,0,0,0,1,0,2,1,0,0,2015,reg
Kevan George,Columbus Crew SC,M,6,2,278,0,1,1,0,0,0,1,0,7,6,3,0,2015,reg
Raymon Gaddis,Philadelphia Union,D,28,27,2399,0,1,2,0,0,0,0,1,15,22,3,0,2015,reg
Nick Hagglund,FC Cincinnati,D,12,8,787,0,1,2,1,0,0,0,1,9,5,4,0,2015,reg
Rasheed Olabiyi,Houston Dynamo,M,7,4,283,0,1,2,0,0,0,1,0,10,1,0,0,2015,reg
Daniel Lovitz,Nashville SC,D,11,3,350,0,1,2,1,0,0,0,1,2,6,0,0,2015,reg
Michael Harrington,Colorado Rapids,D,14,14,1260,0,1,2,1,0,0,0,1,10,7,2,0,2015,reg
Roman Torres,,D,4,4,314,0,1,2,2,0,0,1,0,4,4,0,0,2015,reg
Jermaine Taylor,Houston Dynamo,D,16,16,1427,0,1,3,0,0,0,1,0,18,8,3,1,2015,reg
Andoni Iraola,New York City FC,D,9,8,759,0,1,3,0,0,0,1,0,8,7,2,0,2015,reg
Michael Parkhurst,Columbus Crew SC,D,33,33,2895,0,1,3,0,0,0,1,0,15,15,2,1,2015,reg
Zach Loyd,FC Dallas,D,28,28,2396,0,1,3,1,0,0,1,0,30,28,2,1,2015,reg
Chad Barson,Columbus Crew SC,D,10,4,456,0,1,3,3,0,0,1,0,8,1,2,0,2015,reg
Amobi Okugo,Sporting Kansas City ,D-M,18,10,920,0,1,4,1,0,0,0,1,11,6,6,0,2015,reg
Kofi Sarkodie,Houston Dynamo,D,16,15,1304,0,1,4,1,0,0,1,0,21,10,4,1,2015,reg
A.J. DeLaGarza,,D,24,22,1963,0,1,4,0,0,0,1,0,11,11,4,0,2015,reg
Facundo Coria,DC United ,M,7,1,131,0,1,4,2,0,0,0,1,4,7,1,0,2015,reg
Emanuel Pogatetz,Columbus Crew SC,D,19,16,1476,0,1,4,1,0,0,1,0,12,16,3,0,2015,reg
Patrice Bernier,Montreal Impact,M,20,6,673,0,1,5,0,0,0,1,0,16,5,2,1,2015,reg
Ishmael Yartey,Portland Timbers,M,5,3,227,0,1,5,2,0,0,0,1,6,0,0,0,2015,reg
Connor Lade,New York Red Bulls,D,18,16,1433,0,1,5,1,0,0,1,0,20,15,6,0,2015,reg
Amadou Dia,Sporting Kansas City,D,22,13,1317,0,1,5,3,0,0,1,0,26,16,2,0,2015,reg
Saad Abdul-Salaam,FC Cincinnati,D,22,10,1074,0,1,5,3,0,0,0,1,13,16,1,0,2015,reg
Erick Torres,Houston Dynamo,F,11,3,339,0,1,6,1,0,0,1,0,6,11,1,0,2015,reg
Sean Davis,New York Red Bulls,M,14,4,431,0,1,6,1,0,0,1,0,9,12,0,0,2015,reg
Russell Teibert,Vancouver Whitecaps,M,23,15,1346,0,1,6,1,0,0,0,1,28,4,3,0,2015,reg
Michael Farfan,DC United ,M,17,7,660,0,1,6,1,0,0,0,1,19,10,1,0,2015,reg
Shaun Francis,San Jose Earthquakes ,D,23,18,1654,0,1,7,3,0,0,0,1,32,6,3,0,2015,reg
Jordan Harvey,LAFC,D,26,25,2250,0,1,7,3,0,0,1,0,18,18,4,1,2015,reg
Lovel Palmer,Chicago Fire FC,D,22,20,1797,0,1,7,0,0,0,1,0,19,11,2,0,2015,reg
Connor Hallisey,Sporting Kansas City ,F,13,6,516,0,1,8,3,0,0,1,0,3,1,0,0,2015,reg
Matt Watson,Chicago Fire FC,M,13,8,674,0,1,9,2,0,0,1,0,12,6,1,1,2015,reg
George Fochive,Portland Timbers,M,11,8,684,0,1,9,1,0,0,1,0,22,14,2,0,2015,reg
Jordan Stewart,San Jose Earthquakes ,D-M,14,13,1130,0,1,9,0,0,0,1,0,23,16,3,0,2015,reg
Víctor Bernárdez,San Jose Earthquakes ,D,29,29,2508,0,1,11,0,0,0,1,0,36,16,6,1,2015,reg
Jeb Brovsky,New York City FC,D,15,12,1132,0,1,11,1,0,0,0,1,14,7,2,0,2015,reg
Liam Ridgewell,Portland Timbers,D,32,32,2868,0,1,12,2,0,0,1,0,19,25,6,1,2015,reg
Cristian Roldan,FC Dallas,M,22,11,1114,0,1,12,4,0,0,0,1,13,14,1,0,2015,reg
Mohammed Saeid,Columbus Crew SC,M,25,18,1590,0,1,13,0,0,0,1,0,26,20,5,1,2015,reg
Kevin Molino,Minnesota United FC,M,7,7,605,0,1,14,4,0,0,0,1,4,22,3,0,2015,reg
Lewis Neal,Orlando City SC,M,21,18,1509,0,1,15,4,0,0,1,0,7,11,0,0,2015,reg
Alvas Powell,,D,31,31,2726,0,1,18,4,0,0,1,0,30,40,7,0,2015,reg
Eric Gehrig,Chicago Fire FC,D,25,25,2214,0,1,19,5,0,0,0,1,22,14,5,0,2015,reg
Jack McBean,LA Galaxy,F,0,0,0,0,0,0,0,0,0,0,0,0,0,0,0,2015,reg
Danny Mwanga,Orlando City SC,F,4,1,110,0,0,0,0,0,0,0,0,2,1,0,0,2015,reg
Chris Schuler,Real Salt Lake,D,5,5,450,0,0,0,0,0,0,0,0,6,4,1,0,2015,reg
Leandro Barrera,San Jose Earthquakes ,M,6,1,139,0,0,0,0,0,0,0,0,3,2,0,0,2015,reg
Ben Zemanski,Portland Timbers,M,0,0,0,0,0,0,0,0,0,0,0,0,0,0,0,2015,reg
Steven Lenhart,San Jose Earthquakes ,F,0,0,0,0,0,0,0,0,0,0,0,0,0,0,0,2015,reg
Adrian Lopez,Montreal Impact,D,0,0,0,0,0,0,0,0,0,0,0,0,0,0,0,2015,reg
Danny Cruz,Philadelphia Union,M-F,0,0,0,0,0,0,0,0,0,0,0,0,0,0,0,2015,reg
Brandon Barklage,San Jose Earthquakes ,D,0,0,0,0,0,0,0,0,0,0,0,0,0,0,0,2015,reg
Victor Perez,Chicago Fire FC,M,1,0,2,0,0,0,0,0,0,0,0,1,0,0,0,2015,reg
Jeremy Hall,New England Revolution ,D-M,12,11,998,0,0,0,0,0,0,0,0,15,10,2,0,2015,reg
Mike Fucito,San Jose Earthquakes ,F,2,0,7,0,0,0,0,0,0,0,0,0,0,0,0,2015,reg
Steven Caldwell,Toronto FC,D,2,2,135,0,0,0,0,0,0,0,0,1,1,0,0,2015,reg
Peguy Luyindula,New York Red Bulls,F,0,0,0,0,0,0,0,0,0,0,0,0,0,0,0,2015,reg
Eddie Johnson,DC United ,F,0,0,0,0,0,0,0,0,0,0,0,0,0,0,0,2015,reg
Todd Dunivant,LA Galaxy,D,3,1,68,0,0,0,0,0,0,0,0,2,0,0,0,2015,reg
Stephen Keel,FC Dallas,D,0,0,0,0,0,0,0,0,0,0,0,0,0,0,0,2015,reg
Andre Lewis,Vancouver Whitecaps,M,0,0,0,0,0,0,0,0,0,0,0,0,0,0,0,2015,reg
Michael Bustamante,New York Red Bulls,M,0,0,0,0,0,0,0,0,0,0,0,0,0,0,0,2015,reg
Leo Fernandes,Philadelphia Union,M,0,0,0,0,0,0,0,0,0,0,0,0,0,0,0,2015,reg
Michael Seaton,DC United ,F,0,0,0,0,0,0,0,0,0,0,0,0,0,0,0,2015,reg
Andres Correa,FC Dallas,D,0,0,0,0,0,0,0,0,0,0,0,0,0,0,0,2015,reg
Deshorn Brown,Colorado Rapids,F,1,0,2,0,0,0,0,0,0,0,0,0,0,0,0,2015,reg
Greg Cochrane,Chicago Fire FC,D,4,4,334,0,0,0,0,0,0,0,0,2,1,0,0,2015,reg
Blake Smith,Montreal Impact,D,0,0,0,0,0,0,0,0,0,0,0,0,0,0,0,2015,reg
Charlie Rugg,LA Galaxy,F,0,0,0,0,0,0,0,0,0,0,0,0,0,0,0,2015,reg
Donnie Smith,New England Revolution ,M,0,0,0,0,0,0,0,0,0,0,0,0,0,0,0,2015,reg
Collin Martin,DC United ,M,0,0,0,0,0,0,0,0,0,0,0,0,0,0,0,2015,reg
Leo Stolz,New York Red Bulls,M,0,0,0,0,0,0,0,0,0,0,0,0,0,0,0,2015,reg
Jalen Robinson,DC United ,D,0,0,0,0,0,0,0,0,0,0,0,0,0,0,0,2015,reg
Schillo Tshuma,Portland Timbers,F,0,0,0,0,0,0,0,0,0,0,0,0,0,0,0,2015,reg
Boyd Okwuonu,Real Salt Lake,D,3,1,118,0,0,0,0,0,0,0,0,0,0,0,0,2015,reg
Danny Garcia,FC Dallas,M-F,0,0,0,0,0,0,0,0,0,0,0,0,0,0,0,2015,reg
Jordan Hamilton,Columbus Crew SC,F,2,0,13,0,0,0,0,0,0,0,0,0,0,0,0,2015,reg
Eric Bird,Philadelphia Union,M,0,0,0,0,0,0,0,0,0,0,0,0,0,0,0,2015,reg
Tyler Rudy,New England Revolution ,M,0,0,0,0,0,0,0,0,0,0,0,0,0,0,0,2015,reg
Shane O'Neill,FC Dallas,D,4,3,286,0,0,0,0,0,0,0,0,5,0,0,0,2015,reg
Mark Bloom,Toronto FC,D,0,0,0,0,0,0,0,0,0,0,0,0,0,0,0,2015,reg
Andrew Jean-Baptiste,New York Red Bulls,D,0,0,0,0,0,0,0,0,0,0,0,0,0,0,0,2015,reg
Caleb Clarke,Vancouver Whitecaps,F,0,0,0,0,0,0,0,0,0,0,0,0,0,0,0,2015,reg
Matt Dunn,New York City FC,M,1,0,52,0,0,0,0,0,0,0,0,0,2,0,0,2015,reg
Tony Cascio,Orlando City SC,M,0,0,0,0,0,0,0,0,0,0,0,0,0,0,0,2015,reg
Chandler Hoffman,Houston Dynamo,F,5,0,30,0,0,0,0,0,0,0,0,0,0,0,0,2015,reg
Antoine Hoppenot,Philadelphia Union,F,1,0,4,0,0,0,0,0,0,0,0,0,0,0,0,2015,reg
Tommy Meyer,LA Galaxy,D,6,4,371,0,0,0,0,0,0,0,0,3,1,0,0,2015,reg
Jimmy McLaughlin,FC Cincinnati,M,1,0,1,0,0,0,0,0,0,0,0,0,0,0,0,2015,reg
Ruben Bover,New York Red Bulls,M,0,0,0,0,0,0,0,0,0,0,0,0,0,0,0,2015,reg
Shay Facey,New York City FC,D,23,20,1818,0,0,0,0,0,0,0,0,28,9,6,1,2015,reg
Andy Thoma,Portland Timbers,D,0,0,0,0,0,0,0,0,0,0,0,0,0,0,0,2015,reg
Andrés Mendoza,New York City FC,D,0,0,0,0,0,0,0,0,0,0,0,0,0,0,0,2015,reg
Alex Zendejas,FC Dallas,M,8,2,187,0,0,0,0,0,0,0,0,1,6,0,0,2015,reg
Manny Aparicio,Toronto FC,M,0,0,0,0,0,0,0,0,0,0,0,0,0,0,0,2015,reg
Santiago Gonzalez,Montreal Impact,F,0,0,0,0,0,0,0,0,0,0,0,0,0,0,0,2015,reg
Jeremy Gagnon-Lapare,Montreal Impact,M,2,0,18,0,0,0,0,0,0,0,0,0,0,0,0,2015,reg
Timi Mulgrew,New England Revolution ,F,0,0,0,0,0,0,0,0,0,0,0,0,0,0,0,2015,reg
Shawn McLaws,New York Red Bulls,M,0,0,0,0,0,0,0,0,0,0,0,0,0,0,0,2015,reg
Pecka,Real Salt Lake,M,4,1,111,0,0,0,0,0,0,0,0,2,3,0,0,2015,reg
Ben Newnam,Colorado Rapids,D,1,1,90,0,0,0,0,0,0,0,0,2,0,0,0,2015,reg
Caleb Calvert,Colorado Rapids,F,0,0,0,0,0,0,0,0,0,0,0,0,0,0,0,2015,reg
Jimmy Ockford,FC Dallas,D,1,1,90,0,0,0,0,0,0,0,0,0,0,0,0,2015,reg
Connor Brandt,New York City FC,M-D,1,0,9,0,0,0,0,0,0,0,0,0,0,0,0,2015,reg
Raul Mendiola,LA Galaxy,M,0,0,0,0,0,0,0,0,0,0,0,0,0,0,0,2015,reg
Ethen Sampson,Vancouver Whitecaps,D,1,1,88,0,0,0,0,0,0,0,0,1,0,1,0,2015,reg
Tommy Redding,Orlando City SC,D,2,1,87,0,0,0,0,0,0,0,0,0,0,0,0,2015,reg
Victor Cabrera,Houston Dynamo,D,21,20,1730,0,0,0,0,0,0,0,0,24,13,4,0,2015,reg
Oumar Ballo,Houston Dynamo,D,0,0,0,0,0,0,0,0,0,0,0,0,0,0,0,2015,reg
Tyler Turner,Orlando City SC,D,7,5,477,0,0,0,0,0,0,0,0,13,7,2,1,2015,reg
Adam Bedell,Columbus Crew SC,F,0,0,0,0,0,0,0,0,0,0,0,0,0,0,0,2015,reg
Marlon Hairston,Minnesota United FC,M,3,3,270,0,0,0,0,0,0,0,0,2,3,0,0,2015,reg
Chris Ritter,Chicago Fire FC,M,7,5,408,0,0,0,0,0,0,0,0,14,4,3,0,2015,reg
Estrela,Orlando City SC,M,0,0,0,0,0,0,0,0,0,0,0,0,0,0,0,2015,reg
Jeanderson,Portland Timbers,D,3,1,92,0,0,0,0,0,0,0,0,2,0,0,0,2015,reg
Collin Fernandez,Chicago Fire FC,M,1,0,6,0,0,0,0,0,0,0,0,0,0,0,0,2015,reg
Louis Beland-Goyette,Montreal Impact,M,0,0,0,0,0,0,0,0,0,0,0,0,0,0,0,2015,reg
Chris Mannella,Toronto FC,M,0,0,0,0,0,0,0,0,0,0,0,0,0,0,0,2015,reg
Romain Gall,Columbus Crew SC,M,0,0,0,0,0,0,0,0,0,0,0,0,0,0,0,2015,reg
Romario Williams,Montreal Impact,F,2,0,7,0,0,0,0,0,0,0,0,2,0,0,0,2015,reg
Joseph Greenspan,Colorado Rapids,D,3,2,185,0,0,0,0,0,0,0,0,2,2,1,0,2015,reg
Taylor Hunter,Houston Dynamo,M,1,1,90,0,0,0,0,0,0,0,0,0,1,0,0,2015,reg
Ben McKendry,Vancouver Whitecaps,M,0,0,0,0,0,0,0,0,0,0,0,0,0,0,0,2015,reg
Kalen Ryden,Columbus Crew SC,D,0,0,0,0,0,0,0,0,0,0,0,0,0,0,0,2015,reg
Raymond Lee,Philadelphia Union,D,1,0,12,0,0,0,0,0,0,0,0,1,0,0,0,2015,reg
Zachary Herivaux,New England Revolution ,M,0,0,0,0,0,0,0,0,0,0,0,0,0,0,0,2015,reg
Conor Donovan,Orlando City SC,D,1,1,14,0,0,0,0,0,0,0,0,2,0,0,0,2015,reg
Otis Earle,FC Dallas,D,0,0,0,0,0,0,0,0,0,0,0,0,0,0,0,2015,reg
Nick Besler,Real Salt Lake,M,0,0,0,0,0,0,0,0,0,0,0,0,0,0,0,2015,reg
Victor Mansaray,FC Dallas,F,3,0,28,0,0,0,0,0,0,0,0,1,0,0,0,2015,reg
Ben Swanson,Columbus Crew SC,M,0,0,0,0,0,0,0,0,0,0,0,0,0,0,0,2015,reg
Memo Rodriguez,Houston Dynamo,M,0,0,0,0,0,0,0,0,0,0,0,0,0,0,0,2015,reg
James Ansu Rogers,Sporting Kansas City ,F,0,0,0,0,0,0,0,0,0,0,0,0,0,0,0,2015,reg
Sidney Rivera,Orlando City SC,F,0,0,0,0,0,0,0,0,0,0,0,0,0,0,0,2015,reg
Sagi Lev-Ari,Columbus Crew SC,F,0,0,0,0,0,0,0,0,0,0,0,0,0,0,0,2015,reg
Anthony Manning,Portland Timbers,D,0,0,0,0,0,0,0,0,0,0,0,0,0,0,0,2015,reg
Dzenan Catic,Philadelphia Union,F,0,0,0,0,0,0,0,0,0,0,0,0,0,0,0,2015,reg
Kingsley Bryce,Chicago Fire FC,F,0,0,0,0,0,0,0,0,0,0,0,0,0,0,0,2015,reg
Matheus Silva,San Jose Earthquakes ,D,0,0,0,0,0,0,0,0,0,0,0,0,0,0,0,2015,reg
Zach Steinberger,Houston Dynamo,M,3,0,29,0,0,1,0,0,0,0,0,1,0,0,0,2015,reg
Luke Mishu,DC United ,D,2,2,162,0,0,1,0,0,0,0,0,1,1,0,0,2015,reg
Ariel Lassiter,LA Galaxy,F,1,0,19,0,0,1,1,0,0,0,0,0,0,0,0,2015,reg
Dave Romney,Nashville SC,D,5,2,259,0,0,1,1,0,0,0,0,2,0,0,0,2015,reg
Clément Simonin,Toronto FC,D,2,2,171,0,0,1,0,0,0,0,0,4,0,1,0,2015,reg
Cameron Porter,Montreal Impact,F,2,1,39,0,0,1,0,0,0,0,0,0,2,0,0,2015,reg
Harrison Heath,Orlando City SC,M,3,2,136,0,0,1,0,0,0,0,0,1,2,0,0,2015,reg
Aaron Kovar,FC Dallas,M,6,2,201,0,0,1,1,0,0,0,0,1,3,0,0,2015,reg
Marco Bustos,Vancouver Whitecaps,M,1,0,29,0,0,1,0,0,0,0,0,0,0,0,0,2015,reg
Jordan Smith,Vancouver Whitecaps,D,7,4,376,0,0,1,1,0,0,0,0,8,0,1,0,2015,reg
Rafael Garcia ,LA Galaxy,D,10,4,338,0,0,1,1,0,0,0,0,4,6,1,0,2015,reg
Jay Chapman,,M,10,1,202,0,0,1,0,0,0,0,0,5,2,0,0,2015,reg
Kenney Walker,LA Galaxy,M,8,3,285,0,0,1,1,0,0,0,0,6,3,1,0,2015,reg
Karl Ouimette,New York Red Bulls,D,11,7,711,0,0,1,0,0,0,0,0,7,5,2,0,2015,reg
Diego Rodriguez,Vancouver Whitecaps,D,4,3,257,0,0,1,0,0,0,0,0,3,1,2,0,2015,reg
Oscar Sorto,LA Galaxy,D,3,3,269,0,0,1,0,0,0,0,0,6,3,0,1,2015,reg
Phanuel Kavita,Real Salt Lake,D,2,2,180,0,0,1,0,0,0,0,0,2,1,1,0,2015,reg
Sean Okoli,New England Revolution ,F,5,0,46,0,0,1,0,0,0,0,0,2,2,0,0,2015,reg
Chris Klute,Columbus Crew SC,D,14,8,832,0,0,1,1,0,0,0,0,10,7,3,0,2015,reg
Christian Dean,Vancouver Whitecaps,D,5,3,291,0,0,1,0,0,0,0,0,5,2,1,0,2015,reg
Paulo Renato,San Jose Earthquakes ,D,5,3,366,0,0,1,0,0,0,0,0,4,4,0,0,2015,reg
Jean-Baptiste Pierazzi,San Jose Earthquakes ,M,3,3,270,0,0,1,0,0,0,0,0,2,5,0,0,2015,reg
Kenny Cooper,Montreal Impact,F,1,0,4,0,0,1,1,0,0,0,0,0,0,0,0,2015,reg
Martin Paterson,Orlando City SC,F,4,0,53,0,0,1,0,0,0,0,0,4,3,1,0,2015,reg
Gaston Sauro,Columbus Crew SC,D,4,4,273,0,0,1,0,0,0,0,0,6,2,2,0,2015,reg
Kevin Alston,New England Revolution ,D,16,9,933,0,0,1,0,0,0,0,0,8,15,2,0,2015,reg
Ezequiel Cirigliano,FC Dallas,M,7,5,431,0,0,1,0,0,0,0,0,6,0,0,0,2015,reg
Daneil Cyrus,Chicago Fire FC,D,6,5,519,0,0,1,0,0,0,0,0,5,3,1,0,2015,reg
Tony Taylor,New York City FC,F-M,2,1,66,0,0,1,0,0,0,0,0,2,0,0,0,2015,reg
Michael Nanchoff,Portland Timbers,M,4,0,27,0,0,1,1,0,0,0,0,1,1,0,0,2015,reg
Jared Jeffrey,DC United ,M,2,1,61,0,0,2,0,0,0,0,0,2,1,1,0,2015,reg
Roy Miller,New York Red Bulls,D,6,5,444,0,0,2,0,0,0,0,0,7,1,0,0,2015,reg
Bakary Soumare,FC Dallas,D,10,9,835,0,0,2,0,0,0,0,0,10,2,3,0,2015,reg
Ahmed Kantari,Toronto FC,D,12,10,951,0,0,2,1,0,0,0,0,17,6,3,0,2015,reg
Jefferson Mena,New York City FC,D,7,6,596,0,0,2,0,0,0,0,0,11,3,2,0,2015,reg
Andy Craven,FC Dallas,F,3,0,67,0,0,2,1,0,0,0,0,2,1,1,0,2015,reg
Dylan Remick,FC Dallas,D,19,18,1607,0,0,2,0,0,0,0,0,15,9,1,0,2015,reg
Andrew Farrell,New England Revolution,D,32,32,2819,0,0,2,0,0,0,0,0,13,16,3,1,2015,reg
Carlos Alvarez,Colorado Rapids,M,1,0,31,0,0,2,0,0,0,0,0,0,1,0,0,2015,reg
Sam Adekugbe,Vancouver Whitecaps,D,9,7,647,0,0,2,1,0,0,0,0,12,6,4,0,2015,reg
Erik Palmer-Brown,Sporting Kansas City ,D,7,4,376,0,0,2,0,0,0,0,0,3,2,2,0,2015,reg
Coy Craft,FC Dallas,F-M,2,1,67,0,0,2,0,0,0,0,0,1,0,0,0,2015,reg
Taylor Peay,Portland Timbers,D,5,3,319,0,0,2,1,0,0,0,0,2,0,0,0,2015,reg
AJ Cochran,Houston Dynamo,D,7,5,512,0,0,3,1,0,0,0,0,8,4,0,0,2015,reg
Anthony Jackson-Hamel,Montreal Impact,F,8,0,156,0,0,3,0,0,0,0,0,2,2,0,0,2015,reg
Steve Neumann,New England Revolution ,M-F,9,1,144,0,0,3,1,0,0,0,0,3,1,1,0,2015,reg
Mauro Manotas,Houston Dynamo,F,9,0,102,0,0,3,1,0,0,0,0,1,0,0,0,2015,reg
Mikey Lopez,Sporting Kansas City ,M,6,5,482,0,0,3,1,0,0,0,0,14,4,1,0,2015,reg
Ben Speas,Columbus Crew SC,M-F,8,2,215,0,0,3,0,0,0,0,0,1,2,0,0,2015,reg
Elias Vasquez,Real Salt Lake,D,15,14,1264,0,0,3,1,0,0,0,0,27,4,3,0,2015,reg
Fred,Philadelphia Union,M,6,0,83,0,0,3,1,0,0,0,0,4,2,1,1,2015,reg
Jason Hernandez,New York City FC,D,26,26,2294,0,0,3,0,0,0,0,0,38,10,8,0,2015,reg
Hernan Grana,Columbus Crew SC,D,7,7,598,0,0,3,1,0,0,0,0,7,8,1,0,2015,reg
Ethan White,Philadelphia Union,D,16,13,1224,0,0,3,0,0,0,0,0,6,7,2,0,2015,reg
Josh Williams,Columbus Crew SC,D,17,17,1510,0,0,4,0,0,0,0,0,10,9,1,0,2015,reg
Eric Alexander,Montreal Impact,M,20,10,878,0,0,4,2,0,0,0,0,12,12,2,0,2015,reg
Dan Gargan,LA Galaxy,D,25,20,1784,0,0,4,1,0,0,0,0,29,14,6,0,2015,reg
Eric Miller,Nashville SC,D,9,6,517,0,0,4,0,0,0,0,0,3,1,1,0,2015,reg
Justen Glad,Real Salt Lake,D,7,6,551,0,0,4,1,0,0,0,0,6,7,3,0,2015,reg
Mark Sherrod,San Jose Earthquakes ,F,6,2,232,0,0,4,0,0,0,0,0,11,2,1,1,2015,reg
Tim Parker,New York Red Bulls,D,15,14,1262,0,0,4,2,0,0,0,0,9,7,2,0,2015,reg
Miguel Aguilar,DC United ,M,17,4,528,0,0,4,0,0,0,0,0,9,13,1,0,2015,reg
Richie Marquez,Philadelphia Union,D,21,20,1854,0,0,5,2,0,0,0,0,17,9,1,1,2015,reg
Jimmy Medranda ,Nashville SC,D,7,7,426,0,0,5,0,0,0,0,0,10,4,1,0,2015,reg
Marc Burch,Colorado Rapids,D,8,8,720,0,0,5,1,0,0,0,0,15,5,3,0,2015,reg
Khari Stephenson,San Jose Earthquakes ,M,4,2,211,0,0,5,0,0,0,0,0,5,0,0,0,2015,reg
Pablo Alvarez,New York City FC,M,8,3,244,0,0,5,1,0,0,0,0,3,9,0,0,2015,reg
Hassoun Camara,Montreal Impact,D,9,5,478,0,0,5,1,0,0,0,0,5,3,1,1,2015,reg
Norberto Paparatto,Portland Timbers,D,6,5,451,0,0,5,1,0,0,0,0,7,7,1,0,2015,reg
Markus Halsti,DC United ,M-D,14,12,949,0,0,6,1,0,0,0,0,13,7,1,0,2015,reg
Michael Lahoud,Philadelphia Union,M,19,14,1233,0,0,6,0,0,0,0,0,19,11,2,0,2015,reg
Seth Sinovic,New England Revolution,D,11,10,902,0,0,6,2,0,0,0,0,21,4,3,0,2015,reg
Edson Buddle,LA Galaxy,F,12,1,252,0,0,6,1,0,0,0,0,10,4,1,0,2015,reg
Darwin Jones,FC Dallas,F,9,0,107,0,0,6,2,0,0,0,0,1,0,0,0,2015,reg
Micheal Azira,Chicago Fire FC,M,11,8,727,0,0,6,0,0,0,0,0,15,4,2,0,2015,reg
Oniel Fisher,DC United,D,12,9,864,0,0,6,1,0,0,0,0,16,11,4,0,2015,reg
Manolo Sanchez,New York Red Bulls,M,3,0,22,0,0,6,2,0,0,0,0,0,0,0,0,2015,reg
Erik Hurtado,Sporting Kansas City,F,9,1,182,0,0,6,2,0,0,0,0,3,4,0,0,2015,reg
Jordi Quintilla,Sporting Kansas City ,M,8,3,274,0,0,7,3,0,0,0,0,11,7,0,0,2015,reg
Deybi Flores,Vancouver Whitecaps,M,9,5,446,0,0,7,1,0,0,0,0,7,6,1,0,2015,reg
Dane Richards,New York Red Bulls,M,12,1,259,0,0,7,1,0,0,0,0,7,2,1,0,2015,reg
Chris Wingert,New York City FC,D,27,26,2169,0,0,7,4,0,0,0,0,40,17,7,0,2015,reg
Kristinn Steindorsson,Columbus Crew SC,M,21,4,621,0,0,7,2,0,0,0,0,7,7,1,0,2015,reg
Rolando Escobar,FC Dallas,M,14,2,398,0,0,7,3,0,0,0,0,4,11,0,0,2015,reg
Osvaldo Alonso,Minnesota United FC,M,22,21,1857,0,0,8,1,0,0,0,0,45,44,7,0,2015,reg
Leonardo,LA Galaxy,D,26,26,2264,0,0,8,1,0,0,0,0,40,17,2,1,2015,reg
Zach Scott,FC Dallas,D,20,15,1481,0,0,9,4,0,0,0,0,14,7,4,0,2015,reg
Brian Carroll,Philadelphia Union,M,22,21,1820,0,0,9,2,0,0,0,0,17,13,2,0,2015,reg
Sebastian Saucedo,Real Salt Lake,F,9,1,168,0,0,9,2,0,0,0,0,5,5,0,1,2015,reg
Marc Pelosi,San Jose Earthquakes ,M,12,7,653,0,0,9,1,0,0,0,0,28,9,6,0,2015,reg
Sebastian Velasquez,New York City FC,M,12,5,446,0,0,9,2,0,0,0,0,8,7,0,0,2015,reg
Walker Zimmerman,Nashville SC,D,20,10,1084,0,0,10,2,0,0,0,0,10,10,1,0,2015,reg
Chad Marshall,FC Dallas,D,29,28,2529,0,0,10,3,0,0,0,0,29,28,2,0,2015,reg
Demar Phillips,Real Salt Lake,D,18,16,1376,0,0,11,1,0,0,0,0,17,14,5,1,2015,reg
Bernardo Añor,Sporting Kansas City ,M,13,4,483,0,0,11,3,0,0,0,0,11,11,2,0,2015,reg
Je-Vaughn Watson,FC Dallas,D,23,22,1986,0,0,11,4,0,0,0,0,17,5,4,1,2015,reg
JJ Koval,San Jose Earthquakes ,M,17,7,738,0,0,11,3,0,0,0,0,15,9,0,1,2015,reg
Matt Polster,New England Revolution,D,30,27,2422,0,0,12,4,0,0,0,0,57,30,10,0,2015,reg
Axel Sjöberg,Columbus Crew SC,D,14,14,1259,0,0,12,4,0,0,0,0,24,8,5,1,2015,reg
Jermaine Jones,New England Revolution ,M,18,17,1312,0,0,12,4,0,0,0,0,31,33,6,0,2015,reg
Justin Mapp,Montreal Impact,M,5,3,264,0,0,12,5,0,0,0,0,0,1,0,0,2015,reg
Adam Nemec,New York City FC,F,9,8,594,0,0,13,3,0,0,0,0,10,8,0,0,2015,reg
Will Johnson,Portland Timbers,D,12,12,1046,0,0,15,2,0,0,0,0,10,7,1,1,2015,reg
Mika Vayrynen,LA Galaxy,M,19,10,797,0,0,15,2,0,0,0,0,19,7,3,0,2015,reg
Tommy Thompson,San Jose Earthquakes,D,17,4,465,0,0,15,4,0,0,0,0,3,9,1,0,2015,reg
Luis Garrido,Houston Dynamo,M,29,21,1983,0,0,17,2,0,0,0,0,73,21,10,0,2015,reg
Guilherme do Prado,Chicago Fire FC,F,15,6,577,0,0,18,5,0,0,0,0,19,18,4,0,2015,reg
Bradley Wright-Phillips,LAFC,F,34,32,2761,24,5,103,56,14,10,2,3,53,37,3,0,2016,reg
David Villa,New York City FC,F,33,32,2869,23,4,166,68,13,10,4,0,47,72,5,0,2016,reg
Sebastian Giovinco,Toronto FC,F,28,28,2418,17,15,177,59,10,7,7,8,32,69,3,0,2016,reg
Ignacio Piatti,Montreal Impact,M,32,31,2818,17,6,95,42,8,9,5,1,35,65,5,0,2016,reg
Dom Dwyer,Orlando City SC,F,33,31,2823,16,3,119,44,9,7,2,1,66,74,8,0,2016,reg
Ola Kamara,DC United,F,25,20,1859,16,2,80,38,9,7,0,2,24,35,0,0,2016,reg
Fanendo Adi,Columbus Crew SC,F,33,30,2649,16,2,88,37,13,3,0,2,70,63,7,0,2016,reg
Giovani dos Santos,LA Galaxy,M,28,27,2350,14,12,63,31,6,8,6,6,17,24,3,0,2016,reg
Diego Valeri,Portland Timbers,M,30,30,2634,14,7,112,38,9,5,5,2,22,51,2,1,2016,reg
Cyle Larin,Orlando City SC,F,32,29,2455,14,3,73,33,9,5,2,1,24,60,0,0,2016,reg
Chris Pontius,Philadelphia Union,M,33,32,2571,12,6,66,35,5,7,2,4,18,36,2,0,2016,reg
Jordan Morris,FC Dallas,F,34,32,2856,12,4,71,36,6,6,2,2,29,24,0,0,2016,reg
Frank Lampard,New York City FC,M,19,15,1280,12,3,33,21,6,6,3,0,12,21,3,0,2016,reg
Chris Wondolowski,San Jose Earthquakes,F,30,30,2697,12,3,78,31,5,7,3,0,21,18,0,0,2016,reg
Kei Kamara,Colorado Rapids,F,30,30,2659,12,2,106,37,8,4,1,1,40,45,5,0,2016,reg
Kevin Molino,Minnesota United FC,M,30,26,2316,11,8,59,22,7,4,4,4,38,48,1,0,2016,reg
Didier Drogba,Montreal Impact,F,22,18,1650,10,6,90,35,8,2,3,3,26,39,5,1,2016,reg
Jozy Altidore,Toronto FC,F,23,16,1487,10,5,43,21,5,5,1,4,43,48,4,0,2016,reg
Robbie Keane,LA Galaxy,F,17,16,1426,10,2,40,21,8,2,1,1,7,17,1,0,2016,reg
Joao Plata,Real Salt Lake,F,30,28,2478,9,12,77,33,3,6,8,4,13,29,4,0,2016,reg
Kaká,Orlando City SC,M,24,23,1955,9,10,62,29,6,3,9,1,17,34,2,0,2016,reg
Pedro Morales,Vancouver Whitecaps,M,27,26,2073,9,6,51,25,4,5,4,2,15,29,4,2,2016,reg
Lamar Neagle,DC United,M,31,21,1950,9,6,51,21,3,6,4,2,31,26,2,0,2016,reg
David Accam,Nashville SC,F,24,21,1935,9,5,71,28,6,3,3,2,28,66,4,0,2016,reg
Maximiliano Urruti,Montreal Impact,F,30,29,2482,9,4,91,36,6,3,2,2,42,51,4,0,2016,reg
Shkelzen Gashi,Colorado Rapids,M-F,26,25,2123,9,4,92,40,1,8,1,3,41,21,4,0,2016,reg
Roland Alberg,Philadelphia Union,M,28,13,1153,9,3,47,17,7,2,2,1,28,32,2,1,2016,reg
Yura Movsisyan,Real Salt Lake,F,29,25,2161,9,3,68,28,6,3,2,1,18,38,3,0,2016,reg
Michael Barrios,FC Dallas,M,32,30,2454,9,2,50,26,3,6,2,0,23,25,3,0,2016,reg
Patrick Mullins,Toronto FC,F,21,14,1278,8,3,44,23,8,0,2,1,31,19,3,0,2016,reg
Clint Dempsey,FC Dallas,M-F,17,17,1429,8,2,65,22,5,3,2,0,23,27,1,1,2016,reg
Benny Feilhaber,Sporting Kansas City,M,30,28,2563,7,13,45,13,6,1,7,6,33,56,3,0,2016,reg
Mike Grella,New York Red Bulls,M,32,28,2410,7,6,40,21,7,0,3,3,35,16,7,0,2016,reg
Juan Agudelo,,F,24,14,1349,7,5,52,18,6,1,4,1,31,24,5,0,2016,reg
Michael de Leeuw,Chicago Fire FC,F,18,17,1465,7,3,25,12,5,2,1,2,31,16,2,0,2016,reg
Juan Manuel Martínez,Real Salt Lake,M-F,32,29,2519,7,3,47,17,4,3,2,1,24,80,1,0,2016,reg
CJ Sapong,Chicago Fire FC,F,31,29,2535,7,2,60,22,5,2,1,1,44,71,1,0,2016,reg
Sacha Kljestan,LA Galaxy,M,32,30,2623,6,20,40,19,4,2,12,8,42,38,3,0,2016,reg
Lee Nguyen,,M,33,33,2900,6,10,68,29,5,1,9,1,36,50,2,0,2016,reg
Ethan Finlay,Minnesota United FC,M,34,27,2462,6,9,46,22,4,2,2,7,18,23,2,0,2016,reg
Dominic Oduro,Montreal Impact,M,31,22,2028,6,6,34,17,2,4,1,5,18,43,2,0,2016,reg
Diego Fagundez,New England Revolution,M,34,24,2237,6,6,64,22,4,2,3,3,17,27,4,0,2016,reg
Gyasi Zardes,Columbus Crew SC,F,19,17,1604,6,5,24,15,3,3,3,2,10,32,1,0,2016,reg
Mike Magee,LA Galaxy,M,30,16,1467,6,4,33,18,4,2,4,0,15,21,1,0,2016,reg
Tesho Akindele,Orlando City SC,F-M,31,15,1514,6,4,35,17,3,3,2,2,14,16,2,0,2016,reg
Dominique Badji,Nashville SC,F,27,17,1571,6,4,47,19,2,4,4,0,39,14,5,0,2016,reg
Julio Baptista,Orlando City SC,F,23,5,729,6,3,27,9,2,4,1,2,6,22,1,0,2016,reg
Alvaro Saborio,DC United ,F,19,8,890,6,3,37,12,5,1,3,0,19,10,0,0,2016,reg
Andrew Wenger,Houston Dynamo,D-M,32,24,2062,6,3,44,19,4,2,3,0,27,15,3,0,2016,reg
Giles Barnes,Houston Dynamo,M,24,21,1807,6,3,51,19,6,0,2,1,27,33,1,0,2016,reg
Kevin Doyle,Colorado Rapids,F,26,24,2178,6,2,73,15,4,2,1,1,31,50,5,0,2016,reg
Jacob Peterson,Sporting Kansas City,F,21,18,1500,6,1,37,13,6,0,1,0,8,13,0,0,2016,reg
Mauro Manotas,Houston Dynamo,F,22,10,1054,6,1,41,18,5,1,1,0,11,17,0,0,2016,reg
Adam Jahn,Atlanta United FC,F,22,4,554,6,0,23,8,2,4,0,0,12,5,0,0,2016,reg
Mauro Diaz,FC Dallas,M,27,24,2149,5,13,47,14,4,1,11,2,32,81,3,0,2016,reg
Justin Meram,Real Salt Lake,M,33,31,2605,5,13,76,27,4,1,8,5,21,53,3,0,2016,reg
Arturo Alvarez,Chicago Fire FC,M,30,24,1923,5,9,39,9,3,2,4,5,19,12,2,0,2016,reg
Thomas McNamara,Houston Dynamo,M,30,28,2229,5,9,40,18,2,3,4,5,33,28,5,0,2016,reg
Christian Bolaños,Vancouver Whitecaps,M,27,23,2116,5,8,34,13,2,3,7,1,24,32,2,0,2016,reg
Felipe,DC United,M,33,33,2898,5,7,54,22,4,1,4,3,51,66,6,1,2016,reg
Kelyn Rowe,New England Revolution,M,33,32,2787,5,7,64,25,1,4,3,4,43,52,2,0,2016,reg
Fabian Castillo,FC Dallas,M-F,22,20,1752,5,5,43,20,3,2,3,2,28,7,1,0,2016,reg
Justin Morrow,Toronto FC,D,31,31,2653,5,4,15,7,3,2,1,3,8,16,5,0,2016,reg
Tranquillo Barnetta,Philadelphia Union,M,29,25,2311,5,4,60,28,3,2,3,1,36,62,8,0,2016,reg
Razvan Cocis,Chicago Fire FC,M,30,19,1901,5,2,28,10,3,2,2,0,25,26,4,0,2016,reg
Kekuta Manneh,FC Cincinnati,F,17,13,1139,5,2,36,20,1,4,1,1,9,10,1,0,2016,reg
Alex,Houston Dynamo,M,30,29,2476,5,2,42,11,2,3,1,1,40,55,8,1,2016,reg
Luis Solignac,Chicago Fire FC,F,31,24,2177,5,2,49,22,2,3,2,0,30,23,1,1,2016,reg
Simon Dawkins,San Jose Earthquakes ,M,29,28,2402,5,2,64,18,3,2,1,1,29,31,3,1,2016,reg
Steven Mendoza,New York City FC,F,24,10,1139,5,1,45,10,4,1,0,1,13,19,1,0,2016,reg
Kennedy Igboananike,Chicago Fire FC,F,25,20,1754,5,1,57,19,3,2,1,0,35,44,3,0,2016,reg
Jack McInerney,Portland Timbers,F,24,8,904,5,0,37,18,3,2,0,0,16,10,1,0,2016,reg
Lloyd Sam,DC United,M-F,29,26,2025,4,10,32,6,3,1,8,2,23,37,3,0,2016,reg
Khiry Shelton,Sporting Kansas City,F,22,13,1159,4,9,17,6,2,2,7,2,10,15,0,0,2016,reg
Patrick Nyarko,DC United,F-M,26,23,1828,4,8,23,7,2,2,7,1,19,64,2,0,2016,reg
Nicolás Lodeiro,FC Dallas,M,13,13,1170,4,8,33,11,1,3,3,5,8,44,5,0,2016,reg
Jack Harrison,New York City FC,F,21,17,1574,4,7,22,8,3,1,6,1,15,19,0,0,2016,reg
Javier Morales,Real Salt Lake,M,29,23,2182,4,4,38,13,2,2,3,1,32,35,5,0,2016,reg
Ricardo Clark,Houston Dynamo,M,32,29,2551,4,4,43,13,1,3,3,1,51,27,4,0,2016,reg
Cristian Roldan,FC Dallas,M,33,28,2632,4,3,30,11,4,0,1,2,27,46,2,0,2016,reg
Federico Higuain,DC United,F,20,18,1607,4,3,45,14,2,2,2,1,10,23,0,0,2016,reg
Will Bruin,FC Dallas,F,31,18,1554,4,3,59,22,1,3,3,0,22,24,1,0,2016,reg
Luke Mulholland,Real Salt Lake,M,33,23,2028,4,2,42,9,1,3,0,2,54,40,7,0,2016,reg
Fabian Espindola,DC United ,F,15,10,926,4,1,38,15,3,1,0,1,9,18,2,0,2016,reg
Nicolas Mezquida,Colorado Rapids,F-M,28,17,1395,4,1,50,19,4,0,0,1,19,35,1,0,2016,reg
Chad Marshall,FC Dallas,D,30,30,2634,4,0,21,9,2,2,0,0,13,19,2,0,2016,reg
Walker Zimmerman,Nashville SC,D,30,30,2700,4,0,28,11,4,0,0,0,38,20,4,0,2016,reg
Steven Gerrard,LA Galaxy,M,21,18,1491,3,11,32,11,3,0,6,5,20,15,2,0,2016,reg
Luciano Acosta,DC United,M-F,31,25,2109,3,11,50,14,3,0,8,3,47,50,9,0,2016,reg
Andreas Ivanschitz,FC Dallas,M,28,25,1910,3,8,36,13,2,1,6,2,13,30,5,0,2016,reg
Sébastien Le Toux,Colorado Rapids,F,32,21,1861,3,7,20,8,2,1,4,3,12,28,3,0,2016,reg
Fabian Herbers,Chicago Fire FC,F,32,13,1290,3,7,32,14,1,2,3,4,18,30,3,0,2016,reg
Marlon Hairston,Minnesota United FC,M,21,14,1272,3,6,16,9,3,0,4,2,11,15,2,0,2016,reg
Dax McCarty,Nashville SC,M,27,26,2268,3,5,24,8,1,2,3,2,28,37,3,0,2016,reg
Lucas Melano,Portland Timbers,F,31,27,2268,3,5,44,14,2,1,4,1,29,21,1,0,2016,reg
Cristian Maidana,Houston Dynamo,M,30,21,1695,3,4,22,6,3,0,3,1,8,9,1,0,2016,reg
Alberto Quintero,San Jose Earthquakes ,M,30,29,2230,3,4,28,9,2,1,3,1,25,81,4,1,2016,reg
John Goossens,Chicago Fire FC,M,24,15,1288,3,4,32,11,2,1,2,2,10,17,0,0,2016,reg
Matteo Mancosu,Montreal Impact,F,15,7,772,3,4,33,11,2,1,1,3,9,14,1,0,2016,reg
Carlos Rivas,Orlando City SC,F,21,8,799,3,4,34,7,0,3,1,3,19,12,6,0,2016,reg
Osvaldo Alonso,Minnesota United FC,M,32,32,2826,3,4,43,11,0,3,3,1,51,63,7,1,2016,reg
Harrison Afful,Columbus Crew SC,D,30,30,2567,3,3,40,13,2,1,2,1,27,21,1,1,2016,reg
Quincy Amarikwa,San Jose Earthquakes ,F,23,22,1699,3,3,50,12,2,1,1,2,55,52,0,0,2016,reg
Adrian Winter,Orlando City SC,M-F,13,12,975,3,2,17,7,2,1,2,0,18,10,1,0,2016,reg
Jermaine Jones,Colorado Rapids,M,9,8,725,3,2,21,9,3,0,1,1,21,26,4,0,2016,reg
Brek Shea,,D,27,22,2003,3,2,27,9,1,2,2,0,27,25,9,0,2016,reg
Steven Birnbaum,DC United,D,26,26,2340,3,2,33,12,2,1,2,0,37,10,5,0,2016,reg
Alan Gordon,LA Galaxy,F,22,7,710,3,1,15,6,1,2,0,1,17,13,2,0,2016,reg
Fatai Alashe,FC Cincinnati,M,28,27,2335,3,1,19,9,2,1,1,0,41,23,8,0,2016,reg
Jordan Hamilton,Columbus Crew SC,F,14,11,911,3,1,20,12,1,2,0,1,9,12,0,0,2016,reg
Kendall Waston,FC Cincinnati,D,26,26,2266,3,1,21,10,3,0,1,0,43,15,8,3,2016,reg
Gonzalo Verón,New York Red Bulls,M-F,23,6,631,3,0,18,8,1,2,0,0,11,15,2,1,2016,reg
Tosaint Ricketts,Vancouver Whitecaps,F,11,4,399,3,0,20,9,1,2,0,0,3,8,1,1,2016,reg
Drew Moor,Colorado Rapids,D,32,32,2880,3,0,21,6,2,1,0,0,15,29,3,0,2016,reg
David Horst,Houston Dynamo,D,26,24,2211,3,0,21,11,2,1,0,0,20,17,4,0,2016,reg
Sebastian Hines,Orlando City SC,D,26,23,2105,3,0,27,9,3,0,0,0,38,12,7,0,2016,reg
Alex Muyl,New York Red Bulls,M,27,18,1599,2,6,30,12,0,2,3,3,41,37,5,0,2016,reg
Emmanuel Boateng,DC United,M,26,17,1547,2,5,20,9,1,1,3,2,15,11,1,0,2016,reg
Jonathan Osorio,Toronto FC,M,30,26,2440,2,5,24,7,1,1,3,2,25,30,2,0,2016,reg
Will Johnson,Toronto FC,D,23,19,1660,2,5,32,10,1,1,0,5,21,23,4,0,2016,reg
Kellyn Acosta,Colorado Rapids,M,32,24,2328,2,5,35,9,2,0,3,2,38,29,4,0,2016,reg
Graham Zusi,Sporting Kansas City,M,21,18,1651,2,4,29,10,2,0,3,1,13,18,1,0,2016,reg
Marco Pappa,Colorado Rapids,M,20,10,895,2,4,29,13,2,0,1,3,10,14,2,0,2016,reg
Mauro Rosales,FC Dallas,M,23,4,544,2,3,6,3,2,0,1,2,8,12,2,0,2016,reg
Sean Davis,New York Red Bulls,M,21,11,1108,2,3,12,3,1,1,2,1,18,15,1,0,2016,reg
Joevin Jones,FC Dallas,D-M,33,29,2547,2,3,16,5,1,1,0,3,29,11,6,0,2016,reg
Chris Tierney,New England Revolution,D-M,28,27,2321,2,3,19,6,1,1,1,2,6,9,1,0,2016,reg
Harry Shipp,Montreal Impact,M,27,20,1596,2,3,25,6,1,1,2,1,16,14,2,0,2016,reg
Baggio Husidic,LA Galaxy,M,29,16,1556,2,2,12,4,1,1,1,1,21,20,2,0,2016,reg
Marky Delgado,Toronto FC,M,28,23,1995,2,2,17,5,1,1,0,2,30,15,5,0,2016,reg
Hassoun Camara,Montreal Impact,D,27,26,2249,2,2,19,5,2,0,2,0,44,15,6,0,2016,reg
Matt Polster,New England Revolution,D,27,24,2107,2,2,20,4,1,1,1,1,39,27,5,0,2016,reg
Keegan Rosenberry,Colorado Rapids,D,34,34,3060,2,2,21,7,1,1,1,1,13,17,0,0,2016,reg
Lucas Ontivero,Montreal Impact,M,21,12,980,2,2,29,9,2,0,1,1,24,38,4,0,2016,reg
Ilsinho,Philadelphia Union,M,25,14,1286,2,2,30,7,2,0,1,1,13,14,2,1,2016,reg
Erik Hurtado,Sporting Kansas City,F,24,12,1230,2,2,34,8,1,1,1,1,30,24,2,0,2016,reg
Cristian Techera,Vancouver Whitecaps,M,29,19,1584,2,2,43,17,2,0,2,0,13,29,3,0,2016,reg
Teal Bunbury,New England Revolution,F,27,19,1666,2,2,49,9,0,2,1,1,47,29,5,0,2016,reg
Justen Glad,Real Salt Lake,D,28,27,2424,2,1,4,3,0,2,1,0,24,15,4,0,2016,reg
Femi Hollinger-Janzen,New England Revolution,F,19,1,273,2,1,10,2,2,0,0,1,5,2,0,0,2016,reg
Lawrence Olum,Sporting Kansas City,D,19,17,1469,2,1,10,4,1,1,0,1,13,4,3,0,2016,reg
Axel Sjöberg,Columbus Crew SC,D,31,31,2772,2,1,11,6,0,2,0,1,25,11,6,0,2016,reg
Ken Tribbett,Nashville SC,D,22,19,1727,2,1,12,5,1,1,0,1,15,28,4,0,2016,reg
Tony Taylor,New York City FC,F-M,14,7,605,2,1,12,3,1,1,0,1,14,6,2,0,2016,reg
Bobby Boswell,DC United,D,30,29,2632,2,1,14,10,1,1,1,0,24,10,3,0,2016,reg
Blas Pérez,Vancouver Whitecaps,F,22,5,754,2,1,15,5,2,0,1,0,26,22,5,0,2016,reg
Chad Barrett,San Jose Earthquakes,F,20,3,531,2,1,17,7,1,1,0,1,4,4,1,0,2016,reg
Masato Kudo,Vancouver Whitecaps,F,17,12,894,2,1,25,14,2,0,1,0,12,8,0,0,2016,reg
Brad Davis,Sporting Kansas City,M,24,14,1300,2,1,34,11,2,0,0,1,10,27,0,0,2016,reg
Gideon Baah,New York Red Bulls,D,9,6,467,2,0,8,3,0,2,0,0,8,2,0,0,2016,reg
Michael Salazar,Houston Dynamo,F,17,8,711,2,0,9,5,2,0,0,0,17,14,1,0,2016,reg
Jordan Harvey,LAFC,D,28,28,2520,2,0,10,2,2,0,0,0,26,24,2,0,2016,reg
Ronald Zubar,New York Red Bulls,D,21,19,1593,2,0,11,3,1,1,0,0,15,17,6,0,2016,reg
Victor Ulloa,,M,32,18,1639,2,0,11,4,1,1,0,0,21,13,2,0,2016,reg
Richie Marquez,Philadelphia Union,D,33,33,2970,2,0,11,4,1,1,0,0,32,10,4,0,2016,reg
Vincent Nogueira,Philadelphia Union,M,8,8,684,2,0,14,3,2,0,0,0,6,6,1,0,2016,reg
Jámison Olave,Real Salt Lake,D,17,16,1482,2,0,14,7,2,0,0,0,10,15,2,1,2016,reg
Andrew Jacobson,New York City FC,M,26,18,1751,2,0,16,7,0,2,0,0,27,10,4,0,2016,reg
Rob Vincent,DC United,M-F,20,12,1137,2,0,17,8,1,1,0,0,11,2,4,0,2016,reg
Ryan Hollingshead,FC Dallas,M,29,22,2024,2,0,22,8,2,0,0,0,36,24,3,0,2016,reg
Octavio Rivero,Vancouver Whitecaps,F,12,9,757,2,0,23,15,1,1,0,0,25,17,4,0,2016,reg
Tsubasa Endoh,Toronto FC,M,21,15,1387,2,0,24,9,2,0,0,0,9,20,0,0,2016,reg
Jared Jeffrey,DC United,M,21,14,1314,2,0,24,5,0,2,0,0,40,3,5,0,2016,reg
Andrea Pirlo,New York City FC,M,32,32,2770,1,11,26,6,1,0,4,7,29,33,4,0,2016,reg
Sebastian Lletget,LA Galaxy,M,31,23,2057,1,8,29,8,0,1,4,4,20,45,1,0,2016,reg
RJ Allen,New York City FC,D,24,19,1751,1,6,4,1,1,0,2,4,39,19,7,0,2016,reg
Taylor Kemp,DC United,D,31,30,2745,1,6,23,3,1,0,5,1,38,30,2,0,2016,reg
Michael Bradley,Toronto FC,M,24,24,2160,1,5,12,3,1,0,4,1,28,20,5,0,2016,reg
Shea Salinas,San Jose Earthquakes,M,33,8,1223,1,5,19,9,0,1,4,1,12,8,0,0,2016,reg
Ronald Matarrita,New York City FC,D,25,23,1988,1,5,25,9,0,1,3,2,28,13,4,0,2016,reg
Darlington Nagbe,Columbus Crew SC,M,27,27,2416,1,5,39,8,1,0,3,2,16,57,1,0,2016,reg
Roger Espinoza,Sporting Kansas City,M,30,30,2679,1,5,48,12,1,0,4,1,65,54,10,2,2016,reg
Julian Buescher,DC United,M,20,3,584,1,4,8,4,1,0,1,3,21,12,3,0,2016,reg
Dillon Powers,Colorado Rapids,M,29,24,2122,1,4,34,6,0,1,2,2,31,39,4,0,2016,reg
Ike Opara,Minnesota United FC,D,25,16,1542,1,3,15,7,1,0,2,1,22,11,4,1,2016,reg
Darren Mattocks,Portland Timbers,F,19,12,940,1,3,20,10,1,0,3,0,14,18,0,0,2016,reg
Tony Tchani,Columbus Crew SC,M,21,20,1791,1,3,27,8,1,0,1,2,35,27,8,1,2016,reg
Sam Cronin,Colorado Rapids,M,33,33,2924,1,3,27,8,1,0,2,1,54,31,6,0,2016,reg
Sean Franklin,DC United,D,29,29,2494,1,2,5,1,1,0,1,1,39,17,5,0,2016,reg
Robbie Rogers,LA Galaxy,D,21,19,1655,1,2,6,4,0,1,1,1,22,26,2,0,2016,reg
Jack Jewsbury,Portland Timbers,M,23,17,1503,1,2,8,2,1,0,2,0,17,15,4,0,2016,reg
Atiba Harris,FC Dallas,D,28,22,1970,1,2,17,5,0,1,2,0,29,19,6,0,2016,reg
Mix Diskerud,New York City FC,M,12,9,812,1,2,20,7,0,1,1,1,7,14,1,0,2016,reg
Marcelo Sarvas,DC United,M,28,26,2247,1,2,22,6,1,0,2,0,67,65,11,1,2016,reg
Anibal Godoy,Nashville SC,M-D,23,23,1941,1,2,28,9,1,0,1,1,45,57,7,2,2016,reg
Jimmy Medranda ,Nashville SC,D,28,22,1939,1,2,41,8,1,0,2,0,36,16,8,1,2016,reg
Matt Besler,Sporting Kansas City,D,18,17,1546,1,1,3,1,1,0,1,0,14,7,4,0,2016,reg
Hernan Bernardello,Montreal Impact,M,12,11,991,1,1,3,3,0,1,0,1,13,16,5,0,2016,reg
Zarek Valentin,Houston Dynamo,D,20,18,1607,1,1,4,3,1,0,0,1,12,7,2,0,2016,reg
Damien Perquis,Toronto FC,D,12,11,986,1,1,4,1,0,1,1,0,12,14,3,0,2016,reg
Álvaro Fernández,FC Dallas,M,10,8,530,1,1,5,2,1,0,0,1,8,11,0,0,2016,reg
Nat Borchers,Portland Timbers,D,21,21,1812,1,1,5,1,0,1,0,1,10,9,1,0,2016,reg
Joey Calistri,Chicago Fire FC,M,14,2,348,1,1,5,4,0,1,0,1,2,3,0,0,2016,reg
Kevin Ellis,Sporting Kansas City,D,14,10,953,1,1,7,3,0,1,0,1,8,7,1,0,2016,reg
Daniel Royer,New York Red Bulls,M,6,3,275,1,1,8,2,1,0,1,0,1,8,0,0,2016,reg
Leonel Miranda,Houston Dynamo,M,12,3,484,1,1,8,2,0,1,1,0,6,8,0,0,2016,reg
Daniel Steres ,LA Galaxy,D,31,29,2656,1,1,9,2,1,0,1,0,30,14,5,0,2016,reg
Jonathan Campbell,Chicago Fire FC,D,33,30,2823,1,1,9,2,1,0,1,0,14,21,1,0,2016,reg
Brad Evans,FC Dallas,D-M,23,21,1866,1,1,9,1,0,1,1,0,12,13,1,2,2016,reg
Jeff Larentowicz,Atlanta United FC,M,23,17,1501,1,1,11,1,1,0,0,1,33,14,5,0,2016,reg
Je-Vaughn Watson,New England Revolution,D,23,19,1705,1,1,11,4,1,0,1,0,24,20,3,1,2016,reg
Cristian Higuita,Orlando City SC,M,21,16,1513,1,1,11,1,1,0,1,0,42,40,9,1,2016,reg
Sunday Stephen,Real Salt Lake,M,15,15,1115,1,1,12,3,1,0,0,1,26,14,4,0,2016,reg
Charlie Davies,New England Revolution ,F,17,3,371,1,1,12,9,0,1,0,1,8,2,0,0,2016,reg
Víctor Bernárdez,San Jose Earthquakes ,D,33,33,2835,1,1,13,2,1,0,1,0,40,24,5,0,2016,reg
Dilly Duka,Columbus Crew SC,M,15,5,604,1,1,14,7,1,0,1,0,7,3,0,0,2016,reg
Connor Lade,New York Red Bulls,D,18,15,1380,1,1,15,4,1,0,0,1,17,25,4,0,2016,reg
Johan Venegas,Montreal Impact,M,20,7,683,1,1,15,8,1,0,1,0,18,17,2,0,2016,reg
Olmes Garcia,Real Salt Lake,F,24,9,964,1,1,18,8,1,0,0,1,23,20,2,0,2016,reg
Nuno Andre Coelho,Sporting Kansas City,D,22,20,1618,1,1,18,3,0,1,1,0,4,12,2,0,2016,reg
Carlos Ruiz,FC Dallas,F,1,0,13,1,0,1,1,1,0,0,0,0,0,0,0,2016,reg
Maxim Tissot,Montreal Impact,D,7,5,517,1,0,2,1,1,0,0,0,7,4,0,0,2016,reg
Kwadwo Poku,New York City FC,M,7,3,268,1,0,3,1,0,1,0,0,4,8,0,0,2016,reg
Steven Taylor,Portland Timbers,D,9,9,810,1,0,4,2,1,0,0,0,3,6,0,0,2016,reg
Landon Donovan,LA Galaxy,M-F,6,2,233,1,0,4,1,0,1,0,0,2,2,1,0,2016,reg
Cristian Martinez,Columbus Crew SC,M,5,2,197,1,0,4,2,0,1,0,0,6,5,1,0,2016,reg
Dillon Serna,Colorado Rapids,M,9,3,280,1,0,5,3,1,0,0,0,4,1,1,0,2016,reg
DaMarcus Beasley,Houston Dynamo,D,24,24,1979,1,0,5,4,0,1,0,0,15,49,1,0,2016,reg
Vytas,Portland Timbers,D,11,10,916,1,0,5,1,1,0,0,0,19,15,2,0,2016,reg
Jefferson Mena,New York City FC,D,16,16,1306,1,0,6,2,1,0,0,0,14,6,1,0,2016,reg
London Woodberry,New England Revolution,D,25,23,2068,1,0,6,3,0,1,0,0,31,9,7,0,2016,reg
Alhaji Kamara,DC United,F,8,2,173,1,0,7,2,0,1,0,0,8,1,0,0,2016,reg
Anthony Jackson-Hamel,Montreal Impact,F,7,1,171,1,0,8,3,1,0,0,0,3,2,0,0,2016,reg
Ashley Cole,LA Galaxy,D,26,25,2227,1,0,8,2,1,0,0,0,22,31,3,2,2016,reg
Bobby Burling,Colorado Rapids,D,16,16,1415,1,0,10,2,0,1,0,0,21,11,4,0,2016,reg
Alejandro Bedoya,Philadelphia Union,M,10,10,844,1,0,10,4,0,1,0,0,24,7,3,0,2016,reg
Matt Hedges,FC Dallas,D,26,26,2334,1,0,10,5,1,0,0,0,28,15,5,0,2016,reg
Kyle Bekker,Montreal Impact,M,18,13,1139,1,0,10,4,1,0,0,0,14,2,3,0,2016,reg
Jack Barmby,Portland Timbers,M-D,19,2,381,1,0,11,5,0,1,0,0,7,8,1,0,2016,reg
Frederic Brillant,DC United,D,31,31,2790,1,0,11,4,1,0,0,0,21,12,4,0,2016,reg
Cedrick Mabwati,Columbus Crew SC,M,17,6,593,1,0,12,5,1,0,0,0,4,5,0,0,2016,reg
Liam Ridgewell,Portland Timbers,D,22,22,1980,1,0,12,4,1,0,0,0,25,30,6,0,2016,reg
Daigo Kobayashi,New England Revolution,M,27,6,701,1,0,13,2,0,1,0,0,6,2,0,0,2016,reg
Diego Rubio,Colorado Rapids,F,15,3,330,1,0,13,2,0,1,0,0,13,13,2,0,2016,reg
Raul Rodriguez,Houston Dynamo,D,25,24,2128,1,0,13,3,0,1,0,0,23,7,3,0,2016,reg
Brian Carroll,Philadelphia Union,M,26,23,2094,1,0,14,3,0,1,0,0,40,9,6,0,2016,reg
Dairon Asprilla,Portland Timbers,M-F,9,6,488,1,0,14,3,1,0,0,0,8,5,1,1,2016,reg
Aaron Kovar,FC Dallas,M,16,10,811,1,0,21,5,0,1,0,0,12,8,1,0,2016,reg
Khaly Thiam,Chicago Fire FC,M,20,15,1285,1,0,21,3,0,1,0,0,27,14,3,1,2016,reg
Nick DeLeon,Toronto FC,M,32,27,2509,1,0,34,10,1,0,0,0,21,16,5,0,2016,reg
Boniek Garcia,Houston Dynamo,M,31,24,2249,0,9,25,4,0,0,2,7,35,58,4,0,2016,reg
Fabinho,Philadelphia Union,D,29,29,2517,0,6,10,2,0,0,2,4,27,23,6,0,2016,reg
Saad Abdul-Salaam,FC Cincinnati,D,30,26,2377,0,6,15,3,0,0,4,2,32,19,1,0,2016,reg
Demar Phillips,Real Salt Lake,D,29,23,2177,0,5,9,3,0,0,3,2,40,16,3,1,2016,reg
Ambroise Oyongo,Montreal Impact,D,27,26,2316,0,5,16,4,0,0,4,1,13,29,4,1,2016,reg
Mohammed Saeid,Columbus Crew SC,M,25,24,2016,0,5,20,3,0,0,5,0,14,37,2,0,2016,reg
Mekeil Williams,Colorado Rapids,D,21,17,1468,0,4,2,0,0,0,3,1,12,9,5,0,2016,reg
Corey Ashe,Columbus Crew SC,M,18,14,1214,0,4,4,0,0,0,2,2,7,18,1,0,2016,reg
Marco Donadel,Montreal Impact,M,21,18,1515,0,4,9,1,0,0,3,1,40,21,5,0,2016,reg
Gershon Koffie,New England Revolution ,M,22,19,1545,0,4,18,5,0,0,2,2,38,41,8,1,2016,reg
Jelle Van Damme,LA Galaxy,D,28,28,2436,0,4,24,2,0,0,3,1,44,15,9,0,2016,reg
Marc Burch,Colorado Rapids,D,28,27,2443,0,3,2,1,0,0,2,1,25,10,9,0,2016,reg
Rafael Ramos,Orlando City SC,D,12,12,1015,0,3,4,1,0,0,1,2,12,6,2,0,2016,reg
Waylon Francis,Columbus Crew SC,D,19,13,1233,0,3,5,1,0,0,3,0,18,9,2,0,2016,reg
Luke Boden,Orlando City SC,D,20,19,1613,0,3,5,0,0,0,2,1,19,10,2,0,2016,reg
Tony Beltran,Real Salt Lake,D,29,27,2468,0,3,7,2,0,0,2,1,40,33,9,0,2016,reg
Brandon Vincent,Chicago Fire FC,D,26,24,2191,0,3,8,1,0,0,3,0,33,13,1,0,2016,reg
Scott Caldwell,New England Revolution,M,32,31,2622,0,3,9,1,0,0,3,0,35,34,6,0,2016,reg
Rodrigo Ramos,Chicago Fire FC,D,21,16,1484,0,3,9,1,0,0,1,2,25,27,4,0,2016,reg
Jermaine Taylor,Portland Timbers,D,23,21,1841,0,3,9,2,0,0,1,2,27,4,4,0,2016,reg
Matías Pérez García,Orlando City SC,F,27,19,1635,0,3,24,6,0,0,1,2,14,62,3,0,2016,reg
Michael Parkhurst,Columbus Crew SC,D,34,34,3036,0,2,0,0,0,0,1,1,11,18,2,1,2016,reg
Michael Stephens,Chicago Fire FC,M,17,11,948,0,2,2,0,0,0,0,2,5,4,1,0,2016,reg
Mark Bloom,Toronto FC,D,7,5,339,0,2,2,1,0,0,2,0,4,4,1,0,2016,reg
Tyrone Mears,FC Dallas,D,32,32,2835,0,2,3,0,0,0,1,1,33,22,3,0,2016,reg
Donny Toia,Real Salt Lake,D,17,15,1365,0,2,5,1,0,0,1,1,17,4,2,0,2016,reg
Nicolai Naess,Columbus Crew SC,D,13,13,1156,0,2,6,3,0,0,1,1,8,11,0,0,2016,reg
Chris Duvall,Portland Timbers,D,25,20,1889,0,2,9,1,0,0,2,0,19,26,4,1,2016,reg
Cordell Cato,San Jose Earthquakes ,F,21,15,1391,0,2,9,3,0,0,1,1,9,18,0,0,2016,reg
Aurelien Collin,Philadelphia Union,D,25,22,2067,0,2,10,3,0,0,1,1,37,16,7,1,2016,reg
Armando Cooper,Toronto FC,M,6,4,390,0,2,11,3,0,0,2,0,8,19,0,0,2016,reg
Servando Carrasco,Orlando City SC,M,31,21,2001,0,2,12,3,0,0,2,0,37,7,5,0,2016,reg
Erik Friberg,FC Dallas,M,25,18,1582,0,2,12,2,0,0,2,0,17,5,4,0,2016,reg
Jay Chapman,,M,18,9,780,0,2,12,5,0,0,1,1,14,9,1,0,2016,reg
Benoit Cheyrou,Toronto FC,M,14,9,800,0,2,13,2,0,0,1,1,9,3,2,1,2016,reg
Sal Zizzo,New York Red Bulls,D,28,20,1920,0,2,18,5,0,0,1,1,15,13,2,0,2016,reg
Gilberto,Chicago Fire FC,F,9,8,641,0,2,23,4,0,0,2,0,7,10,0,0,2016,reg
Carlos Gruezo,FC Dallas,M,27,26,2240,0,2,24,3,0,0,2,0,55,14,9,0,2016,reg
Darwin Ceren,Houston Dynamo,M,28,23,2113,0,2,30,3,0,0,1,1,41,29,4,1,2016,reg
Kip Colvey,San Jose Earthquakes ,M,4,3,315,0,1,0,0,0,0,1,0,1,3,0,0,2016,reg
Marvell Wynne,San Jose Earthquakes ,D,32,31,2769,0,1,0,0,0,0,0,1,22,16,3,0,2016,reg
Chance Myers,Sporting Kansas City,D,11,6,559,0,1,1,0,0,0,1,0,6,5,1,0,2016,reg
Dave Romney,Nashville SC,D,10,8,730,0,1,1,0,0,0,0,1,4,7,1,0,2016,reg
Hadji Barry,Orlando City SC,F,8,4,293,0,1,1,0,0,0,1,0,4,4,0,0,2016,reg
Oniel Fisher,DC United,D,6,2,232,0,1,1,0,0,0,1,0,10,5,1,1,2016,reg
Dennis Castillo,Colorado Rapids,D,4,1,123,0,1,1,0,0,0,1,0,3,2,1,0,2016,reg
Walter Restrepo,Philadelphia Union,M,4,0,81,0,1,1,1,0,0,0,1,5,2,0,0,2016,reg
Michael Harrington,Chicago Fire FC,D,19,16,1291,0,1,2,1,0,0,1,0,10,7,0,1,2016,reg
Raymon Gaddis,Philadelphia Union,D,7,5,514,0,1,2,1,0,0,0,1,7,6,4,0,2016,reg
Josh Williams,Columbus Crew SC,D,15,11,918,0,1,2,0,0,0,1,0,7,3,0,1,2016,reg
Steven Beitashour,Toronto FC,D,29,29,2563,0,1,3,0,0,0,0,1,34,32,5,0,2016,reg
Eric Alexander,Houston Dynamo,M,22,15,1374,0,1,3,1,0,0,1,0,14,8,1,0,2016,reg
Andoni Iraola,New York City FC,D,29,25,2180,0,1,3,0,0,0,0,1,22,17,3,0,2016,reg
Andrew Farrell,New England Revolution,D,33,32,2891,0,1,3,1,0,0,1,0,15,20,1,0,2016,reg
Diego Martinez,New York City FC,D,4,2,263,0,1,3,1,0,0,1,0,6,2,1,0,2016,reg
Eriq Zavaleta,Toronto FC,D,15,14,1277,0,1,4,1,0,0,1,0,7,4,2,0,2016,reg
Warren Creavalle,Philadelphia Union,M,27,21,1807,0,1,4,0,0,0,1,0,33,21,5,1,2016,reg
Jordi Quintilla,Sporting Kansas City,M,6,6,410,0,1,4,1,0,0,0,1,4,9,1,0,2016,reg
Sheanon Williams,Houston Dynamo,D-M,22,20,1807,0,1,5,1,0,0,1,0,25,19,3,0,2016,reg
Patrice Bernier,Montreal Impact,M,20,13,1185,0,1,5,0,0,0,1,0,22,12,4,0,2016,reg
Paulo Nagamura,Sporting Kansas City,M,9,6,526,0,1,5,2,0,0,0,1,13,6,2,0,2016,reg
John Stertzer,Real Salt Lake,M,18,9,777,0,1,5,3,0,0,1,0,14,8,0,0,2016,reg
Joao Meira,Chicago Fire FC,D-M,28,26,2284,0,1,6,2,0,0,1,0,35,27,6,0,2016,reg
Alvas Powell,,D,23,23,2015,0,1,6,1,0,0,0,1,21,29,4,0,2016,reg
Federico Bravo,New York City FC,M,21,11,1096,0,1,7,0,0,0,0,1,36,19,8,1,2016,reg
Eric Miller,Nashville SC,D,26,23,2118,0,1,7,2,0,0,1,0,24,11,3,1,2016,reg
Nick LaBrocca,Chicago Fire FC,M,12,5,514,0,1,8,3,0,0,0,1,13,12,3,0,2016,reg
Jordan Stewart,San Jose Earthquakes ,D-M,15,14,1221,0,1,8,2,0,0,1,0,15,31,4,0,2016,reg
Diego Chara,Portland Timbers,M,30,30,2600,0,1,9,2,0,0,1,0,86,55,9,1,2016,reg
Wil Trapp,,M,30,29,2543,0,1,10,0,0,0,1,0,34,25,5,0,2016,reg
Molham Babouli,Toronto FC,F,16,6,647,0,1,10,1,0,0,1,0,11,6,1,0,2016,reg
Mikey Lopez,New York City FC,M,15,6,672,0,1,12,4,0,0,0,1,19,10,6,0,2016,reg
Leo Fernandes,Philadelphia Union,M,12,2,256,0,1,12,3,0,0,1,0,9,7,1,0,2016,reg
Jalil Anibaba,Nashville SC,D,30,28,2614,0,1,12,4,0,0,1,0,27,8,4,0,2016,reg
Ben Zemanski,Portland Timbers,M,16,11,1010,0,1,12,1,0,0,1,0,10,12,2,0,2016,reg
Collen Warner,Colorado Rapids,M,24,24,1979,0,1,12,0,0,0,0,1,41,18,2,0,2016,reg
Micheal Azira,Chicago Fire FC,M,31,28,2503,0,1,13,1,0,0,0,1,65,25,9,1,2016,reg
Hector Jimenez,Columbus Crew SC,M,25,14,1239,0,1,14,4,0,0,0,1,4,10,0,0,2016,reg
Henok Goitom,San Jose Earthquakes ,F,8,3,416,0,1,14,2,0,0,1,0,6,6,1,0,2016,reg
Chris Rolfe,DC United,F,9,9,643,0,1,17,3,0,0,0,1,7,11,2,0,2016,reg
Erick Torres,Houston Dynamo,F,11,4,401,0,1,17,3,0,0,1,0,9,9,1,0,2016,reg
Connor Hallisey,Sporting Kansas City,F,17,12,1072,0,1,18,8,0,0,1,0,5,12,0,0,2016,reg
Maynor Figueroa,Houston Dynamo,D,28,28,2434,0,1,21,4,0,0,0,1,27,11,7,1,2016,reg
Nelson Valdez,FC Dallas,F,24,8,900,0,1,30,11,0,0,1,0,21,22,4,0,2016,reg
Kyle Beckerman,Real Salt Lake,M,27,27,2367,0,1,43,12,0,0,0,1,48,27,8,1,2016,reg
Sean St. Ledger,Colorado Rapids,D,0,0,0,0,0,0,0,0,0,0,0,0,0,0,0,2016,reg
Conor Casey,Columbus Crew SC,F,4,0,35,0,0,0,0,0,0,0,0,2,0,0,1,2016,reg
Nathan Sturgis,FC Dallas,M,0,0,0,0,0,0,0,0,0,0,0,0,0,0,0,2016,reg
Mehdi Ballouchy,New York City FC,M,4,1,145,0,0,0,0,0,0,0,0,2,2,0,0,2016,reg
Jason Hernandez,New York City FC,D,31,26,2292,0,0,0,0,0,0,0,0,26,21,2,1,2016,reg
Maurice Edu,Philadelphia Union,M,0,0,0,0,0,0,0,0,0,0,0,0,0,0,0,2016,reg
Steven Lenhart,San Jose Earthquakes ,F,0,0,0,0,0,0,0,0,0,0,0,0,0,0,0,2016,reg
Markus Halsti,DC United ,M-D,0,0,0,0,0,0,0,0,0,0,0,0,0,0,0,2016,reg
Andrea Mancini,DC United ,F,0,0,0,0,0,0,0,0,0,0,0,0,0,0,0,2016,reg
Xavier Kouassi,New England Revolution ,M,0,0,0,0,0,0,0,0,0,0,0,0,0,0,0,2016,reg
Juan Ramirez,Colorado Rapids,M,0,0,0,0,0,0,0,0,0,0,0,0,0,0,0,2016,reg
Marc Pelosi,San Jose Earthquakes ,M,0,0,0,0,0,0,0,0,0,0,0,0,0,0,0,2016,reg
Paul Clowes,DC United ,M,0,0,0,0,0,0,0,0,0,0,0,0,0,0,0,2016,reg
Rafael Garcia ,LA Galaxy,D,6,2,269,0,0,0,0,0,0,0,0,5,2,1,0,2016,reg
Eric Gehrig,Chicago Fire FC,D,5,3,259,0,0,0,0,0,0,0,0,5,0,0,0,2016,reg
Zach Pfeffer,Colorado Rapids,M,0,0,0,0,0,0,0,0,0,0,0,0,0,0,0,2016,reg
Chris Korb,DC United ,D,0,0,0,0,0,0,0,0,0,0,0,0,0,0,0,2016,reg
Michael Farfan,FC Dallas,M,1,0,26,0,0,0,0,0,0,0,0,1,0,0,0,2016,reg
Ethan White,New York City FC,D,13,7,676,0,0,0,0,0,0,0,0,7,4,2,1,2016,reg
Moises Hernandez,FC Dallas,D,0,0,0,0,0,0,0,0,0,0,0,0,0,0,0,2016,reg
Zach Loyd,FC Dallas,D,12,10,919,0,0,0,0,0,0,0,0,4,13,1,0,2016,reg
Emil Larsen,Columbus Crew SC,M,3,0,31,0,0,0,0,0,0,0,0,0,0,0,0,2016,reg
Leonardo,LA Galaxy,D,4,4,360,0,0,0,0,0,0,0,0,8,1,0,0,2016,reg
Amobi Okugo,Portland Timbers,D-M,4,2,227,0,0,0,0,0,0,0,0,5,3,0,0,2016,reg
Aubrey David,FC Dallas,D,5,4,363,0,0,0,0,0,0,0,0,5,5,1,0,2016,reg
Kevin Kratz,Philadelphia Union,M,0,0,0,0,0,0,0,0,0,0,0,0,0,0,0,2016,reg
Andres Romero,Montreal Impact,M,0,0,0,0,0,0,0,0,0,0,0,0,0,0,0,2016,reg
Norberto Paparatto,FC Dallas,D,0,0,0,0,0,0,0,0,0,0,0,0,0,0,0,2016,reg
Michael Gamble,New England Revolution ,F,0,0,0,0,0,0,0,0,0,0,0,0,0,0,0,2016,reg
Jalen Robinson,DC United,D,4,3,271,0,0,0,0,0,0,0,0,3,2,0,0,2016,reg
Collin Martin,DC United,M,2,1,91,0,0,0,0,0,0,0,0,2,1,0,0,2016,reg
Andy Craven,FC Dallas,F,0,0,0,0,0,0,0,0,0,0,0,0,0,0,0,2016,reg
Juan Esteban Ortiz,FC Dallas,M,5,2,171,0,0,0,0,0,0,0,0,5,1,2,0,2016,reg
Boyd Okwuonu,Real Salt Lake,D,2,1,92,0,0,0,0,0,0,0,0,0,1,0,0,2016,reg
Chris Klute,Portland Timbers,D,8,8,709,0,0,0,0,0,0,0,0,8,0,1,0,2016,reg
Benji Joya,Sporting Kansas City,M,0,0,0,0,0,0,0,0,0,0,0,0,0,0,0,2016,reg
Chad Barson,Columbus Crew SC,D,7,3,326,0,0,0,0,0,0,0,0,4,5,0,0,2016,reg
Michael Seaton,Portland Timbers,F,0,0,0,0,0,0,0,0,0,0,0,0,0,0,0,2016,reg
Mikey Ambrose,,D,5,4,405,0,0,0,0,0,0,0,0,4,4,1,0,2016,reg
Oscar Sorto,LA Galaxy,D,0,0,0,0,0,0,0,0,0,0,0,0,0,0,0,2016,reg
Gbenga Arokoyo,Portland Timbers,D,1,0,23,0,0,0,0,0,0,0,0,0,0,0,0,2016,reg
Jose Villarreal,LA Galaxy,M,3,0,17,0,0,0,0,0,0,0,0,1,0,1,0,2016,reg
Kevin Garcia,Houston Dynamo,D,0,0,0,0,0,0,0,0,0,0,0,0,0,0,0,2016,reg
Cole Seiler,Vancouver Whitecaps,D,2,2,180,0,0,0,0,0,0,0,0,5,0,0,0,2016,reg
Zach Carroll,New York Red Bulls,D,0,0,0,0,0,0,0,0,0,0,0,0,0,0,0,2016,reg
Brandon Allen,New York Red Bulls,F,1,0,7,0,0,0,0,0,0,0,0,0,1,0,0,2016,reg
Sebastien Ibeagha,New York City FC,D,0,0,0,0,0,0,0,0,0,0,0,0,0,0,0,2016,reg
Christian Dean,Vancouver Whitecaps,D,0,0,0,0,0,0,0,0,0,0,0,0,0,0,0,2016,reg
Phanuel Kavita,Real Salt Lake,D,1,1,90,0,0,0,0,0,0,0,0,0,1,0,0,2016,reg
Kyle Fisher,Montreal Impact,D,2,2,180,0,0,0,0,0,0,0,0,1,0,1,0,2016,reg
Sam Adekugbe,Vancouver Whitecaps,D,2,1,111,0,0,0,0,0,0,0,0,2,2,0,0,2016,reg
Jeremy Gagnon-Lapare,Montreal Impact,M,0,0,0,0,0,0,0,0,0,0,0,0,0,0,0,2016,reg
Andy Thoma,Portland Timbers,D,0,0,0,0,0,0,0,0,0,0,0,0,0,0,0,2016,reg
Devron Garcia,Orlando City SC,M-D,0,0,0,0,0,0,0,0,0,0,0,0,0,0,0,2016,reg
Mark Sherrod,San Jose Earthquakes ,F,0,0,0,0,0,0,0,0,0,0,0,0,0,0,0,2016,reg
Alex Zendejas,FC Dallas,M,0,0,0,0,0,0,0,0,0,0,0,0,0,0,0,2016,reg
Darwin Jones,FC Dallas,F,2,0,22,0,0,0,0,0,0,0,0,1,0,0,0,2016,reg
Taylor Peay,Portland Timbers,D,2,1,109,0,0,0,0,0,0,0,0,0,1,0,0,2016,reg
Emery Welshman,Real Salt Lake,F,0,0,0,0,0,0,0,0,0,0,0,0,0,0,0,2016,reg
Emilio Orozco,Real Salt Lake,D,0,0,0,0,0,0,0,0,0,0,0,0,0,0,0,2016,reg
Harrison Heath,Orlando City SC,M,3,3,223,0,0,0,0,0,0,0,0,3,3,1,0,2016,reg
Ricardo Velazco,Real Salt Lake,F,0,0,0,0,0,0,0,0,0,0,0,0,0,0,0,2016,reg
Aaron Long,New York Red Bulls,D,0,0,0,0,0,0,0,0,0,0,0,0,0,0,0,2016,reg
Connor Brandt,New York City FC,M-D,0,0,0,0,0,0,0,0,0,0,0,0,0,0,0,2016,reg
Paxton Pomykal,FC Dallas,M,0,0,0,0,0,0,0,0,0,0,0,0,0,0,0,2016,reg
Amro Tarek,New York Red Bulls,D,1,0,2,0,0,0,0,0,0,0,0,0,0,0,0,2016,reg
Derrick Jones,Nashville SC,M,0,0,0,0,0,0,0,0,0,0,0,0,0,0,0,2016,reg
Brett Levis,Vancouver Whitecaps,D,1,0,6,0,0,0,0,0,0,0,0,0,2,0,0,2016,reg
Cole Missimo,Philadelphia Union,M,0,0,0,0,0,0,0,0,0,0,0,0,0,0,0,2016,reg
Shannon Gomez,New York City FC,D,0,0,0,0,0,0,0,0,0,0,0,0,0,0,0,2016,reg
Agustin Jara,FC Dallas,D,3,0,12,0,0,0,0,0,0,0,0,0,0,0,0,2016,reg
Pedro Baez,Real Salt Lake,F,1,0,5,0,0,0,0,0,0,0,0,0,0,0,0,2016,reg
Drew Conner,Chicago Fire FC,M,0,0,0,0,0,0,0,0,0,0,0,0,0,0,0,2016,reg
Derrick Etienne Jr.,Columbus Crew SC,M,1,0,4,0,0,0,0,0,0,0,0,0,0,0,0,2016,reg
Ben Polk,Portland Timbers,F,0,0,0,0,0,0,0,0,0,0,0,0,0,0,0,2016,reg
Rodrigo Saravia,Columbus Crew SC,M,10,1,208,0,0,0,0,0,0,0,0,3,2,0,0,2016,reg
Jordan McCrary,New England Revolution ,D,0,0,0,0,0,0,0,0,0,0,0,0,0,0,0,2016,reg
Daniel Salloi,Sporting Kansas City,F,0,0,0,0,0,0,0,0,0,0,0,0,0,0,0,2016,reg
Christian Lucatero,Houston Dynamo,M,0,0,0,0,0,0,0,0,0,0,0,0,0,0,0,2016,reg
Danilo Acosta,LA Galaxy,D,0,0,0,0,0,0,0,0,0,0,0,0,0,0,0,2016,reg
Taylor Washington,Nashville SC,D,0,0,0,0,0,0,0,0,0,0,0,0,0,0,0,2016,reg
Aaron Guillen,FC Dallas,D,2,1,106,0,0,0,0,0,0,0,0,3,0,0,0,2016,reg
Marshall Hollingsworth,Columbus Crew SC,M,0,0,0,0,0,0,0,0,0,0,0,0,0,0,0,2016,reg
Richie Laryea,Toronto FC,M,0,0,0,0,0,0,0,0,0,0,0,0,0,0,0,2016,reg
Zach Steinberger,Houston Dynamo,M,0,0,0,0,0,0,0,0,0,0,0,0,0,0,0,2016,reg
Cameron Porter,Montreal Impact,F,2,0,32,0,0,0,0,0,0,0,0,0,1,0,0,2016,reg
Joseph Greenspan,Colorado Rapids,D,1,0,1,0,0,0,0,0,0,0,0,0,1,0,0,2016,reg
Tyler Adams,New York Red Bulls,M,1,1,45,0,0,0,0,0,0,0,0,0,0,0,0,2016,reg
Chris Mannella,Toronto FC,M,0,0,0,0,0,0,0,0,0,0,0,0,0,0,0,2016,reg
Romario Williams,Montreal Impact,F,0,0,0,0,0,0,0,0,0,0,0,0,0,0,0,2016,reg
Anthony Manning,Portland Timbers,D,0,0,0,0,0,0,0,0,0,0,0,0,0,0,0,2016,reg
Colin Bonner,FC Dallas,F,1,1,27,0,0,0,0,0,0,0,0,1,0,0,0,2016,reg
Bradley Bourgeois,Houston Dynamo,D,0,0,0,0,0,0,0,0,0,0,0,0,0,0,0,2016,reg
Neco Brett,Portland Timbers,M,1,0,1,0,0,0,0,0,0,0,0,0,0,0,0,2016,reg
Chris Durkin,DC United ,M,0,0,0,0,0,0,0,0,0,0,0,0,0,0,0,2016,reg
Clément Simonin,Toronto FC,D,0,0,0,0,0,0,0,0,0,0,0,0,0,0,0,2016,reg
Zachary Herivaux,New England Revolution,M,5,0,38,0,0,0,0,0,0,0,0,1,0,0,0,2016,reg
Ben McKendry,Vancouver Whitecaps,M,0,0,0,0,0,0,0,0,0,0,0,0,0,0,0,2016,reg
Coy Craft,FC Dallas,F-M,2,0,17,0,0,0,0,0,0,0,0,0,1,0,0,2016,reg
Bryan Róchez,Orlando City SC,F,0,0,0,0,0,0,0,0,0,0,0,0,0,0,0,2016,reg
Andrew Brody,Real Salt Lake,F,0,0,0,0,0,0,0,0,0,0,0,0,0,0,0,2016,reg
Tyler Turner,Orlando City SC,D,0,0,0,0,0,0,0,0,0,0,0,0,0,0,0,2016,reg
Tommy Redding,Orlando City SC,D,18,16,1346,0,0,0,0,0,0,0,0,10,3,2,0,2016,reg
Victor Mansaray,FC Dallas,F,0,0,0,0,0,0,0,0,0,0,0,0,0,0,0,2016,reg
Ben Swanson,Columbus Crew SC,M,1,0,16,0,0,0,0,0,0,0,0,0,0,0,0,2016,reg
Auston Trusty,Colorado Rapids,D,0,0,0,0,0,0,0,0,0,0,0,0,0,0,0,2016,reg
Fito Ovalle,Real Salt Lake,M,0,0,0,0,0,0,0,0,0,0,0,0,0,0,0,2016,reg
Patrick Doody,Chicago Fire FC,D,0,0,0,0,0,0,0,0,0,0,0,0,0,0,0,2016,reg
Conor Donovan,Orlando City SC,D,0,0,0,0,0,0,0,0,0,0,0,0,0,0,0,2016,reg
Josh Yaro,Philadelphia Union,D,17,15,1327,0,0,0,0,0,0,0,0,12,4,3,2,2016,reg
Nick Besler,Real Salt Lake,M,0,0,0,0,0,0,0,0,0,0,0,0,0,0,0,2016,reg
Miguel Aguilar,DC United ,M,6,0,90,0,0,1,1,0,0,0,0,0,0,0,0,2016,reg
Collin Fernandez,Chicago Fire FC,M,2,0,8,0,0,1,0,0,0,0,0,0,2,0,0,2016,reg
Victor Cabrera,Houston Dynamo,D,23,21,1925,0,0,1,0,0,0,0,0,26,10,6,0,2016,reg
Keyner Brown,Houston Dynamo,D,4,3,285,0,0,1,0,0,0,0,0,2,0,0,0,2016,reg
Amadou Dia,Sporting Kansas City,D,11,10,907,0,0,1,0,0,0,0,0,20,5,1,0,2016,reg
Matheus Silva,San Jose Earthquakes ,D,4,2,139,0,0,1,0,0,0,0,0,3,3,1,0,2016,reg
Rob Lovejoy,Houston Dynamo,F,2,0,14,0,0,1,0,0,0,0,0,2,1,0,0,2016,reg
Luke Mishu,DC United ,D,7,5,448,0,0,1,0,0,0,0,0,2,2,0,0,2016,reg
Yair Arboleda,Houston Dynamo,M,1,1,62,0,0,1,0,0,0,0,0,0,1,0,0,2016,reg
Tony Alfaro,FC Dallas,D,6,1,286,0,0,1,0,0,0,0,0,1,4,0,0,2016,reg
Emmanuel Appiah,Colorado Rapids,M,1,1,90,0,0,1,0,0,0,0,0,0,1,0,0,2016,reg
Timo Pitter,FC Dallas,M-F,1,0,9,0,0,1,0,0,0,0,0,1,0,0,0,2016,reg
Samba,New England Revolution ,D,2,1,91,0,0,1,1,0,0,0,0,1,1,0,0,2016,reg
Raheem Edwards,Minnesota United FC,M,1,0,2,0,0,1,1,0,0,0,0,0,0,0,0,2016,reg
Dylan Remick,FC Dallas,D,11,6,537,0,0,1,0,0,0,0,0,6,5,1,0,2016,reg
Donnie Smith,New England Revolution,M,3,2,213,0,0,1,1,0,0,0,0,1,3,0,0,2016,reg
Bradford Jamieson IV,LA Galaxy,F,3,0,39,0,0,1,1,0,0,0,0,2,0,0,0,2016,reg
Marco Bustos,Vancouver Whitecaps,M,3,1,63,0,0,1,0,0,0,0,0,2,0,0,0,2016,reg
Steve Neumann,New England Revolution ,M-F,4,1,62,0,0,1,1,0,0,0,0,0,1,0,0,2016,reg
Anderson Conceicao,Philadelphia Union,D,1,1,90,0,0,1,1,0,0,0,0,0,2,0,0,2016,reg
Maxime Chanot,New York City FC,D,6,5,495,0,0,1,0,0,0,0,0,6,2,2,1,2016,reg
Darrius Barnes,New England Revolution ,D,4,4,345,0,0,1,1,0,0,0,0,5,1,0,0,2016,reg
Russell Teibert,Vancouver Whitecaps,M,11,8,696,0,0,1,0,0,0,0,0,16,3,1,0,2016,reg
Conor Doyle,Colorado Rapids,F,3,0,23,0,0,1,0,0,0,0,0,3,0,2,0,2016,reg
David Rocha,Houston Dynamo,M,4,0,57,0,0,1,0,0,0,0,0,2,1,0,0,2016,reg
Damien Perrinelle,New York Red Bulls,D,10,7,726,0,0,1,0,0,0,0,0,9,6,2,0,2016,reg
Clarence Goodson,San Jose Earthquakes ,D,2,2,180,0,0,1,0,0,0,0,0,3,1,0,0,2016,reg
Justin Mapp,Sporting Kansas City,M,6,0,43,0,0,1,0,0,0,0,0,0,0,0,0,2016,reg
Marcel de Jong,Vancouver Whitecaps,D-M,7,5,467,0,0,2,1,0,0,0,0,9,2,1,0,2016,reg
Tyson Wahl,Columbus Crew SC,D,13,11,1014,0,0,2,0,0,0,0,0,14,7,2,1,2016,reg
Kofi Sarkodie,San Jose Earthquakes ,D,13,12,1043,0,0,2,1,0,0,0,0,11,10,0,0,2016,reg
Ashtone Morgan,Real Salt Lake,D,7,0,157,0,0,2,0,0,0,0,0,6,0,2,0,2016,reg
Jack McBean,LA Galaxy,F,2,1,99,0,0,2,0,0,0,0,0,2,4,0,0,2016,reg
Gaston Sauro,Columbus Crew SC,D,13,12,918,0,0,2,0,0,0,0,0,23,3,3,0,2016,reg
Jose Escalante,Houston Dynamo,M,3,1,109,0,0,2,1,0,0,0,0,1,2,0,0,2016,reg
Kianz Froese,Vancouver Whitecaps,M,5,1,150,0,0,2,0,0,0,0,0,3,2,1,0,2016,reg
Raul Mendiola,LA Galaxy,M,6,5,375,0,0,2,0,0,0,0,0,2,5,1,0,2016,reg
David Choiniere,Montreal Impact,M,1,1,76,0,0,2,1,0,0,0,0,1,0,0,0,2016,reg
Justin Bilyeu,New York Red Bulls,D,3,1,117,0,0,2,1,0,0,0,0,1,0,0,0,2016,reg
Deybi Flores,Vancouver Whitecaps,M,1,1,45,0,0,2,0,0,0,0,0,3,0,0,0,2016,reg
Eric Ayuk,Philadelphia Union,M,1,1,90,0,0,2,2,0,0,0,0,0,1,0,0,2016,reg
Alex Morrell,Chicago Fire FC,F,4,0,52,0,0,2,1,0,0,0,0,0,1,0,0,2016,reg
Ariel Lassiter,LA Galaxy,F,3,2,133,0,0,3,0,0,0,0,0,0,0,0,0,2016,reg
Anatole Abang,New York Red Bulls,F,8,2,221,0,0,3,0,0,0,0,0,4,2,0,0,2016,reg
Devon Sandoval,Real Salt Lake,F,12,2,228,0,0,3,0,0,0,0,0,4,4,0,0,2016,reg
Nick Hagglund,FC Cincinnati,D,16,8,847,0,0,3,1,0,0,0,0,13,6,0,0,2016,reg
A.J. DeLaGarza,,D,24,23,2064,0,0,3,1,0,0,0,0,21,21,5,0,2016,reg
Omer Damari,New York Red Bulls,F,4,0,79,0,0,3,0,0,0,0,0,3,2,0,0,2016,reg
Johan Kappelhof,Chicago Fire FC,D,33,31,2789,0,0,3,1,0,0,0,0,35,7,3,0,2016,reg
Chris Schuler,Real Salt Lake,D,4,3,271,0,0,3,0,0,0,0,0,5,4,0,0,2016,reg
Pa-Modou Kah,Vancouver Whitecaps,D,5,4,395,0,0,3,1,0,0,0,0,8,1,3,0,2016,reg
José Gonçalves,New England Revolution ,D,28,28,2519,0,0,3,0,0,0,0,0,41,22,3,0,2016,reg
Shaun Wright-Phillips,New York Red Bulls,M,7,1,121,0,0,3,1,0,0,0,0,3,2,0,0,2016,reg
David Edgar,Vancouver Whitecaps,D,8,8,720,0,0,4,1,0,0,0,0,7,1,2,0,2016,reg
Kevin Alston,Orlando City SC,D,24,21,1989,0,0,4,1,0,0,0,0,23,16,3,0,2016,reg
Zach Scott,FC Dallas,D,14,9,886,0,0,4,1,0,0,0,0,7,13,2,0,2016,reg
Andres Imperiale,San Jose Earthquakes ,D,11,10,869,0,0,4,1,0,0,0,0,9,5,2,0,2016,reg
Karl Ouimette,New York Red Bulls,D,7,6,582,0,0,4,0,0,0,0,0,3,6,0,0,2016,reg
Pedro Ribeiro,Orlando City SC,M-F,3,1,152,0,0,4,2,0,0,0,0,6,3,1,0,2016,reg
Tony Rocha,New York City FC,M,8,2,298,0,0,4,0,0,0,0,0,7,3,1,0,2016,reg
Getterson,FC Dallas,F,4,2,152,0,0,4,2,0,0,0,0,2,1,0,0,2016,reg
Omar Holness,Real Salt Lake,M,9,3,277,0,0,5,0,0,0,0,0,6,5,1,0,2016,reg
Caleb Calvert,Colorado Rapids,F,8,1,165,0,0,5,4,0,0,0,0,4,1,1,0,2016,reg
Wandrille Lefevre,Montreal Impact,D,13,12,1114,0,0,5,2,0,0,0,0,15,6,1,0,2016,reg
Fraser Aird,Vancouver Whitecaps,D-M,18,16,1455,0,0,5,1,0,0,0,0,23,6,4,1,2016,reg
Carlos Lizarazo,FC Dallas,M-F,8,2,161,0,0,5,1,0,0,0,0,3,2,0,0,2016,reg
Aaron Maund,Real Salt Lake,D,20,20,1746,0,0,5,1,0,0,0,0,24,13,4,0,2016,reg
Seth Sinovic,New England Revolution,D,9,6,532,0,0,5,1,0,0,0,0,7,5,2,0,2016,reg
Innocent Emeghara,San Jose Earthquakes ,F,6,1,115,0,0,5,1,0,0,0,0,1,3,0,0,2016,reg
Jordan Smith,Vancouver Whitecaps,D,17,15,1267,0,0,5,0,0,0,0,0,18,4,2,1,2016,reg
Chris Wingert,Real Salt Lake,D,20,18,1514,0,0,5,0,0,0,0,0,14,10,5,0,2016,reg
Abdoulie Mansally,Houston Dynamo,D,9,5,565,0,0,5,1,0,0,0,0,9,8,1,1,2016,reg
Roman Torres,,D,9,8,765,0,0,6,1,0,0,0,0,5,5,1,0,2016,reg
Calum Mallace,Montreal Impact,M,18,10,862,0,0,6,0,0,0,0,0,11,8,3,1,2016,reg
Shaun Francis,San Jose Earthquakes ,D,18,17,1524,0,0,6,2,0,0,0,0,25,8,4,0,2016,reg
Kofi Opare,DC United,D,10,10,874,0,0,6,2,0,0,0,0,17,8,2,2,2016,reg
Kemar Lawrence,New York Red Bulls,D,21,21,1801,0,0,6,1,0,0,0,0,26,13,3,0,2016,reg
Daniel Lovitz,Nashville SC,D,12,5,406,0,0,6,0,0,0,0,0,11,8,1,0,2016,reg
Alphonso Davies,Vancouver Whitecaps,M,8,2,299,0,0,7,2,0,0,0,0,10,10,0,0,2016,reg
Jared Watts,Colorado Rapids,D-M,21,18,1647,0,0,8,1,0,0,0,0,18,11,5,0,2016,reg
Soni Mustivar,Sporting Kansas City,M,25,24,2095,0,0,8,0,0,0,0,0,30,15,3,1,2016,reg
Agus,Houston Dynamo,D,8,8,672,0,0,8,3,0,0,0,0,13,4,0,0,2016,reg
David Mateos,Orlando City SC,D,21,20,1759,0,0,9,2,0,0,0,0,26,14,8,1,2016,reg
David Arshakyan,Chicago Fire FC,F,9,3,324,0,0,9,2,0,0,0,0,2,3,0,0,2016,reg
Oalex Anderson,FC Dallas,F,15,2,334,0,0,9,4,0,0,0,0,7,14,0,0,2016,reg
Jose Aja,Minnesota United FC,D,10,9,830,0,0,9,1,0,0,0,0,16,10,4,0,2016,reg
Matias Laba,Vancouver Whitecaps,M,32,32,2729,0,0,10,4,0,0,0,0,71,20,5,1,2016,reg
Ned Grabavoy,Portland Timbers,M,22,5,632,0,0,10,2,0,0,0,0,12,20,3,0,2016,reg
Antonio Nocerino,Orlando City SC,M,21,19,1509,0,0,11,2,0,0,0,0,27,18,3,1,2016,reg
Tim Parker,New York Red Bulls,D,29,28,2551,0,0,12,3,0,0,0,0,22,17,1,0,2016,reg
Tommy Thompson,San Jose Earthquakes,D,17,9,825,0,0,12,5,0,0,0,0,10,14,2,0,2016,reg
Hérculez Gómez,FC Dallas,F,21,9,842,0,0,14,7,0,0,0,0,16,18,1,0,2016,reg
Nigel de Jong,LA Galaxy,M,18,18,1561,0,0,16,5,0,0,0,0,20,28,3,1,2016,reg
Laurent Ciman,Toronto FC,D,28,28,2484,0,0,18,3,0,0,0,0,24,16,3,0,2016,reg
Nemanja Nikolic,Chicago Fire FC,F,34,34,2946,24,4,118,59,19,5,2,2,11,22,1,0,2017,reg
David Villa,New York City FC,F,31,28,2556,22,9,136,55,15,7,8,1,30,68,4,0,2017,reg
Diego Valeri,Portland Timbers,M,32,32,2828,21,11,93,39,13,8,7,4,19,42,4,0,2017,reg
Josef Martinez,Atlanta United FC,F,20,17,1528,19,1,67,32,16,3,0,1,19,18,4,0,2017,reg
Ola Kamara,DC United,F,34,33,2867,18,3,89,39,10,8,2,1,29,43,0,0,2017,reg
Ignacio Piatti,Montreal Impact,M,28,26,2368,17,6,75,38,11,6,2,4,40,59,3,0,2017,reg
Bradley Wright-Phillips,LAFC,F,32,29,2560,17,1,83,36,7,10,0,1,54,42,5,0,2017,reg
Sebastian Giovinco,Toronto FC,F,25,25,2057,16,6,128,52,10,6,5,1,30,54,4,0,2017,reg
CJ Sapong,Chicago Fire FC,F,33,30,2794,16,5,67,34,13,3,4,1,50,87,3,0,2017,reg
Jozy Altidore,Toronto FC,F,27,25,2194,15,6,68,30,8,7,4,2,50,49,8,0,2017,reg
David Accam,Nashville SC,F,30,24,2177,14,8,66,36,8,6,6,2,44,47,2,0,2017,reg
Christian Ramirez,Houston Dynamo,F,30,27,2392,14,3,60,34,8,6,2,1,18,33,1,0,2017,reg
Erick Torres,Houston Dynamo,F,27,23,2001,14,3,72,26,9,5,2,1,32,41,6,0,2017,reg
Romain Alessandrini,LA Galaxy,M,30,27,2441,13,12,95,41,5,8,5,7,46,70,8,0,2017,reg
Hector Villalba,Atlanta United FC,F,34,34,2762,13,11,86,44,7,6,9,2,39,18,4,0,2017,reg
Chris Wondolowski,San Jose Earthquakes,F,34,34,3041,13,8,79,28,11,2,6,2,19,28,3,0,2017,reg
Justin Meram,Real Salt Lake,M,34,32,2588,13,7,61,28,10,3,4,3,27,44,6,0,2017,reg
Fredy Montero,Vancouver Whitecaps,F,33,26,2469,13,6,86,35,9,4,5,1,45,47,6,0,2017,reg
Kei Kamara,Colorado Rapids,F,31,27,2365,12,5,88,35,10,2,4,1,31,32,4,0,2017,reg
Maximiliano Urruti,Montreal Impact,F,32,31,2749,12,5,103,39,7,5,4,1,43,52,1,0,2017,reg
Clint Dempsey,FC Dallas,M-F,29,25,2276,12,5,116,39,4,8,2,3,18,52,3,1,2017,reg
Daniel Royer,New York Red Bulls,M,26,23,1868,12,3,52,22,8,4,1,2,22,45,5,0,2017,reg
Cyle Larin,Orlando City SC,F,28,24,2169,12,3,55,32,7,5,1,2,45,54,1,0,2017,reg
Lee Nguyen,,M,31,30,2542,11,15,49,23,7,4,12,3,25,52,3,0,2017,reg
Roland Lamah,FC Dallas,M,32,29,2157,11,3,44,23,10,1,0,3,24,37,2,0,2017,reg
Will Bruin,FC Dallas,F,31,20,1824,11,2,52,20,7,4,1,1,24,19,1,0,2017,reg
Jack Harrison,New York City FC,F,34,33,2757,10,6,65,31,4,6,4,2,29,30,3,1,2017,reg
Mauro Manotas,Houston Dynamo,F,33,24,2063,10,5,71,35,7,3,4,1,21,27,3,0,2017,reg
Alberth Elis,Houston Dynamo,F,26,18,1645,10,4,71,28,9,1,3,1,36,37,8,0,2017,reg
Fanendo Adi,Columbus Crew SC,F,22,22,1885,10,3,66,28,7,3,2,1,44,41,2,1,2017,reg
Federico Higuain,DC United,F,26,26,2238,9,14,52,24,6,3,11,3,24,35,3,0,2017,reg
Miguel Almiron ,Atlanta United FC,M,30,27,2394,9,14,84,35,7,2,10,4,36,46,4,0,2017,reg
Dominique Badji,Nashville SC,F,33,29,2540,9,6,56,28,6,3,6,0,50,41,5,0,2017,reg
Dom Dwyer,Orlando City SC,F,27,25,2246,9,5,74,36,5,4,3,2,47,65,5,0,2017,reg
Anthony Jackson-Hamel,Montreal Impact,F,21,11,1137,9,4,32,14,4,5,3,1,13,11,0,0,2017,reg
Victor Vazquez,Toronto FC,M,31,28,2382,8,16,41,20,5,3,9,7,23,26,3,0,2017,reg
Sebastian Blanco,Portland Timbers,M-F,33,32,2783,8,8,86,32,3,5,5,3,59,41,6,1,2017,reg
Abu Danladi,Nashville SC,F,27,15,1391,8,3,37,13,4,4,2,1,30,26,4,1,2017,reg
Gerso Fernandes,Sporting Kansas City,F,32,26,2238,8,2,62,25,8,0,1,1,32,40,4,0,2017,reg
Justin Morrow,Toronto FC,D,28,28,2479,8,1,26,12,7,1,1,0,21,18,0,0,2017,reg
Juan Agudelo,,F,28,20,1821,8,1,36,17,6,2,1,0,41,28,3,0,2017,reg
Albert Rusnak,Real Salt Lake,M,30,29,2579,7,14,85,30,5,2,10,4,28,25,2,0,2017,reg
Yamil Asad,DC United,M,32,31,2765,7,13,53,23,5,2,10,3,53,95,7,1,2017,reg
Nicolás Lodeiro,FC Dallas,M,33,33,2965,7,12,67,19,4,3,8,4,37,110,5,1,2017,reg
Blerim Dzemaili,Montreal Impact,M,22,22,1941,7,10,66,17,4,3,7,3,30,60,8,0,2017,reg
Kevin Molino,Minnesota United FC,M,30,30,2512,7,9,46,16,2,5,7,2,44,70,5,0,2017,reg
Diego Fagundez,New England Revolution,M,32,27,2435,7,8,72,35,6,1,6,2,20,16,2,0,2017,reg
Joao Plata,Real Salt Lake,F,29,27,2318,7,5,95,30,3,4,4,1,11,34,1,0,2017,reg
Luis Solignac,Chicago Fire FC,F,33,26,2153,7,4,45,15,4,3,1,3,34,31,1,0,2017,reg
Romell Quioto,Montreal Impact,M,22,14,1281,7,3,44,15,5,2,2,1,16,15,4,0,2017,reg
Fafa Picault,FC Dallas,M,28,23,1894,7,3,46,22,4,3,2,1,11,27,1,0,2017,reg
Luis Silva,Real Salt Lake,F,30,20,1775,7,3,58,20,5,2,2,1,25,26,5,0,2017,reg
Tosaint Ricketts,Vancouver Whitecaps,F,22,9,1003,7,1,31,15,3,4,0,1,8,13,0,0,2017,reg
Roland Alberg,Philadelphia Union,M,24,9,871,7,1,31,13,5,2,1,0,18,24,3,0,2017,reg
Teal Bunbury,New England Revolution,F,28,13,1279,7,1,46,22,5,2,1,0,21,22,1,0,2017,reg
Yura Movsisyan,Real Salt Lake,F,28,16,1416,7,0,45,19,4,3,0,0,19,16,4,0,2017,reg
Cristian Techera,Vancouver Whitecaps,M,29,24,2043,6,7,56,17,4,2,5,2,21,40,1,0,2017,reg
Kaká,Orlando City SC,M,23,18,1564,6,5,31,10,4,2,2,3,20,22,6,1,2017,reg
Ilsinho,Philadelphia Union,M,27,24,1848,6,5,38,11,6,0,5,0,33,14,4,0,2017,reg
Jefferson Savarino,Real Salt Lake,F,22,19,1673,6,5,57,25,4,2,3,2,13,46,0,0,2017,reg
Yordy Reyna,Vancouver Whitecaps,M-F,18,11,1073,6,4,26,11,6,0,3,1,24,41,3,0,2017,reg
Gonzalo Verón,New York Red Bulls,M-F,24,5,777,6,3,28,13,2,4,1,2,16,28,1,0,2017,reg
Cristian Roldan,FC Dallas,M,33,33,2960,6,3,40,17,5,1,2,1,34,66,3,0,2017,reg
Giovani dos Santos,LA Galaxy,M,25,25,2189,6,3,59,17,2,4,1,2,14,21,3,0,2017,reg
Diego Rubio,Colorado Rapids,F,16,11,1010,6,2,37,14,5,1,2,0,22,28,2,0,2017,reg
Matteo Mancosu,Montreal Impact,F,26,20,1745,6,2,49,20,3,3,1,1,14,13,5,0,2017,reg
Julian Gressel,DC United,M,32,24,2048,5,9,35,9,3,2,6,3,30,16,4,0,2017,reg
Maximiliano Moralez,New York City FC,M,29,28,2523,5,9,44,17,4,1,6,3,31,81,8,0,2017,reg
Luciano Acosta,DC United,M-F,31,30,2419,5,5,46,24,4,1,2,3,44,56,4,2,2017,reg
Danny Hoesen,San Jose Earthquakes,F,32,20,1838,5,5,70,24,5,0,4,1,22,34,1,0,2017,reg
Carlos Rivas,Orlando City SC,F,30,21,1960,5,5,76,19,3,2,3,2,40,38,3,0,2017,reg
Kevin Doyle,Colorado Rapids,F,25,23,1966,5,4,54,18,4,1,3,1,34,20,5,0,2017,reg
Marco Ureña,San Jose Earthquakes,F,25,22,1766,5,3,49,24,3,2,2,1,20,17,3,0,2017,reg
Benny Feilhaber,Sporting Kansas City ,M,30,24,2269,5,3,64,20,4,1,2,1,35,48,4,0,2017,reg
Vako,San Jose Earthquakes,M,13,8,784,5,2,38,14,2,3,2,0,6,15,0,0,2017,reg
Patrick Mullins,Toronto FC,F,20,12,1075,5,0,38,14,4,1,0,0,28,23,1,0,2017,reg
Rodney Wallace,New York City FC,D,26,23,1935,4,6,52,19,3,1,4,2,46,23,6,0,2017,reg
Ethan Finlay,Minnesota United FC,M,30,25,2262,4,4,38,11,3,1,1,3,33,35,3,0,2017,reg
Kekuta Manneh,FC Cincinnati,F,22,11,974,4,3,29,12,2,2,2,1,3,19,0,0,2017,reg
Brek Shea,,D,25,14,1325,4,2,22,8,1,3,2,0,13,23,2,1,2017,reg
Emmanuel Boateng,DC United,M,34,29,2321,4,2,28,13,2,2,1,1,16,19,0,0,2017,reg
Darren Mattocks,Portland Timbers,F,24,11,1075,4,2,31,14,4,0,1,1,12,18,1,0,2017,reg
Kendall Waston,FC Cincinnati,D,25,25,2250,4,1,19,7,3,1,1,0,37,9,7,0,2017,reg
Tony Tchani,Columbus Crew SC,M,27,26,2121,4,1,21,9,1,3,0,1,44,15,5,2,2017,reg
Tesho Akindele,Orlando City SC,F-M,29,15,1511,4,0,21,11,3,1,0,0,22,11,3,1,2017,reg
Kyle Beckerman,Real Salt Lake,M,26,26,2242,4,0,33,13,0,4,0,0,40,27,9,2,2017,reg
Michael Barrios,FC Dallas,M,34,28,2566,3,14,60,18,2,1,12,2,29,27,5,0,2017,reg
Michael de Leeuw,Chicago Fire FC,F,30,26,2189,3,8,37,13,2,1,5,3,48,35,5,0,2017,reg
Bastian Schweinsteiger,Chicago Fire FC,M,24,23,1993,3,6,25,5,2,1,6,0,25,43,5,0,2017,reg
Marky Delgado,Toronto FC,M,26,25,2072,3,5,18,4,1,2,4,1,20,23,1,1,2017,reg
Darlington Nagbe,Columbus Crew SC,M,27,27,2332,3,5,42,10,2,1,3,2,10,44,3,0,2017,reg
Jahmir Hyka,San Jose Earthquakes,M,30,21,1871,3,5,45,12,2,1,3,2,6,17,0,0,2017,reg
Marlon Hairston,Minnesota United FC,M,34,29,2605,3,4,15,7,3,0,4,0,26,40,2,0,2017,reg
Brooks Lennon,Atlanta United FC,D,25,15,1525,3,4,21,9,2,1,3,1,17,11,2,0,2017,reg
Miguel Ibarra ,FC Dallas,M,29,20,1758,3,4,22,12,3,0,3,1,16,12,2,0,2017,reg
Alan Gordon,Colorado Rapids,F,26,6,816,3,4,23,9,3,0,3,1,23,13,5,1,2017,reg
Alex Muyl,New York Red Bulls,M,30,21,1938,3,4,36,14,2,1,2,2,36,40,4,0,2017,reg
Luke Mulholland,Real Salt Lake,M,27,22,1949,3,4,44,8,2,1,2,2,35,31,4,0,2017,reg
Michael Salazar,Houston Dynamo,F,17,7,690,3,3,10,7,2,1,3,0,16,11,1,0,2017,reg
Erik Hurtado,Sporting Kansas City,F,15,7,523,3,2,10,5,1,2,0,2,12,9,0,0,2017,reg
Thomas McNamara,Houston Dynamo,M,27,19,1574,3,2,23,11,1,2,1,1,18,28,5,0,2017,reg
Arturo Alvarez,Chicago Fire FC,M,25,13,1084,3,2,27,11,2,1,1,1,17,28,2,0,2017,reg
Daniel Salloi,Sporting Kansas City,F,22,12,1172,3,2,42,19,3,0,2,0,11,18,1,0,2017,reg
Kellyn Acosta,Colorado Rapids,M,23,20,1895,3,2,49,15,1,2,1,1,24,27,2,0,2017,reg
Giles Barnes,Orlando City SC,M,34,23,2137,3,2,52,16,2,1,2,0,25,45,0,0,2017,reg
Bradford Jamieson IV,LA Galaxy,F,24,11,984,3,1,8,3,2,1,1,0,25,12,2,0,2017,reg
Nicolas Hasler,Toronto FC,D,10,9,752,3,1,9,4,1,2,0,1,7,4,1,0,2017,reg
Maynor Figueroa,Houston Dynamo,D,26,26,2325,3,1,34,6,3,0,1,0,20,21,8,0,2017,reg
Jordan Morris,FC Dallas,F,23,22,1801,3,1,34,14,1,2,1,0,15,12,0,0,2017,reg
Latif Blessing,LAFC,F,25,16,1419,3,1,37,15,1,2,0,1,31,37,3,0,2017,reg
Josh Williams,Columbus Crew SC,D,22,19,1795,3,0,6,3,2,1,0,0,9,10,4,0,2017,reg
Liam Ridgewell,Portland Timbers,D,15,15,1270,3,0,7,3,3,0,0,0,15,23,4,0,2017,reg
Jacob Peterson,Atlanta United FC,F,10,1,165,3,0,7,3,1,2,0,0,1,2,0,0,2017,reg
Daniel Steres ,LA Galaxy,D,21,21,1843,3,0,16,5,1,2,0,0,18,4,1,0,2017,reg
Ike Opara,Minnesota United FC,D,30,30,2700,3,0,17,5,1,2,0,0,23,14,3,0,2017,reg
Lamar Neagle,DC United,M,30,9,1204,3,0,31,15,2,1,0,0,22,19,6,0,2017,reg
Sacha Kljestan,LA Galaxy,M,32,28,2582,2,17,41,11,1,1,10,7,38,40,6,0,2017,reg
Haris Medunjanin,FC Cincinnati,M,34,34,3057,2,12,36,10,1,1,9,3,12,3,4,0,2017,reg
Alex,Houston Dynamo,M,32,28,2309,2,11,40,14,2,0,8,3,35,55,5,1,2017,reg
Mauro Diaz,FC Dallas,M,19,13,1107,2,8,21,9,2,0,7,1,8,38,0,0,2017,reg
Lloyd Sam,DC United,M-F,30,23,2025,2,6,25,11,1,1,4,2,17,25,5,1,2017,reg
Chris Pontius,Philadelphia Union,M,30,27,2253,2,6,43,17,2,0,5,1,25,43,0,0,2017,reg
Greg Garza,FC Cincinnati,D,26,25,2150,2,5,12,5,1,1,2,3,23,34,2,0,2017,reg
Brandon Vincent,Chicago Fire FC,D,27,26,2341,2,5,18,4,1,1,5,0,34,16,3,0,2017,reg
Vicente Sanchez,Houston Dynamo,F,21,3,517,2,5,21,7,1,1,4,1,10,16,0,0,2017,reg
Johan Venegas,Minnesota United FC,M,22,12,1226,2,5,32,10,1,1,3,2,29,26,4,0,2017,reg
Felipe,DC United,M,33,33,2961,2,5,37,12,2,0,2,3,58,87,5,0,2017,reg
Tyler Adams,New York Red Bulls,M,24,22,1994,2,4,12,7,2,0,2,2,34,33,2,0,2017,reg
Jonathan Osorio,Toronto FC,M,27,9,1060,2,4,16,6,2,0,2,2,7,23,1,0,2017,reg
Patrice Bernier,Montreal Impact,M,27,20,1801,2,4,21,5,2,0,2,2,29,17,1,0,2017,reg
Sean Davis,New York Red Bulls,M,27,21,1795,2,4,28,10,2,0,1,3,29,22,5,0,2017,reg
Dairon Asprilla,Portland Timbers,M-F,27,17,1395,2,4,36,7,1,1,2,2,39,24,1,0,2017,reg
Alejandro Bedoya,Philadelphia Union,M,28,28,2509,2,4,36,10,1,1,3,1,66,17,6,0,2017,reg
Jerome Thiesson,Minnesota United FC,D,33,33,2955,2,3,10,4,1,1,0,3,26,20,6,0,2017,reg
Florian Jungwirth,San Jose Earthquakes,D,30,30,2600,2,3,13,3,0,2,3,0,26,23,4,0,2017,reg
Alvas Powell,,D,23,19,1690,2,3,13,6,2,0,0,3,17,7,3,0,2017,reg
Josh Gatt,Colorado Rapids,M-F,20,11,1067,2,3,17,6,1,1,3,0,25,10,3,0,2017,reg
Will Johnson,Orlando City SC,D,26,23,2057,2,3,32,13,1,1,3,0,16,26,6,0,2017,reg
Carlos Carmona,Atlanta United FC,M,31,30,2684,2,2,9,2,1,1,2,0,55,22,8,1,2017,reg
Atiba Harris,FC Dallas,D,29,21,2020,2,2,10,2,1,1,2,0,35,23,7,0,2017,reg
Andrew Jacobson,Vancouver Whitecaps,M,21,19,1704,2,2,13,3,1,1,1,1,25,21,2,0,2017,reg
Andrew Wenger,Houston Dynamo,D-M,22,12,1110,2,2,21,9,1,1,1,1,6,11,2,0,2017,reg
Ballou Jean-Yves Tabla,Montreal Impact,F,21,11,1146,2,2,26,10,0,2,2,0,26,24,4,0,2017,reg
Gyasi Zardes,Columbus Crew SC,F,24,23,1987,2,2,29,10,1,1,2,0,22,32,3,0,2017,reg
Jordan Hamilton,Columbus Crew SC,F,8,0,142,2,1,5,3,2,0,1,0,2,4,0,0,2017,reg
Jonathan Lewis,Colorado Rapids,F,11,4,342,2,1,9,5,1,1,1,0,10,4,0,0,2017,reg
Jack McBean,LA Galaxy,F,18,8,715,2,1,9,4,0,2,0,1,17,21,4,0,2017,reg
Stefan Aigner,Colorado Rapids,M-F,9,5,488,2,1,9,3,2,0,0,1,12,12,2,0,2017,reg
Memo Rodriguez,Houston Dynamo,M,9,3,326,2,1,11,6,1,1,1,0,6,7,0,0,2017,reg
Drew Moor,Colorado Rapids,D,25,24,2176,2,1,12,3,1,1,0,1,10,24,1,0,2017,reg
Nicolas Mezquida,Colorado Rapids,F-M,20,8,686,2,1,12,4,0,2,0,1,14,19,1,0,2017,reg
Leonardo,Houston Dynamo,D,30,29,2616,2,1,13,2,2,0,1,0,38,6,3,0,2017,reg
Matias Laba,Vancouver Whitecaps,M,19,19,1612,2,1,15,5,2,0,0,1,33,9,6,1,2017,reg
Harry Shipp,FC Dallas,M,18,11,927,2,1,15,4,2,0,1,0,6,11,1,0,2017,reg
Marcus Epps,Philadelphia Union,M,19,7,709,2,1,16,5,2,0,1,0,3,3,0,0,2017,reg
Victor Rodriguez,FC Dallas,M,7,5,484,2,1,17,7,2,0,1,0,2,11,0,0,2017,reg
Marco Donadel,Montreal Impact,M,19,18,1424,2,1,19,4,1,1,0,1,38,7,3,1,2017,reg
Dave Romney,Nashville SC,D,29,23,2249,2,1,19,9,1,1,1,0,10,4,0,0,2017,reg
Nick Lima,San Jose Earthquakes,D,22,20,1809,2,1,20,6,2,0,0,1,6,27,2,1,2017,reg
Anibal Godoy,Nashville SC,M-D,26,24,2134,2,1,20,4,2,0,0,1,61,71,10,1,2017,reg
Jonathan Mensah,Columbus Crew SC,D,26,25,2169,2,1,20,5,2,0,0,1,33,5,7,2,2017,reg
Francisco Calvo ,Chicago Fire FC,D,27,27,2430,2,1,22,6,1,1,0,1,28,12,5,0,2017,reg
Deshorn Brown,DC United,F,16,10,788,2,1,22,10,0,2,1,0,7,10,1,0,2017,reg
Ian Harkes,DC United,M,25,22,1948,2,1,25,7,0,2,1,0,25,26,2,0,2017,reg
Shkelzen Gashi,Colorado Rapids,M-F,17,12,1034,2,1,26,9,2,0,1,0,20,6,1,0,2017,reg
Kofi Opare,DC United,D,26,25,2214,2,1,32,8,2,0,1,0,12,12,2,0,2017,reg
Cristian Colman,FC Dallas,F,26,10,959,2,1,40,15,0,2,0,1,14,14,1,0,2017,reg
Jimmy Medranda ,Nashville SC,D,33,24,2086,2,1,49,10,1,1,0,1,19,20,2,0,2017,reg
Anton Walkes,Atlanta United FC,D,20,17,1528,2,0,7,4,2,0,0,0,11,2,2,0,2017,reg
Sébastien Le Toux,DC United ,F,16,8,732,2,0,9,4,0,2,0,0,6,6,1,0,2017,reg
Brent Kallman,Minnesota United FC,D,23,23,1942,2,0,10,4,1,1,0,0,22,17,7,0,2017,reg
Kenwyne Jones,Atlanta United FC,F,17,5,499,2,0,11,4,1,1,0,0,4,9,0,0,2017,reg
Alexander Callens,New York City FC,D,34,34,3060,2,0,15,3,2,0,0,0,27,29,4,0,2017,reg
Maxime Chanot,New York City FC,D,19,19,1710,2,0,16,3,1,1,0,0,17,17,3,0,2017,reg
Michael Amir Murillo,New York Red Bulls,D,17,15,1316,2,0,17,7,1,1,0,0,17,20,3,0,2017,reg
Tomas Martinez,Houston Dynamo,M,9,5,501,2,0,18,5,2,0,0,0,5,13,2,0,2017,reg
Matt Hedges,FC Dallas,D,27,27,2425,2,0,25,9,1,1,0,0,21,18,7,0,2017,reg
Joevin Jones,FC Dallas,D-M,30,28,2451,1,11,27,6,0,1,8,3,14,34,4,1,2017,reg
Matt Polster,New England Revolution,D,22,21,1769,1,7,9,3,1,0,4,3,24,21,3,0,2017,reg
Kelyn Rowe,New England Revolution,M,23,21,1897,1,7,34,10,0,1,5,2,31,38,3,0,2017,reg
Raheem Edwards,Minnesota United FC,M,21,10,1058,1,6,11,4,1,0,3,3,20,14,1,0,2017,reg
Ben Sweat,,D,26,25,2176,1,6,17,4,0,1,2,4,28,11,3,0,2017,reg
David Guzman,Portland Timbers,M,25,24,2028,1,6,42,9,1,0,5,1,61,37,11,0,2017,reg
Chris Tierney,New England Revolution,D-M,26,20,1713,1,5,8,2,1,0,5,0,9,9,3,0,2017,reg
Scott Caldwell,New England Revolution,M,33,26,2195,1,5,11,2,1,0,5,0,42,42,2,0,2017,reg
Kemar Lawrence,New York Red Bulls,D,24,23,2076,1,5,17,4,1,0,4,1,25,17,7,0,2017,reg
Hernan Grana,FC Dallas,D,30,30,2660,1,4,8,2,1,0,4,0,24,13,8,0,2017,reg
Yoshi Yotun,Orlando City SC,M,10,10,887,1,4,16,4,1,0,3,1,13,33,2,0,2017,reg
Gustav Svensson,FC Dallas,M,32,30,2645,1,4,17,4,1,0,3,1,28,17,1,0,2017,reg
Scott Sutter,Orlando City SC,D,32,30,2729,1,4,17,3,0,1,2,2,15,36,1,0,2017,reg
Mohammed Saeid,Colorado Rapids,M,32,30,2512,1,4,18,4,0,1,4,0,20,45,2,0,2017,reg
Jermaine Jones,LA Galaxy,M,20,19,1588,1,4,21,5,1,0,2,2,28,31,8,1,2017,reg
Tommy Thompson,San Jose Earthquakes,D,32,16,1534,1,4,42,12,0,1,4,0,16,40,1,0,2017,reg
Diego Chara,Portland Timbers,M,29,29,2530,1,3,5,2,0,1,2,1,57,48,8,1,2017,reg
Shea Salinas,San Jose Earthquakes,M,25,15,1435,1,3,6,1,1,0,2,1,19,15,3,0,2017,reg
Jeremy Ebobisse,Portland Timbers,F,14,2,317,1,3,6,2,0,1,1,2,6,4,0,0,2017,reg
Leandro Gonzalez Pirez,,D,32,32,2811,1,3,16,6,1,0,2,1,46,42,10,1,2017,reg
Osvaldo Alonso,Minnesota United FC,M,26,24,2073,1,3,24,6,1,0,2,1,42,41,4,0,2017,reg
Roger Espinoza,Sporting Kansas City,M,30,30,2677,1,3,48,10,0,1,3,0,48,43,9,1,2017,reg
Javier Morales,FC Dallas,M,15,8,757,1,2,7,3,1,0,0,2,14,7,1,0,2017,reg
Niko Hansen,Houston Dynamo,F,14,3,401,1,2,7,2,1,0,1,1,3,5,0,0,2017,reg
Fabian Herbers,Chicago Fire FC,F,12,4,395,1,2,8,2,0,1,2,0,6,7,1,0,2017,reg
Ashley Cole,LA Galaxy,D,29,29,2499,1,2,8,2,1,0,0,2,23,30,1,1,2017,reg
Djordje Mihailovic,Chicago Fire FC,M,17,7,732,1,2,8,1,0,1,0,2,11,15,0,0,2017,reg
Chris Duvall,Portland Timbers,D,27,25,2210,1,2,11,4,1,0,1,1,26,29,5,1,2017,reg
Chad Marshall,FC Dallas,D,28,27,2366,1,2,15,4,1,0,1,1,12,15,2,0,2017,reg
Kelvin Leerdam,FC Dallas,D,15,14,1290,1,2,16,2,1,0,2,0,16,11,2,0,2017,reg
Matías Pérez García,Orlando City SC,F,15,11,971,1,2,17,5,1,0,2,0,16,36,3,0,2017,reg
Seth Sinovic,New England Revolution,D,32,32,2857,1,2,17,5,1,0,2,0,20,18,6,0,2017,reg
Bernie Ibini,Vancouver Whitecaps,M-F,17,7,629,1,2,18,5,0,1,2,0,5,13,0,0,2017,reg
Patrick Nyarko,DC United,F-M,14,12,1028,1,2,18,7,1,0,0,2,10,29,0,0,2017,reg
Paul Arriola,DC United,M-F,11,11,922,1,2,19,7,1,0,2,0,15,19,2,0,2017,reg
Yangel Herrera,New York City FC,M,18,14,1223,1,2,20,7,0,1,0,2,44,38,7,1,2017,reg
Juninho,Chicago Fire FC,M,21,17,1528,1,2,26,9,1,0,1,1,16,14,3,1,2017,reg
Joao Pedro,LA Galaxy,M,28,26,2306,1,2,28,5,0,1,0,2,40,25,7,0,2017,reg
Tyrone Mears,Atlanta United FC,D,20,16,1498,1,1,2,1,0,1,1,0,19,7,2,0,2017,reg
Xavier Kouassi,New England Revolution,M,23,14,1218,1,1,5,1,0,1,0,1,27,21,3,2,2017,reg
Jonathan Spector,Orlando City SC,D,25,25,2176,1,1,6,3,1,0,1,0,29,14,5,1,2017,reg
Jack Elliott,Philadelphia Union,D,30,29,2621,1,1,7,3,0,1,1,0,27,12,4,0,2017,reg
Jordan Harvey,LAFC,D,28,28,2509,1,1,8,4,1,0,0,1,37,22,3,0,2017,reg
Tony Beltran,Real Salt Lake,D,21,21,1820,1,1,8,4,0,1,0,1,28,27,3,0,2017,reg
Collen Warner,Colorado Rapids,M,25,12,1283,1,1,8,1,0,1,0,1,27,17,6,0,2017,reg
Kevin Kratz,Atlanta United FC,M,20,5,590,1,1,8,2,1,0,1,0,5,11,1,0,2017,reg
Adam Jahn,Atlanta United FC,F,21,1,316,1,1,8,5,0,1,1,0,14,2,3,0,2017,reg
Walker Zimmerman,Nashville SC,D,22,18,1602,1,1,9,3,0,1,1,0,20,9,0,0,2017,reg
Brandon Vazquez,FC Cincinnati,F,13,0,178,1,1,10,2,0,1,1,0,4,5,1,1,2017,reg
Ambroise Oyongo,Montreal Impact,D,11,11,990,1,1,10,3,1,0,0,1,12,14,0,0,2017,reg
Saad Abdul-Salaam,FC Cincinnati,D,12,10,902,1,1,10,3,1,0,0,1,12,10,1,0,2017,reg
Krisztian Nemeth,New England Revolution,F,6,3,177,1,1,10,3,0,1,1,0,3,1,0,1,2017,reg
Roy Miller,Portland Timbers,D,26,26,2268,1,1,11,2,0,1,1,0,25,9,8,0,2017,reg
Jonathan dos Santos,LA Galaxy,M,12,11,1004,1,1,11,2,1,0,0,1,7,10,4,0,2017,reg
Caleb Calvert,Colorado Rapids,F,12,3,378,1,1,11,2,0,1,1,0,10,1,2,1,2017,reg
Antonio Mlinar Delamea,New England Revolution,D,29,29,2547,1,1,12,2,1,0,1,0,38,28,6,1,2017,reg
Zoltan Stieber,DC United,M-F,8,6,526,1,1,13,7,0,1,0,1,5,2,1,0,2017,reg
Jared Jeffrey,DC United,M,23,19,1617,1,1,13,6,0,1,1,0,47,9,4,0,2017,reg
Jeff Larentowicz,Atlanta United FC,M,33,30,2602,1,1,15,4,1,0,0,1,41,31,6,0,2017,reg
Frederic Brillant,DC United,D,23,16,1523,1,1,15,5,1,0,1,0,10,7,3,0,2017,reg
Jelle Van Damme,LA Galaxy,D,18,18,1503,1,1,16,1,0,1,0,1,31,5,8,3,2017,reg
Sam Nicholson,Minnesota United FC,F,12,8,639,1,1,19,5,0,1,0,1,13,16,0,0,2017,reg
Tim Parker,New York Red Bulls,D,32,32,2880,1,1,20,6,1,0,1,0,22,9,4,0,2017,reg
Dillon Serna,Colorado Rapids,M,19,9,945,1,1,26,6,1,0,1,0,7,10,0,0,2017,reg
Jesus Ferreira,FC Dallas,F,1,0,19,1,0,1,1,1,0,0,0,0,0,0,0,2017,reg
Brad Evans,FC Dallas,D-M,11,6,480,1,0,1,1,1,0,0,0,4,5,0,1,2017,reg
Ashtone Morgan,Real Salt Lake,D,5,3,283,1,0,1,1,0,1,0,0,2,2,1,0,2017,reg
Michael Ciani,LA Galaxy,D,6,6,540,1,0,3,1,0,1,0,0,6,2,3,0,2017,reg
Jose Hernandez,Real Salt Lake,M,7,1,160,1,0,3,1,0,1,0,0,5,2,1,0,2017,reg
Miguel Camargo,New York City FC,M,8,2,176,1,0,3,1,1,0,0,0,4,4,1,0,2017,reg
Eriq Zavaleta,Toronto FC,D,29,27,2356,1,0,4,2,1,0,0,0,27,7,4,0,2017,reg
Jack Barmby,Portland Timbers,M-D,10,0,99,1,0,5,2,1,0,0,0,6,2,3,0,2017,reg
Omar Holness,Real Salt Lake,M,9,3,261,1,0,5,1,0,1,0,0,7,2,1,0,2017,reg
Lalas Abubakar,Colorado Rapids,D,7,6,528,1,0,5,1,0,1,0,0,4,1,2,1,2017,reg
Servando Carrasco,Orlando City SC,M,15,9,833,1,0,5,1,1,0,0,0,11,4,2,1,2017,reg
Daigo Kobayashi,New England Revolution,M,12,4,507,1,0,5,2,0,1,0,0,5,4,0,0,2017,reg
Bobby Boswell,Atlanta United FC,D,11,10,892,1,0,6,3,1,0,0,0,9,2,0,0,2017,reg
Richie Marquez,Philadelphia Union,D,15,13,1212,1,0,6,1,1,0,0,0,10,4,0,0,2017,reg
Kyle Fisher,Montreal Impact,D,20,15,1455,1,0,6,1,1,0,0,0,12,5,3,0,2017,reg
Jay Chapman,,M,12,3,385,1,0,6,1,1,0,0,0,7,2,0,0,2017,reg
Dylan Remick,Houston Dynamo,D,14,13,1167,1,0,6,1,1,0,0,0,10,6,1,0,2017,reg
Khiry Shelton,Sporting Kansas City,F,15,3,502,1,0,7,2,0,1,0,0,9,6,0,0,2017,reg
Sebastian Hines,Orlando City SC,D,6,5,443,1,0,7,2,1,0,0,0,4,3,1,1,2017,reg
Chris Wingert,Real Salt Lake,D,23,20,1755,1,0,7,3,0,1,0,0,32,12,5,0,2017,reg
Cristian Lobato,Sporting Kansas City ,D,10,6,547,1,0,7,3,0,1,0,0,3,3,0,0,2017,reg
Aaron Maund,Real Salt Lake,D,15,14,1179,1,0,8,3,1,0,0,0,13,2,2,0,2017,reg
Lawrence Olum,Portland Timbers,D,30,22,2103,1,0,10,2,1,0,0,0,12,7,3,0,2017,reg
Kortne Ford,Colorado Rapids,D,20,19,1727,1,0,10,3,1,0,0,0,22,11,4,0,2017,reg
Axel Sjöberg,Columbus Crew SC,D,19,19,1637,1,0,11,2,1,0,0,0,23,6,1,1,2017,reg
Ariel Lassiter,LA Galaxy,F,14,0,258,1,0,11,3,0,1,0,0,2,5,0,0,2017,reg
Benjamin Angoua,New England Revolution,D,26,26,2311,1,0,11,3,1,0,0,0,43,17,6,0,2017,reg
Benoit Cheyrou,Toronto FC,M,13,7,615,1,0,11,4,0,1,0,0,5,9,1,0,2017,reg
Jay Simpson,Philadelphia Union,F,22,4,472,1,0,13,6,1,0,0,0,6,6,0,0,2017,reg
Sean Okoli,New York City FC,F,16,3,421,1,0,13,6,0,1,0,0,11,6,1,0,2017,reg
Oguchi Onyewu,Philadelphia Union,D,22,22,1929,1,0,14,6,0,1,0,0,44,17,6,0,2017,reg
Antonio Nocerino,Orlando City SC,M,31,28,2234,1,0,17,5,1,0,0,0,23,11,2,1,2017,reg
Juan David Cabezas,Houston Dynamo,M,27,26,2231,1,0,20,4,1,0,0,0,63,16,7,0,2017,reg
Jose Guillermo Ortiz,DC United,F,16,7,669,1,0,21,8,1,0,0,0,9,8,1,0,2017,reg
Aaron Long,New York Red Bulls,D,31,30,2659,1,0,22,8,0,1,0,0,20,20,3,0,2017,reg
Dominic Oduro,Montreal Impact,M,25,17,1439,1,0,26,10,0,1,0,0,10,27,1,0,2017,reg
Graham Zusi,Sporting Kansas City,M,24,23,2114,0,8,37,11,0,0,7,1,16,17,3,1,2017,reg
Christian Bolaños,Vancouver Whitecaps,M,21,18,1626,0,7,29,7,0,0,5,2,12,30,0,1,2017,reg
Ibson,Minnesota United FC,M,31,29,2660,0,6,17,7,0,0,3,3,32,75,6,0,2017,reg
Jake Nerwinski,Vancouver Whitecaps,D,19,19,1707,0,5,2,1,0,0,5,0,16,21,2,0,2017,reg
Steven Beitashour,Toronto FC,D,22,17,1589,0,5,4,1,0,0,3,2,15,10,1,0,2017,reg
Wil Trapp,,M,34,34,3035,0,5,8,3,0,0,2,3,37,41,3,0,2017,reg
Dax McCarty,Nashville SC,M,28,28,2465,0,5,15,3,0,0,2,3,26,57,4,0,2017,reg
Patrick Doody,Chicago Fire FC,D,7,7,629,0,4,1,0,0,0,3,1,4,3,0,0,2017,reg
Matt Besler,Sporting Kansas City,D,26,26,2339,0,4,4,1,0,0,1,3,22,14,2,0,2017,reg
Johan Kappelhof,Chicago Fire FC,D,33,33,2881,0,4,4,1,0,0,4,0,29,6,5,1,2017,reg
Boniek Garcia,Houston Dynamo,M,20,12,1165,0,4,6,2,0,0,3,1,21,17,4,0,2017,reg
Vytas,Portland Timbers,D,23,19,1780,0,4,8,2,0,0,4,0,25,9,5,0,2017,reg
Alexander Ring,New York City FC,M,29,29,2604,0,4,22,6,0,0,1,3,55,34,10,0,2017,reg
Carlos Gruezo,FC Dallas,M,31,30,2613,0,4,22,4,0,0,3,1,61,25,6,1,2017,reg
Zarek Valentin,Houston Dynamo,D,19,17,1547,0,3,1,0,0,0,2,1,13,5,2,0,2017,reg
Sheanon Williams,Vancouver Whitecaps,D-M,15,15,1349,0,3,2,0,0,0,2,1,12,20,3,0,2017,reg
Ronald Matarrita,New York City FC,D,12,8,696,0,3,2,0,0,0,2,1,5,3,3,0,2017,reg
Jose Villarreal,LA Galaxy,M,12,4,389,0,3,5,2,0,0,2,1,6,15,0,0,2017,reg
Andrew Farrell,New England Revolution,D,30,30,2664,0,3,6,1,0,0,3,0,20,23,5,1,2017,reg
Hector Jimenez,Columbus Crew SC,M,19,15,1366,0,3,6,1,0,0,2,1,11,15,1,0,2017,reg
RJ Allen,New York City FC,D,15,10,1009,0,3,6,0,0,0,1,2,24,4,3,0,2017,reg
A.J. DeLaGarza,,D,30,30,2623,0,3,8,2,0,0,2,1,26,20,8,0,2017,reg
Hernan Bernardello,Montreal Impact,M,22,17,1496,0,3,9,3,0,0,2,1,27,21,5,0,2017,reg
Donny Toia,Real Salt Lake,D,30,29,2545,0,3,13,2,0,0,1,2,43,7,4,0,2017,reg
Cristian Higuita,Orlando City SC,M,26,18,1554,0,3,14,2,0,0,3,0,42,62,8,0,2017,reg
Artur,Columbus Crew SC,M,24,19,1702,0,3,19,3,0,0,3,0,32,20,1,0,2017,reg
Danilo Acosta,LA Galaxy,D,17,16,1411,0,2,2,0,0,0,1,1,23,14,2,1,2017,reg
Rafael Garcia ,LA Galaxy,D,18,12,1186,0,2,2,0,0,0,0,2,25,14,1,0,2017,reg
Ethan White,New York City FC,D,21,19,1553,0,2,3,2,0,0,1,1,24,9,5,0,2017,reg
Mekeil Williams,Colorado Rapids,D,17,16,1397,0,2,3,0,0,0,2,0,21,6,7,1,2017,reg
Demar Phillips,Real Salt Lake,D,13,11,961,0,2,3,0,0,0,0,2,19,6,2,0,2017,reg
Sal Zizzo,New York Red Bulls,D,23,18,1644,0,2,6,2,0,0,0,2,18,12,5,1,2017,reg
Victor Ulloa,,M,23,12,1203,0,2,6,4,0,0,2,0,23,12,1,0,2017,reg
Joao Meira,Chicago Fire FC,D-M,30,27,2412,0,2,6,3,0,0,2,0,37,18,3,0,2017,reg
Ben Spencer,Toronto FC,F,3,2,179,0,2,7,0,0,0,1,1,1,0,0,0,2017,reg
Fabinho,Philadelphia Union,D,22,21,1902,0,2,8,3,0,0,2,0,30,26,4,0,2017,reg
Waylon Francis,Columbus Crew SC,D,12,10,852,0,2,8,0,0,0,1,1,12,6,0,0,2017,reg
Chris Mavinga,Toronto FC,D,26,24,2015,0,2,8,1,0,0,1,1,25,15,3,0,2017,reg
Jukka Raitala,Montreal Impact,D,28,20,1920,0,2,8,1,0,0,1,1,31,16,4,0,2017,reg
Sean Franklin,DC United,D,19,15,1415,0,2,8,3,0,0,0,2,22,7,5,0,2017,reg
Andrea Pirlo,New York City FC,M,15,14,1085,0,2,11,3,0,0,0,2,9,16,1,0,2017,reg
Michael Bradley,Toronto FC,M,30,30,2700,0,2,11,0,0,0,0,2,21,15,8,0,2017,reg
Adolfo Machado,Houston Dynamo,D,33,33,2970,0,2,11,1,0,0,2,0,30,11,5,0,2017,reg
Connor Lade,New York Red Bulls,D,21,16,1381,0,2,12,3,0,0,2,0,15,18,3,0,2017,reg
Armando Cooper,Toronto FC,M,19,10,906,0,2,12,4,0,0,2,0,31,30,2,0,2017,reg
Chris McCann,Atlanta United FC,M-D,23,9,958,0,2,13,2,0,0,2,0,20,14,0,0,2017,reg
Micheal Azira,Chicago Fire FC,M,30,28,2569,0,2,13,4,0,0,1,1,56,25,8,0,2017,reg
Derrick Etienne Jr.,Columbus Crew SC,M,18,8,702,0,2,13,6,0,0,2,0,10,14,2,0,2017,reg
Pedro Santos,Columbus Crew SC,M,9,8,650,0,2,14,6,0,0,2,0,20,21,2,0,2017,reg
Darwin Ceren,Houston Dynamo,M,21,19,1642,0,2,17,2,0,0,1,1,33,22,3,2,2017,reg
Ilie Sanchez,Sporting Kansas City,M,33,33,2970,0,2,19,2,0,0,2,0,16,37,6,0,2017,reg
Roman Torres,,D,23,21,1787,0,2,19,0,0,0,1,1,25,7,4,1,2017,reg
Ricardo Clark,Houston Dynamo,M,28,26,2252,0,2,23,6,0,0,2,0,39,14,6,0,2017,reg
Sebastian Saucedo,Real Salt Lake,F,20,5,573,0,2,29,8,0,0,1,1,13,17,2,0,2017,reg
Louis Beland-Goyette,Montreal Impact,M,6,4,293,0,1,0,0,0,0,1,0,10,3,2,0,2017,reg
Adrian Arregui,Montreal Impact,M,6,3,238,0,1,0,0,0,0,0,1,9,3,1,0,2017,reg
Tony Rocha,New York City FC,M,3,0,25,0,1,0,0,0,0,1,0,1,2,1,0,2017,reg
Marc Burch,Colorado Rapids,D,18,17,1502,0,1,0,0,0,0,1,0,4,8,1,0,2017,reg
Soni Mustivar,Sporting Kansas City ,M,14,2,260,0,1,0,0,0,0,1,0,7,4,0,0,2017,reg
Connor Maloney,Columbus Crew SC,D,2,1,127,0,1,1,0,0,0,0,1,0,1,0,0,2017,reg
Tsubasa Endoh,Toronto FC,M,4,3,269,0,1,2,1,0,0,1,0,4,5,0,0,2017,reg
Collin Martin,Minnesota United FC,M,11,7,635,0,1,2,1,0,0,1,0,11,7,4,0,2017,reg
Jordy Delem,FC Dallas,M,14,9,755,0,1,2,0,0,0,0,1,8,13,3,0,2017,reg
Sunday Stephen,Real Salt Lake,M,21,18,1493,0,1,2,0,0,0,0,1,44,10,8,0,2017,reg
Eric Alexander,Houston Dynamo,M,12,11,887,0,1,2,0,0,0,1,0,8,5,0,0,2017,reg
Muhamed Keita,New York Red Bulls,F,6,2,190,0,1,2,0,0,0,0,1,6,3,1,0,2017,reg
Chris Korb,DC United,D,16,13,1160,0,1,2,0,0,0,1,0,5,10,0,0,2017,reg
Raymon Gaddis,Philadelphia Union,D,26,23,2028,0,1,2,0,0,0,1,0,17,11,5,0,2017,reg
Warren Creavalle,Philadelphia Union,M,13,5,545,0,1,2,0,0,0,1,0,9,6,2,0,2017,reg
Kofi Sarkodie,San Jose Earthquakes,D,18,16,1325,0,1,3,0,0,0,1,0,20,24,2,1,2017,reg
Andraz Struna,New York City FC,D,5,4,322,0,1,3,0,0,0,1,0,3,3,1,0,2017,reg
Ben Zemanski,Portland Timbers,M,7,4,438,0,1,3,1,0,0,1,0,3,4,1,0,2017,reg
Giliano Wijnaldum,Philadelphia Union,D,13,13,1138,0,1,3,0,0,0,1,0,21,24,4,0,2017,reg
PC,Orlando City SC,D,8,5,436,0,1,3,0,0,0,0,1,10,10,1,1,2017,reg
Vincent Bezecourt,New York Red Bulls,M,3,2,190,0,1,3,1,0,0,0,1,3,0,0,0,2017,reg
Drew Conner,Chicago Fire FC,M,21,8,882,0,1,3,1,0,0,1,0,11,5,0,0,2017,reg
Richie Laryea,Toronto FC,M,12,1,250,0,1,3,2,0,0,1,0,9,18,2,0,2017,reg
Samuel Piette,Montreal Impact,M,11,11,960,0,1,3,0,0,0,0,1,14,12,3,0,2017,reg
Daniel Lovitz,Nashville SC,D,25,19,1750,0,1,4,1,0,0,1,0,26,10,4,1,2017,reg
Jared Watts,Colorado Rapids,D-M,20,18,1490,0,1,4,1,0,0,1,0,21,12,4,2,2017,reg
Keegan Rosenberry,Colorado Rapids,D,14,11,1051,0,1,4,2,0,0,1,0,13,6,2,0,2017,reg
Nouhou Tolo,FC Dallas,D,19,10,1052,0,1,5,0,0,0,1,0,15,13,1,1,2017,reg
Marcel de Jong,Vancouver Whitecaps,D-M,13,9,779,0,1,5,2,0,0,1,0,11,10,1,0,2017,reg
DaMarcus Beasley,Houston Dynamo,D,24,22,1985,0,1,6,3,0,0,1,0,13,35,0,0,2017,reg
Mohammed Abu,DC United,M,20,14,1280,0,1,6,1,0,0,1,0,24,14,3,0,2017,reg
Russell Canouse,DC United,M,10,10,868,0,1,6,1,0,0,0,1,18,12,3,0,2017,reg
Fidel Escobar,New York Red Bulls,D,6,5,482,0,1,7,1,0,0,0,1,5,4,2,0,2017,reg
Sam Cronin,Colorado Rapids,M,21,21,1813,0,1,7,1,0,0,1,0,21,16,5,0,2017,reg
David Horst,Real Salt Lake,D,12,8,880,0,1,7,2,0,0,0,1,10,5,4,0,2017,reg
Dillon Powers,Colorado Rapids,M,21,15,1309,0,1,8,2,0,0,1,0,21,29,3,0,2017,reg
Alex Crognale,Columbus Crew SC,D,17,12,1069,0,1,8,2,0,0,1,0,10,9,1,0,2017,reg
Marcelo Sarvas,DC United,M,25,19,1841,0,1,9,3,0,0,1,0,38,47,8,0,2017,reg
Cordell Cato,San Jose Earthquakes,F,15,13,1138,0,1,11,1,0,0,1,0,6,14,0,0,2017,reg
Damien Perrinelle,New York Red Bulls,D,25,22,1972,0,1,11,1,0,0,1,0,34,16,4,0,2017,reg
Jackson Yueill,San Jose Earthquakes,M,13,10,967,0,1,11,3,0,0,0,1,6,7,2,0,2017,reg
Bismark Adjei-Boateng,Colorado Rapids,M,18,10,806,0,1,12,3,0,0,1,0,16,12,3,0,2017,reg
Víctor Bernárdez,San Jose Earthquakes,D,25,25,2228,0,1,13,1,0,0,1,0,28,8,2,2,2017,reg
Fredrik Gulbrandsen,New York Red Bulls,F,12,4,362,0,1,13,4,0,0,1,0,10,10,2,0,2017,reg
Soony Saad,Sporting Kansas City ,F,12,6,453,0,1,14,4,0,0,1,0,7,8,0,0,2017,reg
Laurent Ciman,Toronto FC,D,30,30,2700,0,1,15,2,0,0,0,1,35,14,6,0,2017,reg
Alphonso Davies,Vancouver Whitecaps,M,26,9,1053,0,1,15,2,0,0,1,0,15,18,1,0,2017,reg
Harrison Afful,Columbus Crew SC,D,24,21,1777,0,1,16,2,0,0,0,1,11,21,3,1,2017,reg
Chance Myers,Portland Timbers,D,1,1,44,0,0,0,0,0,0,0,0,0,0,0,0,2017,reg
Charlie Davies,Philadelphia Union,F,3,0,25,0,0,0,0,0,0,0,0,0,1,0,0,2017,reg
Jason Hernandez,Toronto FC,D,8,5,526,0,0,0,0,0,0,0,0,3,2,0,0,2017,reg
Marvell Wynne,San Jose Earthquakes,D,0,0,0,0,0,0,0,0,0,0,0,0,0,0,0,2017,reg
Robbie Rogers,LA Galaxy,D,0,0,0,0,0,0,0,0,0,0,0,0,0,0,0,2017,reg
David Edgar,Vancouver Whitecaps,D,0,0,0,0,0,0,0,0,0,0,0,0,0,0,0,2017,reg
Michael Harrington,Chicago Fire FC,D,9,9,798,0,0,0,0,0,0,0,0,8,9,0,0,2017,reg
Maurice Edu,Philadelphia Union,M,0,0,0,0,0,0,0,0,0,0,0,0,0,0,0,2017,reg
Mauro Rosales,Vancouver Whitecaps,M,5,0,52,0,0,0,0,0,0,0,0,0,1,0,0,2017,reg
Philippe Senderos,Houston Dynamo,D,2,2,162,0,0,0,0,0,0,0,0,3,1,0,0,2017,reg
Brian Carroll,Philadelphia Union,M,1,0,45,0,0,0,0,0,0,0,0,1,3,0,0,2017,reg
Chris Rolfe,DC United,F,0,0,0,0,0,0,0,0,0,0,0,0,0,0,0,2017,reg
Agus,Houston Dynamo,D,0,0,0,0,0,0,0,0,0,0,0,0,0,0,0,2017,reg
Justin Davis,Minnesota United FC,D,8,5,492,0,0,0,0,0,0,0,0,5,3,0,1,2017,reg
Kevin Garcia,Houston Dynamo,D,3,2,211,0,0,0,0,0,0,0,0,2,1,1,0,2017,reg
Marc Pelosi,San Jose Earthquakes,M,0,0,0,0,0,0,0,0,0,0,0,0,0,0,0,2017,reg
Harold Cummings,San Jose Earthquakes,D,0,0,0,0,0,0,0,0,0,0,0,0,0,0,0,2017,reg
Bernardo Añor,Minnesota United FC,M,0,0,0,0,0,0,0,0,0,0,0,0,0,0,0,2017,reg
Nosa Igiebor,Vancouver Whitecaps,M,1,1,73,0,0,0,0,0,0,0,0,2,0,1,0,2017,reg
Gaston Sauro,Columbus Crew SC,D,0,0,0,0,0,0,0,0,0,0,0,0,0,0,0,2017,reg
Kevin Alston,Orlando City SC,D,0,0,0,0,0,0,0,0,0,0,0,0,0,0,0,2017,reg
Amobi Okugo,Portland Timbers,D-M,8,3,396,0,0,0,0,0,0,0,0,8,3,1,0,2017,reg
Zach Loyd,Atlanta United FC,D,0,0,0,0,0,0,0,0,0,0,0,0,0,0,0,2017,reg
Johan Brunell,Toronto FC,D,0,0,0,0,0,0,0,0,0,0,0,0,0,0,0,2017,reg
Jacori Hayes,Minnesota United FC,M,3,2,90,0,0,0,0,0,0,0,0,4,7,1,1,2017,reg
Arun Basuljevic,New York Red Bulls,M,0,0,0,0,0,0,0,0,0,0,0,0,0,0,0,2017,reg
Andrew Wheeler-Omiunu,Atlanta United FC,M,0,0,0,0,0,0,0,0,0,0,0,0,0,0,0,2017,reg
Marshall Hollingsworth,Columbus Crew SC,M,0,0,0,0,0,0,0,0,0,0,0,0,0,0,0,2017,reg
Kip Colvey,San Jose Earthquakes,M,0,0,0,0,0,0,0,0,0,0,0,0,0,0,0,2017,reg
Bryan Reynolds,FC Dallas,D,0,0,0,0,0,0,0,0,0,0,0,0,0,0,0,2017,reg
Shannon Gomez,New York City FC,D,0,0,0,0,0,0,0,0,0,0,0,0,0,0,0,2017,reg
Molham Babouli,Toronto FC,F,0,0,0,0,0,0,0,0,0,0,0,0,0,0,0,2017,reg
Matheus Silva,San Jose Earthquakes,D,0,0,0,0,0,0,0,0,0,0,0,0,0,0,0,2017,reg
Andrew Carleton,Atlanta United FC,M,1,0,4,0,0,0,0,0,0,0,0,0,0,0,0,2017,reg
Chris Goslin,Atlanta United FC,M,0,0,0,0,0,0,0,0,0,0,0,0,0,0,0,2017,reg
Joey Calistri,Chicago Fire FC,M,0,0,0,0,0,0,0,0,0,0,0,0,0,0,0,2017,reg
James Sands,New York City FC,M,1,0,23,0,0,0,0,0,0,0,0,1,0,0,0,2017,reg
Christian Lucatero,Houston Dynamo,M,0,0,0,0,0,0,0,0,0,0,0,0,0,0,0,2017,reg
Chris Odoi-Atsem,DC United,D,9,5,482,0,0,0,0,0,0,0,0,1,3,0,0,2017,reg
Brandon Aubrey,Toronto FC,D,0,0,0,0,0,0,0,0,0,0,0,0,0,0,0,2017,reg
Abuchi Obinwa,Columbus Crew SC,M,0,0,0,0,0,0,0,0,0,0,0,0,0,0,0,2017,reg
Kevin Oliveira,Sporting Kansas City ,M,2,0,16,0,0,0,0,0,0,0,0,1,3,0,0,2017,reg
Colton Storm,Sporting Kansas City ,D,0,0,0,0,0,0,0,0,0,0,0,0,0,0,0,2017,reg
Kwame Awuah,New York City FC,M,4,0,26,0,0,0,0,0,0,0,0,1,0,0,0,2017,reg
Brandt Bronico,Chicago Fire FC,M,4,0,53,0,0,0,0,0,0,0,0,1,0,0,0,2017,reg
Walker Hume,FC Dallas,F,2,2,180,0,0,0,0,0,0,0,0,2,1,1,0,2017,reg
Lindo Mfeka,San Jose Earthquakes,M,1,0,1,0,0,0,0,0,0,0,0,0,0,0,0,2017,reg
David Choiniere,Montreal Impact,M,3,0,34,0,0,0,0,0,0,0,0,2,1,0,0,2017,reg
Brett Levis,Vancouver Whitecaps,D,0,0,0,0,0,0,0,0,0,0,0,0,0,0,0,2017,reg
Jose Leiton,Minnesota United FC,M,1,0,15,0,0,0,0,0,0,0,0,0,0,0,0,2017,reg
Amer Didic,Sporting Kansas City ,D,0,0,0,0,0,0,0,0,0,0,0,0,0,0,0,2017,reg
Reagan Dunk,Real Salt Lake,D,3,2,174,0,0,0,0,0,0,0,0,1,1,0,0,2017,reg
Sam Hamilton,Colorado Rapids,M,3,1,124,0,0,0,0,0,0,0,0,5,1,1,0,2017,reg
Miles Robinson,Atlanta United FC,D,0,0,0,0,0,0,0,0,0,0,0,0,0,0,0,2017,reg
Rennico Clarke,Portland Timbers,D,0,0,0,0,0,0,0,0,0,0,0,0,0,0,0,2017,reg
Marco Farfan,Portland Timbers,D,6,5,403,0,0,0,0,0,0,0,0,3,3,0,0,2017,reg
Zachary Herivaux,New England Revolution,M,0,0,0,0,0,0,0,0,0,0,0,0,0,0,0,2017,reg
Chris Durkin,DC United,M,0,0,0,0,0,0,0,0,0,0,0,0,0,0,0,2017,reg
Taylor Hunter,Houston Dynamo,M,0,0,0,0,0,0,0,0,0,0,0,0,0,0,0,2017,reg
Ben McKendry,Vancouver Whitecaps,M,1,1,90,0,0,0,0,0,0,0,0,3,2,0,0,2017,reg
Eric Ayuk,Philadelphia Union,M,0,0,0,0,0,0,0,0,0,0,0,0,0,0,0,2017,reg
Auston Trusty,Colorado Rapids,D,0,0,0,0,0,0,0,0,0,0,0,0,0,0,0,2017,reg
Conor Donovan,Orlando City SC,D,0,0,0,0,0,0,0,0,0,0,0,0,0,0,0,2017,reg
Josh Yaro,Philadelphia Union,D,6,4,369,0,0,0,0,0,0,0,0,8,2,0,1,2017,reg
Nick Besler,Real Salt Lake,M,0,0,0,0,0,0,0,0,0,0,0,0,0,0,0,2017,reg
Victor Mansaray,FC Dallas,F,0,0,0,0,0,0,0,0,0,0,0,0,0,0,0,2017,reg
Ben Swanson,Columbus Crew SC,M,0,0,0,0,0,0,0,0,0,0,0,0,0,0,0,2017,reg
Brian Wright,New England Revolution,F,2,0,45,0,0,0,0,0,0,0,0,1,0,0,0,2017,reg
George Malki,Houston Dynamo,D,0,0,0,0,0,0,0,0,0,0,0,0,0,0,0,2017,reg
Cameron Iwasa,Sporting Kansas City ,F,0,0,0,0,0,0,0,0,0,0,0,0,0,0,0,2017,reg
Bryan Róchez,Atlanta United FC,F,0,0,0,0,0,0,0,0,0,0,0,0,0,0,0,2017,reg
Collin Fernandez,Chicago Fire FC,M,0,0,0,0,0,0,0,0,0,0,0,0,0,0,0,2017,reg
London Woodberry,New England Revolution,D,3,2,165,0,0,0,0,0,0,0,0,1,1,0,0,2017,reg
John Stertzer,New York City FC,M,5,0,53,0,0,0,0,0,0,0,0,1,0,0,0,2017,reg
Dan Metzger,New York Red Bulls,M,1,0,1,0,0,0,0,0,0,0,0,1,0,0,0,2017,reg
Kevin Venegas,Minnesota United FC,D,6,6,540,0,0,0,0,0,0,0,0,4,5,0,0,2017,reg
Jorge Corrales,Montreal Impact,D,0,0,0,0,0,0,0,0,0,0,0,0,0,0,0,2017,reg
Sergio Camargo,Toronto FC,M,0,0,0,0,0,0,0,0,0,0,0,0,0,0,0,2017,reg
Gbenga Arokoyo,Portland Timbers,D,0,0,0,0,0,0,0,0,0,0,0,0,0,0,0,2017,reg
Cole Seiler,Vancouver Whitecaps,D,0,0,0,0,0,0,0,0,0,0,0,0,0,0,0,2017,reg
Brandon Allen,Minnesota United FC,F,1,0,9,0,0,0,0,0,0,0,0,0,0,0,0,2017,reg
Mark Bloom,Atlanta United FC,D,2,2,163,0,0,0,0,0,0,0,0,2,5,0,0,2017,reg
Tyler Pasher,Sporting Kansas City ,M-D,1,1,45,0,0,0,0,0,0,0,0,1,0,0,0,2017,reg
Zach Mathers,FC Dallas,M,0,0,0,0,0,0,0,0,0,0,0,0,0,0,0,2017,reg
Dennis Castillo,Colorado Rapids,D,3,3,244,0,0,0,0,0,0,0,0,6,1,1,0,2017,reg
Kharlton Belmar,Sporting Kansas City ,F,1,0,6,0,0,0,0,0,0,0,0,0,1,0,0,2017,reg
Luis Gonzalez,FC Dallas,M,2,0,8,0,0,0,0,0,0,0,0,0,1,0,0,2017,reg
Donnie Smith,New England Revolution,M,1,1,53,0,0,0,0,0,0,0,0,0,0,0,0,2017,reg
Raul Mendiola,LA Galaxy,M,4,0,36,0,0,0,0,0,0,0,0,1,1,0,0,2017,reg
Bill Tuiloma,Portland Timbers,D-M,0,0,0,0,0,0,0,0,0,0,0,0,0,0,0,2017,reg
Anibal Chala,FC Dallas,D,0,0,0,0,0,0,0,0,0,0,0,0,0,0,0,2017,reg
Pierre Da Silva,Orlando City SC,M,1,0,1,0,0,0,0,0,0,0,0,0,0,0,0,2017,reg
Hugo Arellano,LA Galaxy,D,4,4,334,0,0,0,0,0,0,0,0,7,3,1,0,2017,reg
Erik Palmer-Brown,Sporting Kansas City ,D,10,7,641,0,0,0,0,0,0,0,0,4,7,0,0,2017,reg
Sam Adekugbe,Vancouver Whitecaps,D,0,0,0,0,0,0,0,0,0,0,0,0,0,0,0,2017,reg
Marco Bustos,Vancouver Whitecaps,M,0,0,0,0,0,0,0,0,0,0,0,0,0,0,0,2017,reg
Ken Tribbett,Nashville SC,D,1,0,3,0,0,0,0,0,0,0,0,0,0,0,0,2017,reg
Kyle Greig,Vancouver Whitecaps,F,1,0,2,0,0,0,0,0,0,0,0,1,0,0,0,2017,reg
Gideon Baah,New York Red Bulls,D,0,0,0,0,0,0,0,0,0,0,0,0,0,0,0,2017,reg
Harrison Heath,Atlanta United FC,M,1,0,1,0,0,0,0,0,0,0,0,0,0,0,0,2017,reg
Maxim Tissot,DC United,D,1,1,90,0,0,0,0,0,0,0,0,1,0,0,0,2017,reg
Charlie Ward,Houston Dynamo,M,1,0,45,0,0,0,0,0,0,0,0,1,0,0,0,2017,reg
Harold Hanson,Portland Timbers,D,1,0,1,0,0,0,0,0,0,0,0,1,0,0,0,2017,reg
Gianluca Busio,Sporting Kansas City,M-F,0,0,0,0,0,0,0,0,0,0,0,0,0,0,0,2017,reg
Hassan Ndam,FC Cincinnati,D,1,0,1,0,0,0,0,0,0,0,0,0,0,0,0,2017,reg
Aaron Jones,Philadelphia Union,D,0,0,0,0,0,0,0,0,0,0,0,0,0,0,0,2017,reg
Matej Dekovic,Chicago Fire FC,D,0,0,0,0,0,0,0,0,0,0,0,0,0,0,0,2017,reg
Reggie Cannon,FC Dallas,D,1,0,1,0,0,0,0,0,0,0,0,0,0,0,0,2017,reg
Adonijah Reid,FC Dallas,F,0,0,0,0,0,0,0,0,0,0,0,0,0,0,0,2017,reg
Ricardo Perez,Colorado Rapids,M,0,0,0,0,0,0,0,0,0,0,0,0,0,0,0,2017,reg
Adam Najem,Philadelphia Union,M,5,1,153,0,0,1,0,0,0,0,0,4,2,0,0,2017,reg
David Arshakyan,Chicago Fire FC,F,7,0,27,0,0,1,0,0,0,0,0,1,1,1,0,2017,reg
Ismaila Jome,Minnesota United FC,M-F,12,7,674,0,0,1,0,0,0,0,0,8,4,3,0,2017,reg
Nick DePuy,LA Galaxy,D,5,1,128,0,0,1,0,0,0,0,0,4,3,0,0,2017,reg
Alhaji Kamara,DC United,F,1,0,14,0,0,1,0,0,0,0,0,0,0,0,0,2017,reg
Oyvind Alseth,Toronto FC,D,4,4,269,0,0,1,0,0,0,0,0,2,2,1,0,2017,reg
Mikey Ambrose,,D,7,2,260,0,0,1,0,0,0,0,0,4,1,1,0,2017,reg
Jonathan Campbell,Chicago Fire FC,D,24,8,1009,0,0,1,0,0,0,0,0,5,6,2,0,2017,reg
James Musa,Minnesota United FC,D-M,1,1,90,0,0,1,1,0,0,0,0,2,0,1,0,2017,reg
Joe Holland,Houston Dynamo,M,5,0,22,0,0,1,0,0,0,0,0,1,1,0,0,2017,reg
Christian Dean,Chicago Fire FC,D,6,5,459,0,0,1,0,0,0,0,0,4,1,1,0,2017,reg
Carlos Cermeno,FC Dallas,M,8,3,315,0,0,1,0,0,0,0,0,5,6,2,0,2017,reg
Justin Bilyeu,New York Red Bulls,D,1,1,90,0,0,1,0,0,0,0,0,1,1,0,0,2017,reg
Coy Craft,FC Dallas,F-M,1,0,11,0,0,1,0,0,0,0,0,0,1,0,0,2017,reg
Rob Vincent,DC United,M-F,2,0,66,0,0,1,0,0,0,0,0,2,0,2,0,2017,reg
Rafael Ramos,Orlando City SC,D,2,1,55,0,0,1,0,0,0,0,0,1,0,0,1,2017,reg
Joseph Greenspan,Minnesota United FC,D,4,3,235,0,0,1,0,0,0,0,0,6,1,1,1,2017,reg
Cameron Porter,Sporting Kansas City ,F,1,0,21,0,0,1,0,0,0,0,0,0,0,0,0,2017,reg
Tony Alfaro,FC Dallas,D,15,8,817,0,0,1,0,0,0,0,0,9,2,4,0,2017,reg
Hadji Barry,Orlando City SC,F,3,0,11,0,0,1,0,0,0,0,0,0,0,0,0,2017,reg
Shamit Shome,Montreal Impact,M,1,0,8,0,0,1,0,0,0,0,0,0,0,0,0,2017,reg
Paxton Pomykal,FC Dallas,M,2,2,140,0,0,1,0,0,0,0,0,1,2,0,0,2017,reg
Bruno Miranda,DC United,F,5,0,53,0,0,1,0,0,0,0,0,1,1,0,0,2017,reg
Dilly Duka,Columbus Crew SC,M,3,2,151,0,0,1,0,0,0,0,0,1,0,0,0,2017,reg
Michael Boxall,Minnesota United FC,D,12,12,1080,0,0,1,0,0,0,0,0,9,6,2,0,2017,reg
Kevin Ellis,Sporting Kansas City ,D,5,5,450,0,0,1,0,0,0,0,0,4,2,1,0,2017,reg
Michael Parkhurst,Atlanta United FC,D,33,33,2906,0,0,1,0,0,0,0,0,16,8,4,0,2017,reg
Francois Affolter,San Jose Earthquakes,D,6,6,509,0,0,2,0,0,0,0,0,3,4,1,0,2017,reg
Vadim Demidov,Minnesota United FC,D,3,3,270,0,0,2,0,0,0,0,0,3,2,0,0,2017,reg
John Goossens,Chicago Fire FC,M,1,1,89,0,0,2,0,0,0,0,0,1,0,1,0,2017,reg
Jalil Anibaba,Nashville SC,D,8,4,462,0,0,2,1,0,0,0,0,4,2,0,0,2017,reg
Pele van Anholt,LA Galaxy,D,5,5,357,0,0,2,1,0,0,0,0,1,3,0,0,2017,reg
Sebastian Lletget,LA Galaxy,M,3,3,270,0,0,2,0,0,0,0,0,2,3,0,0,2017,reg
Aaron Guillen,FC Dallas,D,6,4,374,0,0,2,0,0,0,0,0,4,3,2,0,2017,reg
Jaime Villarreal,LA Galaxy,D,7,4,374,0,0,2,1,0,0,0,0,5,1,1,0,2017,reg
Tommy Redding,Orlando City SC,D,18,14,1406,0,0,2,1,0,0,0,0,13,3,4,0,2017,reg
Nathan Smith,LA Galaxy,D,12,9,907,0,0,2,0,0,0,0,0,22,11,5,1,2017,reg
Jose Escalante,Houston Dynamo,M,3,0,24,0,0,2,0,0,0,0,0,0,2,0,0,2017,reg
Igor Juliao,Sporting Kansas City ,D,1,1,45,0,0,2,1,0,0,0,0,1,2,1,0,2017,reg
Mikey Lopez,New York City FC,M,12,5,609,0,0,2,0,0,0,0,0,10,4,2,0,2017,reg
Mike da Fonte,Colorado Rapids,D,17,14,1223,0,0,2,0,0,0,0,0,30,14,5,0,2017,reg
Leonardo Pereira,Orlando City SC,D,10,9,805,0,0,2,0,0,0,0,0,16,6,4,0,2017,reg
Eric Miller,Nashville SC,D,30,30,2616,0,0,2,0,0,0,0,0,17,16,5,0,2017,reg
Wandrille Lefevre,Montreal Impact,D,3,1,103,0,0,2,1,0,0,0,0,0,0,0,0,2017,reg
Deian Boldor,Montreal Impact,D,5,5,412,0,0,3,1,0,0,0,0,8,1,0,1,2017,reg
Justin Schmidt,Real Salt Lake,D,9,7,676,0,0,3,1,0,0,0,0,6,3,0,0,2017,reg
Henry Wingo,FC Dallas,M,11,0,132,0,0,3,0,0,0,0,0,1,1,0,0,2017,reg
Seyi Adekoya,FC Dallas,F,2,1,77,0,0,3,1,0,0,0,0,3,2,1,0,2017,reg
Cristian Martinez,Columbus Crew SC,M,8,1,237,0,0,3,0,0,0,0,0,8,9,2,0,2017,reg
Mike Grella,New York Red Bulls,M,8,3,362,0,0,3,1,0,0,0,0,6,3,0,0,2017,reg
Baggio Husidic,LA Galaxy,M,10,5,445,0,0,3,0,0,0,0,0,8,6,0,0,2017,reg
Andres Imperiale,San Jose Earthquakes,D,13,12,1111,0,0,3,1,0,0,0,0,25,11,7,0,2017,reg
Chad Barrett,Real Salt Lake,F,3,0,65,0,0,3,1,0,0,0,0,1,1,0,0,2017,reg
Jermaine Taylor,Minnesota United FC,D,14,6,671,0,0,4,1,0,0,0,0,4,4,1,0,2017,reg
Bobby Burling,Colorado Rapids,D,12,8,760,0,0,4,0,0,0,0,0,7,4,3,0,2017,reg
Rasmus Schuller,Minnesota United FC,M,7,4,324,0,0,4,0,0,0,0,0,3,4,1,0,2017,reg
Julian Buescher,DC United,M,7,2,180,0,0,4,1,0,0,0,0,3,5,0,0,2017,reg
Victor Cabrera,Houston Dynamo,D,20,18,1496,0,0,4,0,0,0,0,0,24,6,6,1,2017,reg
Derrick Jones,Nashville SC,M,12,8,702,0,0,5,1,0,0,0,0,16,13,1,1,2017,reg
Ricardo Velazco,Real Salt Lake,F,9,1,254,0,0,5,1,0,0,0,0,9,14,2,0,2017,reg
Jalen Robinson,DC United,D,7,6,543,0,0,5,0,0,0,0,0,5,2,0,0,2017,reg
Aly Ghazal,Vancouver Whitecaps,M,7,7,630,0,0,5,0,0,0,0,0,12,9,0,0,2017,reg
Calum Mallace,Montreal Impact,M,7,4,298,0,0,5,1,0,0,0,0,1,1,0,0,2017,reg
Russell Teibert,Vancouver Whitecaps,M,12,8,731,0,0,5,1,0,0,0,0,13,4,1,0,2017,reg
Je-Vaughn Watson,New England Revolution,D,18,8,766,0,0,5,2,0,0,0,0,11,5,5,1,2017,reg
Marcelo Silva,Real Salt Lake,D,9,9,650,0,0,5,1,0,0,0,0,8,1,0,1,2017,reg
Aurelien Collin,Philadelphia Union,D,9,7,545,0,0,5,1,0,0,0,0,15,6,2,0,2017,reg
Álvaro Fernández,FC Dallas,M,10,5,492,0,0,5,4,0,0,0,0,4,8,1,0,2017,reg
Chris Schuler,Real Salt Lake,D,12,12,1069,0,0,6,1,0,0,0,0,16,10,4,0,2017,reg
Fatai Alashe,FC Cincinnati,M,17,13,1201,0,0,6,3,0,0,0,0,18,12,6,0,2017,reg
Femi Hollinger-Janzen,New England Revolution,F,13,1,148,0,0,6,2,0,0,0,0,3,0,0,0,2017,reg
Jose Aja,Minnesota United FC,D,15,15,1275,0,0,6,0,0,0,0,0,20,9,5,1,2017,reg
Oniel Fisher,DC United,D,9,7,543,0,0,6,1,0,0,0,0,9,10,1,0,2017,reg
Victor Arboleda,Portland Timbers,F-M,5,0,55,0,0,6,1,0,0,0,0,3,1,0,1,2017,reg
Josh Smith,New England Revolution,D,6,6,539,0,0,6,1,0,0,0,0,8,3,0,0,2017,reg
Daniel Johnson,Chicago Fire FC,M,8,0,125,0,0,6,3,0,0,0,0,2,5,0,0,2017,reg
Shaun Francis,Montreal Impact,D,14,12,1067,0,0,7,3,0,0,0,0,13,4,1,0,2017,reg
Andres Romero,Montreal Impact,M,9,4,432,0,0,7,2,0,0,0,0,10,5,1,0,2017,reg
Claude Dielna,New England Revolution,D,11,11,945,0,0,8,2,0,0,0,0,16,5,4,0,2017,reg
Quincy Amarikwa,San Jose Earthquakes,F,9,1,150,0,0,8,5,0,0,0,0,5,2,0,0,2017,reg
Nicolai Naess,Columbus Crew SC,D,18,17,1476,0,0,8,1,0,0,0,0,11,6,1,0,2017,reg
Nick Hagglund,FC Cincinnati,D,15,13,1124,0,0,9,1,0,0,0,0,12,7,2,0,2017,reg
Jack McInerney,LA Galaxy,F,8,3,260,0,0,9,4,0,0,0,0,3,4,1,0,2017,reg
Larrys Mabiala,Portland Timbers,D,13,13,1160,0,0,9,0,0,0,0,0,16,5,0,1,2017,reg
Hassoun Camara,Montreal Impact,D,18,16,1350,0,0,10,4,0,0,0,0,23,10,4,1,2017,reg
Simon Dawkins,San Jose Earthquakes,M,14,7,637,0,0,10,1,0,0,0,0,10,7,0,0,2017,reg
Aaron Kovar,FC Dallas,M,7,1,199,0,0,10,1,0,0,0,0,6,3,0,0,2017,reg
Taylor Kemp,DC United,D,22,22,1980,0,0,11,2,0,0,0,0,12,17,2,0,2017,reg
Justen Glad,Real Salt Lake,D,18,18,1620,0,0,11,5,0,0,0,0,21,8,2,0,2017,reg
Bradley Diallo,LA Galaxy,D,18,15,1380,0,0,11,3,0,0,0,0,39,6,7,1,2017,reg
Bashkim Kadrii,Minnesota United FC,M-F,11,5,422,0,0,12,3,0,0,0,0,2,1,0,0,2017,reg
Gershon Koffie,New England Revolution,M,23,21,1920,0,0,16,2,0,0,0,0,39,47,3,0,2017,reg
Ryan Hollingshead,FC Dallas,M,18,9,820,0,0,16,3,0,0,0,0,8,5,0,0,2017,reg
Luis Gil,Colorado Rapids,M,21,9,853,0,0,17,10,0,0,0,0,10,7,1,0,2017,reg
Nick DeLeon,Toronto FC,M,19,18,1594,0,0,18,4,0,0,0,0,13,15,3,0,2017,reg
Steven Birnbaum,DC United,D,26,25,2249,0,0,24,3,0,0,0,0,38,15,2,0,2017,reg
Josef Martinez,Atlanta United FC,F,34,34,2898,31,6,97,56,16,15,4,2,24,31,1,0,2018,reg
Zlatan Ibrahimovic,LA Galaxy,F,27,24,2143,22,10,116,49,15,7,5,5,36,34,5,1,2018,reg
Bradley Wright-Phillips,LAFC,F,32,28,2536,20,8,82,37,10,10,4,4,32,55,7,0,2018,reg
Mauro Manotas,Houston Dynamo,F,33,30,2633,19,1,95,43,10,9,0,1,24,20,1,0,2018,reg
Gyasi Zardes,Columbus Crew SC,F,33,33,2948,19,0,88,40,17,2,0,0,27,33,3,0,2018,reg
Ignacio Piatti,Montreal Impact,M,32,32,2821,16,13,95,32,14,2,7,6,40,78,2,0,2018,reg
Nemanja Nikolic,Chicago Fire FC,F,31,29,2443,15,2,52,28,12,3,2,0,9,15,2,0,2018,reg
Carlos Vela,LAFC,F,28,26,2378,14,13,97,44,4,10,8,5,15,73,1,0,2018,reg
Kei Kamara,Colorado Rapids,F,28,24,2167,14,6,88,34,8,6,3,3,39,44,5,1,2018,reg
David Villa,New York City FC,F,23,20,1754,14,5,100,42,9,5,3,2,19,26,3,0,2018,reg
Ola Kamara,DC United,F,31,30,2689,14,3,67,31,7,7,3,0,26,46,2,0,2018,reg
Sebastian Giovinco,Toronto FC,F,28,26,2384,13,15,167,51,8,5,9,6,33,64,5,1,2018,reg
Dom Dwyer,Orlando City SC,F,26,25,2244,13,0,78,36,9,4,0,0,43,50,9,0,2018,reg
Miguel Almiron ,Atlanta United FC,M,32,32,2760,12,14,132,51,8,4,7,7,32,66,5,0,2018,reg
Diego Rossi,LAFC,F,32,30,2604,12,9,89,40,5,7,4,5,31,62,0,0,2018,reg
Damir Kreilach,Real Salt Lake,M,33,31,2784,12,8,67,27,10,2,7,1,39,47,5,0,2018,reg
Wayne Rooney,DC United,F-M,20,18,1641,12,7,71,31,12,0,6,1,15,11,1,0,2018,reg
Cristian Penilla,New England Revolution,F,33,33,2816,12,7,95,38,6,6,5,2,39,50,2,1,2018,reg
Aleksandar Katai,Chicago Fire FC,M,33,27,2428,12,5,97,41,7,5,3,2,39,32,6,0,2018,reg
Adama Diomande,LAFC,F,18,14,1253,12,4,39,22,7,5,2,2,17,10,1,0,2018,reg
Danny Hoesen,San Jose Earthquakes,F,34,29,2488,12,4,83,33,7,5,3,1,24,19,1,0,2018,reg
Darwin Quintero,Houston Dynamo,F,27,27,2396,11,15,78,32,9,2,8,7,25,54,3,0,2018,reg
Alberth Elis,Houston Dynamo,F,30,27,2422,11,10,101,44,5,6,5,5,33,51,6,1,2018,reg
Romain Alessandrini,LA Galaxy,M,26,23,1920,11,9,63,24,6,5,4,5,35,32,7,0,2018,reg
Daniel Salloi,Sporting Kansas City,F,29,26,2291,11,7,78,31,5,6,5,2,12,26,3,1,2018,reg
Teal Bunbury,New England Revolution,F,32,30,2566,11,4,68,33,6,5,3,1,40,31,5,0,2018,reg
Ismael Tajouri-Shradi,New York City FC,F,27,18,1547,11,3,35,16,4,7,1,2,10,20,2,0,2018,reg
Daniel Royer,New York Red Bulls,M,29,24,2049,11,2,72,32,6,5,0,2,19,27,1,1,2018,reg
Luciano Acosta,DC United,M-F,33,32,2753,10,17,60,23,10,0,10,7,59,63,3,0,2018,reg
Diego Valeri,Portland Timbers,M,32,31,2747,10,12,86,29,6,4,7,5,30,47,4,0,2018,reg
Sebastian Blanco,Portland Timbers,M-F,31,29,2564,10,11,81,31,4,6,6,5,31,47,9,0,2018,reg
Johnny Russell,Sporting Kansas City,F,30,24,2183,10,10,70,30,6,4,6,4,15,37,3,0,2018,reg
Jonathan Osorio,Toronto FC,M,30,30,2603,10,7,33,20,6,4,6,1,22,48,6,0,2018,reg
Albert Rusnak,Real Salt Lake,M,31,29,2592,10,7,67,29,6,4,5,2,19,20,0,0,2018,reg
Chris Wondolowski,San Jose Earthquakes,F,34,23,2289,10,5,58,22,7,3,2,3,27,15,3,0,2018,reg
Fafa Picault,FC Dallas,M,29,24,2190,10,5,70,33,3,7,4,1,26,33,7,0,2018,reg
Vako,San Jose Earthquakes,M,33,31,2718,10,5,110,35,6,4,3,2,14,28,0,0,2018,reg
Raul Ruidiaz ,FC Dallas,F,14,13,1098,10,1,44,17,6,4,0,1,8,8,1,0,2018,reg
Cory Burke,Philadelphia Union,F,29,15,1427,10,1,61,19,4,6,1,0,48,35,4,1,2018,reg
Darren Mattocks,DC United,F,25,14,1267,10,0,42,19,3,7,0,0,17,22,3,0,2018,reg
Diego Fagundez,New England Revolution,M,33,30,2666,9,10,68,30,7,2,4,6,28,33,9,0,2018,reg
Yamil Asad,DC United,M,30,27,2365,9,8,45,19,1,8,7,1,28,82,1,0,2018,reg
Dominique Badji,Nashville SC,F,26,24,1963,9,3,59,23,6,3,1,2,51,39,6,0,2018,reg
Christian Ramirez,Houston Dynamo,F,27,20,1645,9,2,43,17,7,2,1,1,6,25,0,0,2018,reg
Nicolás Lodeiro,FC Dallas,M,27,27,2428,8,16,57,17,6,2,11,5,34,94,3,0,2018,reg
Maximiliano Moralez,New York City FC,M,32,32,2818,8,16,72,26,5,3,13,3,46,86,4,0,2018,reg
Alphonso Davies,Vancouver Whitecaps,M,31,27,2420,8,11,37,15,7,1,10,1,31,59,2,0,2018,reg
Maximiliano Urruti,Montreal Impact,F,33,30,2735,8,11,117,35,4,4,4,7,31,49,3,0,2018,reg
Victor Vazquez,Toronto FC,M,21,19,1440,8,9,29,15,6,2,7,2,13,22,0,0,2018,reg
Joao Plata,Real Salt Lake,F,25,20,1721,8,8,56,29,4,4,6,2,12,29,0,0,2018,reg
Diego Rubio,Colorado Rapids,F,20,9,781,8,6,29,15,5,3,4,2,11,19,3,0,2018,reg
Roland Lamah,FC Dallas,M,29,21,1865,8,6,37,14,7,1,3,3,14,28,4,0,2018,reg
Corey Baird,Real Salt Lake,F,31,21,1903,8,5,39,20,4,4,3,2,20,13,4,0,2018,reg
Samuel Armenteros,Portland Timbers,F,28,19,1590,8,1,41,18,4,4,1,0,18,27,2,0,2018,reg
Cristian Techera,Vancouver Whitecaps,M,21,16,1347,8,1,44,21,5,3,1,0,15,24,6,1,2018,reg
Jefferson Savarino,Real Salt Lake,F,32,32,2853,7,11,78,31,5,2,7,4,30,70,2,0,2018,reg
Hector Villalba,Atlanta United FC,F,28,21,1787,7,9,68,28,3,4,7,2,11,12,4,0,2018,reg
Paul Arriola,DC United,M-F,28,25,2183,7,8,36,18,5,2,3,5,40,31,7,1,2018,reg
Miguel Ibarra ,FC Dallas,M,33,31,2715,7,8,37,19,5,2,6,2,28,16,4,1,2018,reg
Saphir Taider,Montreal Impact,F,33,33,2852,7,8,81,25,4,3,4,4,36,56,3,1,2018,reg
Will Bruin,FC Dallas,F,29,19,1793,7,5,37,18,2,5,2,3,13,21,1,0,2018,reg
Felipe Gutiérrez,Sporting Kansas City,M,20,18,1522,7,2,40,17,3,4,0,2,38,25,3,0,2018,reg
Jozy Altidore,Toronto FC,F,13,12,877,7,1,26,9,7,0,0,1,19,12,3,1,2018,reg
Alejandro Romero Gamarra,New York Red Bulls,M,30,29,2424,6,14,53,23,4,2,7,7,19,16,5,0,2018,reg
Romell Quioto,Montreal Impact,M,32,25,2252,6,12,82,30,3,3,9,3,28,33,3,0,2018,reg
Yordy Reyna,Vancouver Whitecaps,M-F,26,21,1875,6,11,43,17,3,3,7,4,24,45,8,2,2018,reg
Federico Higuain,DC United,F,30,27,2380,6,9,52,17,4,2,8,1,22,20,5,1,2018,reg
Jesus Medina,New York City FC,M,28,21,2005,6,7,46,13,4,2,5,2,13,23,1,0,2018,reg
Sacha Kljestan,LA Galaxy,M,30,29,2522,6,6,47,17,3,3,2,4,18,30,4,0,2018,reg
Michael Barrios,FC Dallas,M,34,29,2536,6,6,59,29,2,4,3,3,33,23,4,0,2018,reg
Santiago Mosquera,FC Dallas,M,29,17,1589,6,5,61,21,3,3,1,4,21,27,0,0,2018,reg
Magnus Eriksson,San Jose Earthquakes,F,32,29,2494,6,3,52,20,3,3,1,2,37,81,2,0,2018,reg
Ilsinho,Philadelphia Union,M,23,9,985,6,2,23,8,6,0,2,0,13,18,1,0,2018,reg
Borek Dockal,Philadelphia Union,M,31,30,2397,5,18,44,19,5,0,11,7,22,23,1,0,2018,reg
Tomas Martinez,Houston Dynamo,M,32,31,2455,5,13,66,19,3,2,5,8,22,61,5,1,2018,reg
Alejandro Silva,Montreal Impact,M,31,27,2368,5,11,53,20,2,3,7,4,29,25,4,0,2018,reg
Zoltan Stieber,DC United,M-F,27,21,1833,5,7,34,12,1,4,3,4,11,7,1,0,2018,reg
Chris Pontius,LA Galaxy,M,26,15,1485,5,6,26,8,2,3,5,1,21,25,3,0,2018,reg
Victor Rodriguez,FC Dallas,M,19,14,1258,5,6,47,15,4,1,4,2,12,31,0,0,2018,reg
Latif Blessing,LAFC,F,30,18,1804,5,6,49,20,2,3,4,2,25,53,0,0,2018,reg
Gerso Fernandes,Sporting Kansas City,F,31,17,1591,5,5,38,19,1,4,1,4,31,26,1,0,2018,reg
Larrys Mabiala,Portland Timbers,D,31,31,2744,5,1,26,11,2,3,1,0,36,10,5,0,2018,reg
Derrick Etienne Jr.,Columbus Crew SC,M,30,9,961,5,1,35,17,3,2,1,0,13,24,1,0,2018,reg
Luis Silva,Real Salt Lake,F,19,9,810,5,0,30,16,5,0,0,0,3,7,0,0,2018,reg
Julian Gressel,DC United,M,33,33,2945,4,14,65,21,4,0,7,7,33,11,3,0,2018,reg
Yoshi Yotun,Orlando City SC,M,22,22,1970,4,10,37,11,3,1,9,1,29,63,8,1,2018,reg
Cristian Roldan,FC Dallas,M,34,34,3053,4,9,32,16,3,1,6,3,38,55,4,0,2018,reg
Bastian Schweinsteiger,Chicago Fire FC,M,31,30,2726,4,6,24,8,2,2,4,2,29,51,7,0,2018,reg
Anton Tinnerholm,New York City FC,D,31,31,2697,4,6,37,12,2,2,3,3,33,26,5,0,2018,reg
Wilfried Zahibo,New England Revolution,M,31,22,1943,4,4,36,12,2,2,3,1,45,30,6,0,2018,reg
Ilie Sanchez,Sporting Kansas City,M,34,34,3060,4,4,45,14,3,1,1,3,34,34,6,0,2018,reg
Ezequiel Barco,Atlanta United FC,M,26,19,1730,4,3,21,10,2,2,0,3,8,65,2,0,2018,reg
Tommy Smith,Colorado Rapids,D,33,33,2969,4,3,30,12,4,0,3,0,34,25,6,1,2018,reg
Ibson,Minnesota United FC,M,27,23,2099,4,3,31,8,3,1,2,1,23,47,5,0,2018,reg
Jo Inge Berget,New York City FC,F,23,19,1569,4,3,40,12,3,1,2,1,26,14,1,0,2018,reg
CJ Sapong,Chicago Fire FC,F,32,29,2321,4,3,53,21,3,1,2,1,50,65,3,0,2018,reg
Lucas Janson,Toronto FC,F,11,8,818,4,2,30,17,3,1,2,0,9,12,0,0,2018,reg
Philippe Senderos,Houston Dynamo,D,8,7,606,4,1,10,6,4,0,1,0,6,4,2,0,2018,reg
Chad Marshall,FC Dallas,D,30,30,2584,4,1,19,5,3,1,0,1,12,13,0,1,2018,reg
Walker Zimmerman,Nashville SC,D,26,26,2321,4,1,24,8,3,1,0,1,21,7,4,0,2018,reg
Angelo Rodriguez,Minnesota United FC,F,11,10,870,4,1,28,8,3,1,0,1,17,24,1,0,2018,reg
Reto Ziegler,FC Dallas,D,29,29,2570,4,0,15,7,4,0,0,0,20,15,2,3,2018,reg
Cristian Higuita,Orlando City SC,M,21,18,1366,4,0,18,7,1,3,0,0,32,49,6,1,2018,reg
Alan Gordon,Chicago Fire FC,F,23,7,827,4,0,19,10,1,3,0,0,29,14,2,0,2018,reg
Jeisson Vargas,Montreal Impact,F-M,19,10,871,4,0,28,11,2,2,0,0,10,4,1,0,2018,reg
Roger Espinoza,Sporting Kansas City,M,32,32,2825,3,9,47,11,1,2,5,4,66,48,9,1,2018,reg
Chris Mueller,Orlando City SC,F,32,23,2056,3,7,32,13,2,1,5,2,17,31,2,0,2018,reg
Benny Feilhaber,LAFC,M,34,32,2804,3,6,38,11,0,3,2,4,45,76,5,0,2018,reg
Alejandro Bedoya,Philadelphia Union,M,33,31,2777,3,6,40,13,2,1,6,0,41,17,6,1,2018,reg
Lee Nguyen,,M,25,20,1833,3,5,21,6,2,1,1,4,18,39,4,1,2018,reg
Florian Valot,New York Red Bulls,M,14,13,1150,3,5,24,9,1,2,3,2,14,13,1,0,2018,reg
Edgar Castillo,Atlanta United FC,D,28,28,2440,3,5,28,7,2,1,4,1,26,40,7,0,2018,reg
Kellyn Acosta,Colorado Rapids,M,25,20,1714,3,5,30,7,2,1,3,2,33,25,3,0,2018,reg
Alex Muyl,New York Red Bulls,M,30,13,1286,3,5,31,17,1,2,3,2,37,30,6,0,2018,reg
Sebastian Saucedo,Real Salt Lake,F,28,10,1031,3,5,46,23,2,1,3,2,14,35,1,0,2018,reg
Florian Jungwirth,San Jose Earthquakes,D,31,27,2400,3,4,17,6,0,3,2,2,28,46,4,0,2018,reg
Juan Agudelo,,F,30,13,1496,3,4,40,13,1,2,2,2,41,25,2,0,2018,reg
Harry Shipp,FC Dallas,M,19,15,1230,3,3,28,9,2,1,3,0,13,18,1,0,2018,reg
Niko Hansen,Houston Dynamo,F,22,11,1031,3,3,33,8,0,3,3,0,10,11,1,0,2018,reg
Sam Nicholson,Colorado Rapids,F,27,25,2047,3,3,46,17,3,0,2,1,34,42,3,0,2018,reg
Yohan Croizet,Sporting Kansas City,M,32,19,1594,3,3,49,14,2,1,3,0,25,16,2,0,2018,reg
Scott Sutter,Orlando City SC,D,19,18,1567,3,2,17,5,3,0,2,0,6,8,0,0,2018,reg
Ike Opara,Minnesota United FC,D,31,31,2773,3,2,23,6,1,2,1,1,30,16,5,0,2018,reg
Fanendo Adi,Columbus Crew SC,F,14,9,823,3,2,23,9,3,0,0,2,10,19,0,0,2018,reg
Aaron Long,New York Red Bulls,D,34,31,2806,3,2,23,10,1,2,0,2,23,17,1,0,2018,reg
Brek Shea,,D,28,15,1521,3,2,24,9,0,3,0,2,18,13,3,0,2018,reg
Giovani dos Santos,LA Galaxy,M,14,10,823,3,2,25,9,2,1,1,1,9,12,2,0,2018,reg
Sebastian Lletget,LA Galaxy,M,28,21,1885,3,2,30,9,3,0,1,1,17,28,2,0,2018,reg
Kendall Waston,FC Cincinnati,D,26,26,2218,3,2,33,9,3,0,1,1,25,8,6,1,2018,reg
Raheem Edwards,Minnesota United FC,M,27,19,1724,3,2,36,13,1,2,2,0,26,24,3,0,2018,reg
Alejandro Fuenmayor,Houston Dynamo,D,22,21,1763,3,1,8,4,3,0,1,0,29,7,7,1,2018,reg
David Guzman,Portland Timbers,M,14,11,968,3,1,17,6,3,0,0,1,17,12,4,0,2018,reg
Gustav Svensson,FC Dallas,M,24,23,2074,3,1,21,8,2,1,1,0,25,11,2,0,2018,reg
Jay Chapman,,M,22,10,982,3,1,25,9,3,0,1,0,11,6,2,0,2018,reg
Matteo Mancosu,Montreal Impact,F,20,14,1103,3,1,27,5,1,2,1,0,11,23,2,0,2018,reg
Nicolas Mezquida,Colorado Rapids,F-M,21,9,966,3,1,36,12,2,1,1,0,11,24,0,0,2018,reg
Romario Ibarra,Minnesota United FC,M,9,2,271,3,0,11,5,2,1,0,0,1,4,0,0,2018,reg
Nick Hagglund,FC Cincinnati,D,20,15,1430,3,0,12,6,2,1,0,0,9,7,1,0,2018,reg
Joe Mason,Colorado Rapids,F,14,9,758,3,0,14,8,2,1,0,0,12,14,1,0,2018,reg
Niki Jackson,Colorado Rapids,F,15,1,429,3,0,14,4,0,3,0,0,17,18,4,1,2018,reg
Jahmir Hyka,San Jose Earthquakes,M,19,11,914,3,0,18,6,2,1,0,0,4,7,0,0,2018,reg
Tosaint Ricketts,Vancouver Whitecaps,F,18,4,601,3,0,20,12,1,2,0,0,6,5,1,0,2018,reg
Laurent Ciman,Toronto FC,D,22,22,1980,3,0,24,10,2,1,0,0,18,10,1,0,2018,reg
Jonathan dos Santos,LA Galaxy,M,23,22,1909,2,8,11,5,0,2,4,4,26,32,3,0,2018,reg
Mauro Diaz,FC Dallas,M,12,9,807,2,8,20,5,2,0,6,2,9,29,3,0,2018,reg
Marc Rzatkowski,New York Red Bulls,M,24,16,1497,2,7,22,7,2,0,3,4,27,26,4,0,2018,reg
Haris Medunjanin,FC Cincinnati,M,30,29,2530,2,7,44,9,0,2,4,3,18,7,5,1,2018,reg
Graham Zusi,Sporting Kansas City,M,34,34,3060,2,7,57,19,2,0,3,4,21,35,2,0,2018,reg
Harrison Afful,Columbus Crew SC,D,32,32,2864,2,6,56,13,2,0,5,1,17,21,1,0,2018,reg
Emmanuel Boateng,DC United,M,27,12,1188,2,5,17,4,1,1,2,3,13,11,2,0,2018,reg
Mark-Anthony Kaye,LAFC,M,20,20,1582,2,5,30,10,1,1,4,1,26,14,3,0,2018,reg
Khiry Shelton,Sporting Kansas City,F,20,15,1370,2,5,36,10,1,1,2,3,20,18,2,0,2018,reg
Steven Beitashour,LAFC,D,30,30,2644,2,4,9,3,1,1,0,4,23,21,3,0,2018,reg
Kevin Ellis,Chicago Fire FC,D,22,19,1583,2,4,10,3,2,0,1,3,17,13,4,0,2018,reg
Justin Meram,Real Salt Lake,M,26,21,1867,2,4,56,15,2,0,4,0,16,21,0,0,2018,reg
Alvas Powell,,D,24,24,2072,2,3,25,9,1,1,3,0,23,26,1,0,2018,reg
Francisco Calvo ,Chicago Fire FC,D,26,26,2339,2,3,26,6,0,2,3,0,40,9,9,1,2018,reg
Michael de Leeuw,Chicago Fire FC,F,9,5,454,2,2,9,2,1,1,2,0,14,8,1,0,2018,reg
Jordon Mutch,Vancouver Whitecaps,M,18,8,830,2,2,12,5,1,1,0,2,14,10,1,0,2018,reg
Andrew Farrell,New England Revolution,D,31,30,2701,2,2,12,3,2,0,2,0,10,21,2,0,2018,reg
Jeremy Ebobisse,Portland Timbers,F,9,5,449,2,2,12,3,1,1,1,1,12,4,1,0,2018,reg
Marky Delgado,Toronto FC,M,28,21,1984,2,2,13,5,2,0,2,0,17,24,3,0,2018,reg
Nick Lima,San Jose Earthquakes,D,34,34,3049,2,2,16,6,1,1,2,0,20,49,2,0,2018,reg
Shkelzen Gashi,Colorado Rapids,M-F,21,9,814,2,2,20,5,1,1,2,0,17,3,3,0,2018,reg
Ronald Matarrita,New York City FC,D,24,15,1367,2,2,24,12,2,0,2,0,26,3,4,1,2018,reg
Kevin Molino,Minnesota United FC,M,2,2,140,2,1,4,3,0,2,0,1,3,3,0,0,2018,reg
Erik Hurtado,Sporting Kansas City,F,12,4,484,2,1,8,3,0,2,0,1,12,8,0,0,2018,reg
Jimmy Medranda ,Nashville SC,D,12,8,728,2,1,9,3,1,1,1,0,11,5,1,0,2018,reg
Handwalla Bwana,FC Dallas,M,12,6,491,2,1,10,2,0,2,1,0,4,6,0,0,2018,reg
Ethan Finlay,Minnesota United FC,M,7,7,570,2,1,10,5,0,2,1,0,8,8,1,0,2018,reg
Kevin Kratz,Atlanta United FC,M,27,2,500,2,1,10,7,2,0,1,0,13,3,0,0,2018,reg
Andrew Wenger,Houston Dynamo,D-M,22,20,1710,2,1,14,7,1,1,1,0,20,12,1,0,2018,reg
Kemar Lawrence,New York Red Bulls,D,28,27,2438,2,1,15,6,1,1,1,0,15,13,1,0,2018,reg
Ulises Segura,DC United,M,23,14,1292,2,1,19,8,2,0,1,0,15,23,1,0,2018,reg
Jack McBean,Colorado Rapids,F,22,13,1060,2,1,20,9,1,1,0,1,24,30,5,0,2018,reg
Jordan Hamilton,Columbus Crew SC,F,14,10,862,2,1,26,8,0,2,1,0,9,22,1,0,2018,reg
Carlos Gruezo,FC Dallas,M,31,28,2508,2,1,28,6,1,1,1,0,49,11,8,0,2018,reg
Cristian Lobato,Sporting Kansas City,D,7,3,327,2,0,6,4,2,0,0,0,3,2,0,0,2018,reg
Jay Simpson,Philadelphia Union,F,8,1,159,2,0,6,4,2,0,0,0,1,3,0,0,2018,reg
Michael Boxall,Minnesota United FC,D,32,32,2880,2,0,7,3,1,1,0,0,25,8,7,0,2018,reg
Jack Elliott,Philadelphia Union,D,17,16,1430,2,0,7,3,0,2,0,0,21,9,6,1,2018,reg
Diego Chara,Portland Timbers,M,27,26,2385,2,0,8,3,2,0,0,0,67,64,11,0,2018,reg
Tesho Akindele,Orlando City SC,F-M,19,5,577,2,0,9,7,2,0,0,0,9,5,0,0,2018,reg
Carlos Rivas,New York Red Bulls,F,5,3,264,2,0,10,6,2,0,0,0,5,3,0,0,2018,reg
Scott Caldwell,New England Revolution,M,24,20,1522,2,0,13,8,2,0,0,0,42,15,7,1,2018,reg
Anthony Jackson-Hamel,Montreal Impact,F,16,6,580,2,0,14,8,2,0,0,0,6,13,0,0,2018,reg
Matt Hedges,FC Dallas,D,33,33,2925,2,0,15,7,0,2,0,0,30,12,8,0,2018,reg
Steven Birnbaum,DC United,D,34,34,3060,2,0,17,6,0,2,0,0,33,8,4,0,2018,reg
Stefano Pinho,Orlando City SC,F,23,5,595,2,0,18,6,1,1,0,0,8,5,0,0,2018,reg
Cristian Colman,FC Dallas,F,15,6,606,2,0,21,11,1,1,0,0,10,7,0,1,2018,reg
Yannick Boli,Colorado Rapids,F,17,9,768,2,0,23,7,1,1,0,0,20,21,3,1,2018,reg
Alexander Ring,New York City FC,M,30,29,2608,2,0,30,8,1,1,0,0,66,16,10,0,2018,reg
Ashley Cole,LA Galaxy,D,31,30,2687,1,10,15,5,1,0,4,6,28,33,7,2,2018,reg
Boniek Garcia,Houston Dynamo,M,29,21,2063,1,7,6,1,1,0,4,3,43,23,7,0,2018,reg
Felipe,DC United,M,29,24,2203,1,7,26,8,1,0,6,1,29,56,4,0,2018,reg
Pedro Santos,Columbus Crew SC,M,30,29,2221,1,7,72,20,1,0,4,3,32,83,4,1,2018,reg
Milton Valenzuela,Columbus Crew SC,D,30,29,2557,1,6,17,4,1,0,3,3,27,26,6,0,2018,reg
Brandt Bronico,Chicago Fire FC,M,23,17,1531,1,5,10,3,0,1,1,4,19,12,4,0,2018,reg
Daniel Lovitz,Nashville SC,D,31,29,2650,1,5,11,1,1,0,2,3,27,21,3,1,2018,reg
Josue Colman,Orlando City SC,M,24,10,1054,1,5,28,11,1,0,2,3,4,8,0,0,2018,reg
Marco Ureña,LAFC,F,18,11,1015,1,5,28,12,1,0,0,5,11,9,0,0,2018,reg
Djordje Mihailovic,Chicago Fire FC,M,9,8,582,1,4,9,2,1,0,3,1,9,13,0,0,2018,reg
Brandon Vincent,Chicago Fire FC,D,32,31,2828,1,4,13,4,1,0,4,0,51,14,3,0,2018,reg
Rasmus Schuller,Minnesota United FC,M,31,29,2547,1,4,16,7,1,0,2,2,65,17,5,0,2018,reg
Michael Amir Murillo,New York Red Bulls,D,23,21,1935,1,4,19,5,1,0,1,3,36,24,4,1,2018,reg
Jack Price,Colorado Rapids,M,31,31,2750,1,4,21,8,1,0,4,0,30,12,10,0,2018,reg
Luis Alberto Caicedo,New England Revolution,M,30,29,2590,1,4,35,9,1,0,1,3,71,65,11,0,2018,reg
Greg Garza,FC Cincinnati,D,11,10,927,1,3,5,2,1,0,1,2,13,11,2,1,2018,reg
Rolf Feltscher,LA Galaxy,D,15,15,1295,1,3,7,2,0,1,2,1,24,10,6,0,2018,reg
Justin Morrow,Toronto FC,D,21,20,1790,1,3,8,5,0,1,2,1,13,18,3,0,2018,reg
Dave Romney,Nashville SC,D,28,26,2354,1,3,8,3,0,1,3,0,13,3,3,0,2018,reg
Jonathan Lewis,Colorado Rapids,F,14,0,219,1,3,10,2,1,0,2,1,4,2,0,0,2018,reg
Reggie Cannon,FC Dallas,D,33,33,2921,1,3,10,4,1,0,2,1,18,42,4,0,2018,reg
Ryan Hollingshead,FC Dallas,M,18,7,766,1,3,11,7,0,1,2,1,6,7,0,0,2018,reg
Cristhian Paredes,Portland Timbers,M,19,18,1418,1,3,21,8,1,0,3,0,11,14,1,0,2018,reg
Krisztian Nemeth,New England Revolution,F,24,8,852,1,3,27,10,0,1,3,0,18,14,1,0,2018,reg
Keegan Rosenberry,Colorado Rapids,D,32,31,2773,1,3,31,10,1,0,3,0,29,14,3,0,2018,reg
Russell Teibert,Vancouver Whitecaps,M,23,17,1604,1,2,5,1,0,1,1,1,24,7,3,0,2018,reg
Eric Alexander,Houston Dynamo,M,21,20,1662,1,2,7,1,1,0,2,0,17,10,3,1,2018,reg
Jukka Raitala,Montreal Impact,D,28,25,2290,1,2,8,2,0,1,2,0,32,8,2,0,2018,reg
Patrick Mullins,Toronto FC,F,20,4,510,1,2,10,4,0,1,0,2,14,20,0,0,2018,reg
Marcus Epps,Philadelphia Union,M,13,8,609,1,2,10,3,1,0,2,0,2,7,0,0,2018,reg
DaMarcus Beasley,Houston Dynamo,D,26,26,2208,1,2,11,7,0,1,1,1,15,39,0,1,2018,reg
Victor Ulloa,,M,27,25,2172,1,2,12,3,1,0,2,0,16,16,1,0,2018,reg
Brandon Bye,New England Revolution,D,24,16,1470,1,2,12,5,0,1,0,2,19,5,4,0,2018,reg
Leandro Gonzalez Pirez,,D,32,32,2775,1,2,13,5,0,1,1,1,50,41,8,1,2018,reg
Andres Flores,Portland Timbers,M,26,11,1159,1,2,14,2,0,1,1,1,12,16,1,0,2018,reg
Tim Parker,New York Red Bulls,D,29,29,2610,1,2,16,7,1,0,1,1,25,13,5,0,2018,reg
Eduard Atuesta,LAFC,M,25,16,1501,1,2,19,4,1,0,1,1,30,17,5,0,2018,reg
Diego Campos,Chicago Fire FC,D-M,23,13,1197,1,2,19,6,1,0,1,1,11,28,1,0,2018,reg
Jeff Larentowicz,Atlanta United FC,M,34,33,2771,1,2,24,4,0,1,2,0,38,14,6,0,2018,reg
Quincy Amarikwa,Montreal Impact,F,24,8,913,1,2,26,11,0,1,1,1,25,25,1,0,2018,reg
Andy Polo,Portland Timbers,M,23,18,1633,1,2,33,14,1,0,1,1,4,10,2,0,2018,reg
Kelyn Rowe,New England Revolution,M,27,18,1611,1,2,35,8,0,1,2,0,46,26,6,0,2018,reg
Yeferson Quintana,San Jose Earthquakes,D,13,10,794,1,1,4,2,1,0,1,0,14,6,3,0,2018,reg
Lucas Melano,Portland Timbers,F,7,1,143,1,1,5,4,0,1,1,0,1,3,1,0,2018,reg
Jacori Hayes,Minnesota United FC,M,16,10,998,1,1,8,4,0,1,1,0,17,28,2,0,2018,reg
Russell Canouse,DC United,M,20,17,1533,1,1,8,3,1,0,1,0,26,21,4,0,2018,reg
Wil Trapp,,M,30,29,2620,1,1,8,3,1,0,0,1,31,30,3,0,2018,reg
Gianluca Busio,Sporting Kansas City,M-F,7,1,153,1,1,8,1,0,1,0,1,1,2,0,0,2018,reg
Ryan Telfer,Toronto FC,F,15,9,813,1,1,8,3,1,0,1,0,8,9,1,0,2018,reg
Auston Trusty,Colorado Rapids,D,34,34,3060,1,1,10,2,1,0,1,0,41,13,4,0,2018,reg
Mike Grella,Columbus Crew SC,M,12,5,480,1,1,10,3,1,0,1,0,7,4,1,0,2018,reg
Eduardo Sosa,Columbus Crew SC,M,10,3,385,1,1,11,4,1,0,0,1,9,12,1,1,2018,reg
Abu Danladi,Nashville SC,F,16,5,483,1,1,12,6,0,1,0,1,17,8,1,0,2018,reg
Ricardo Clark,Columbus Crew SC,M,13,8,642,1,1,12,3,1,0,1,0,5,3,1,0,2018,reg
Bismark Adjei-Boateng,Colorado Rapids,M,20,14,1236,1,1,12,4,1,0,1,0,22,13,6,1,2018,reg
Oniel Fisher,DC United,D,24,20,1832,1,1,14,1,1,0,1,0,16,25,3,0,2018,reg
Magnus Wolff Eikrem,FC Dallas,M,15,6,594,1,1,15,3,1,0,0,1,10,3,2,0,2018,reg
Elliot Collier,Chicago Fire FC,F,16,9,904,1,1,15,5,0,1,1,0,9,7,1,0,2018,reg
Rodney Wallace,New York City FC,D,18,9,818,1,1,20,4,0,1,1,0,16,7,2,0,2018,reg
Anthony Blondell,Vancouver Whitecaps,F,18,8,641,1,1,20,7,1,0,1,0,13,9,1,0,2018,reg
Kyle Beckerman,Real Salt Lake,M,31,29,2621,1,1,23,5,1,0,0,1,50,25,8,0,2018,reg
Will Johnson,Orlando City SC,D,28,26,2194,1,1,33,13,1,0,1,0,28,34,7,0,2018,reg
Clint Dempsey,FC Dallas,M-F,14,9,902,1,1,39,12,1,0,1,0,8,19,1,1,2018,reg
Ben Mines,New York Red Bulls,M,1,1,90,1,0,1,1,1,0,0,0,1,2,1,0,2018,reg
Alex Crognale,Columbus Crew SC,D,5,0,97,1,0,1,1,1,0,0,0,0,0,0,0,2018,reg
Mitchell Taintor,Toronto FC,D,1,1,90,1,0,1,1,0,1,0,0,1,1,1,0,2018,reg
Nick Besler,Real Salt Lake,M,22,15,1431,1,0,2,1,1,0,0,0,13,15,1,0,2018,reg
Chris Tierney,New England Revolution,D-M,6,3,308,1,0,2,2,1,0,0,0,3,1,1,0,2018,reg
George Bello,Atlanta United FC,D,3,2,177,1,0,2,1,1,0,0,0,0,2,0,0,2018,reg
Kevin Garcia,Houston Dynamo,D,15,11,1103,1,0,3,1,1,0,0,0,5,4,0,0,2018,reg
Jordy Delem,FC Dallas,M,16,10,856,1,0,3,1,1,0,0,0,14,15,5,0,2018,reg
Chris Schuler,Orlando City SC,D,9,8,785,1,0,4,1,1,0,0,0,3,3,3,0,2018,reg
Lamine Sane,Orlando City SC,D,16,15,1373,1,0,4,2,1,0,0,0,10,4,1,0,2018,reg
Tyrone Mears,Minnesota United FC,D,11,10,883,1,0,5,3,0,1,0,0,6,9,3,0,2018,reg
Michael Ciani,LA Galaxy,D,21,19,1647,1,0,5,1,0,1,0,0,28,10,5,0,2018,reg
Leonardo,Houston Dynamo,D,24,19,1770,1,0,5,1,1,0,0,0,32,6,4,0,2018,reg
Tony Tchani,Chicago Fire FC,M,13,9,825,1,0,5,2,0,1,0,0,12,9,1,0,2018,reg
Anthony Fontana,Philadelphia Union,M,5,1,98,1,0,5,1,1,0,0,0,4,2,0,0,2018,reg
Jose Aja,Minnesota United FC,D,17,17,1512,1,0,5,1,1,0,0,0,21,3,4,1,2018,reg
Cole Bassett,Colorado Rapids,M,6,3,307,1,0,5,1,1,0,0,0,3,3,0,0,2018,reg
Wan Kuzain Wan Kamal,Sporting Kansas City,M,6,3,307,1,0,5,2,1,0,0,0,4,6,1,0,2018,reg
Brian White,New York Red Bulls,F,5,2,217,1,0,5,1,1,0,0,0,2,0,0,0,2018,reg
Amro Tarek,New York Red Bulls,D,20,19,1697,1,0,6,4,1,0,0,0,11,9,3,0,2018,reg
Rod Fanni,Montreal Impact,D,26,26,2290,1,0,6,2,1,0,0,0,14,17,0,0,2018,reg
Ebenezer Ofori,New York City FC,M,27,21,1895,1,0,7,2,1,0,0,0,36,8,3,1,2018,reg
Ronaldo Peña,Houston Dynamo,F,9,2,222,1,0,7,5,1,0,0,0,14,4,2,1,2018,reg
Joao Moutinho,Orlando City SC,D,14,10,872,1,0,7,1,0,1,0,0,11,6,2,1,2018,reg
Romario Williams,Atlanta United FC,F,17,0,211,1,0,8,3,1,0,0,0,6,10,4,0,2018,reg
Darwin Ceren,Houston Dynamo,M,24,20,1858,1,0,8,2,1,0,0,0,42,20,9,1,2018,reg
Lawrence Olum,Portland Timbers,D,22,18,1632,1,0,8,2,0,1,0,0,16,4,2,1,2018,reg
Brian Wright,New England Revolution,F,10,2,258,1,0,9,3,0,1,0,0,6,4,0,0,2018,reg
Micheal Azira,Chicago Fire FC,M,15,11,998,1,0,9,3,1,0,0,0,21,7,4,0,2018,reg
Lalas Abubakar,Colorado Rapids,D,23,20,1771,1,0,9,3,0,1,0,0,29,7,3,0,2018,reg
Chris McCann,Atlanta United FC,M-D,22,21,1800,1,0,10,4,1,0,0,0,22,19,6,0,2018,reg
Bacary Sagna,Montreal Impact,D,9,9,810,1,0,10,4,1,0,0,0,5,6,3,0,2018,reg
Maxime Chanot,New York City FC,D,18,18,1571,1,0,11,3,1,0,0,0,15,10,2,1,2018,reg
Bill Tuiloma,Portland Timbers,D-M,13,7,713,1,0,11,4,0,1,0,0,4,4,0,0,2018,reg
Memo Rodriguez,Houston Dynamo,M,19,6,645,1,0,12,2,1,0,0,0,8,13,1,0,2018,reg
Franco Escobar,Atlanta United FC,D,22,20,1789,1,0,14,3,1,0,0,0,32,15,7,0,2018,reg
Maynor Figueroa,Houston Dynamo,D,16,11,1008,1,0,14,6,1,0,0,0,9,3,2,0,2018,reg
Jonathan Mensah,Columbus Crew SC,D,27,26,2347,1,0,19,6,0,1,0,0,20,10,7,0,2018,reg
Valentin Castellanos,New York City FC,F,8,5,446,1,0,20,6,1,0,0,0,10,11,2,0,2018,reg
Alexander Callens,New York City FC,D,31,31,2750,1,0,21,2,1,0,0,0,37,30,6,0,2018,reg
Dairon Asprilla,Portland Timbers,M-F,17,7,688,1,0,23,9,1,0,0,0,16,11,3,0,2018,reg
Dillon Serna,Colorado Rapids,M,20,10,1181,1,0,24,7,0,1,0,0,10,19,3,0,2018,reg
David Accam,Nashville SC,F,23,13,1213,1,0,37,14,0,1,0,0,20,22,3,0,2018,reg
Sean Davis,New York Red Bulls,M,32,30,2579,0,8,8,3,0,0,7,1,25,27,1,0,2018,reg
Tyler Adams,New York Red Bulls,M,27,26,2328,0,7,13,1,0,0,4,3,45,47,3,0,2018,reg
Brooks Lennon,Atlanta United FC,D,33,32,2850,0,5,7,3,0,0,4,1,25,14,7,0,2018,reg
Kelvin Leerdam,FC Dallas,D,26,24,1967,0,5,11,2,0,0,2,3,19,6,4,1,2018,reg
Michael Bradley,Toronto FC,M,32,32,2857,0,5,13,3,0,0,3,2,26,9,6,0,2018,reg
Gregory van der Wiel,Toronto FC,D,27,25,2295,0,4,4,1,0,0,2,2,12,12,1,1,2018,reg
Johan Kappelhof,Chicago Fire FC,D,29,29,2604,0,4,5,2,0,0,3,1,39,12,9,1,2018,reg
Yangel Herrera,New York City FC,M,15,13,1111,0,4,21,7,0,0,1,3,37,39,4,0,2018,reg
Matt Besler,Sporting Kansas City,D,31,31,2745,0,3,1,0,0,0,2,1,18,11,2,0,2018,reg
Tony Rocha,New York City FC,M,12,9,819,0,3,7,2,0,0,1,2,12,20,1,0,2018,reg
Marcel de Jong,Vancouver Whitecaps,D-M,19,17,1392,0,3,10,3,0,0,3,0,15,11,3,0,2018,reg
Dax McCarty,Nashville SC,M,26,26,2259,0,3,10,2,0,0,3,0,31,34,5,0,2018,reg
Nicolas Hasler,Chicago Fire FC,D,24,19,1725,0,3,11,4,0,0,1,2,13,10,0,0,2018,reg
Samuel Piette,Montreal Impact,M,34,34,3000,0,3,11,2,0,0,2,1,41,35,5,0,2018,reg
Auro,Toronto FC,D,18,16,1424,0,3,12,2,0,0,1,2,16,24,3,0,2018,reg
Osvaldo Alonso,Minnesota United FC,M,25,21,1833,0,3,13,2,0,0,3,0,35,33,6,0,2018,reg
Jackson Yueill,San Jose Earthquakes,M,21,15,1293,0,3,15,2,0,0,2,1,7,14,0,0,2018,reg
Aaron Kovar,LAFC,M,11,7,523,0,3,16,5,0,0,2,1,8,8,0,0,2018,reg
Johan Blomberg,Colorado Rapids,M,24,21,1657,0,3,17,2,0,0,2,1,33,13,5,0,2018,reg
Darlington Nagbe,Columbus Crew SC,M,23,23,1970,0,3,18,2,0,0,1,2,15,23,0,0,2018,reg
Enzo Martinez,Colorado Rapids,M,22,15,1406,0,3,22,7,0,0,3,0,28,31,4,0,2018,reg
Michael Parkhurst,Atlanta United FC,D,33,32,2903,0,2,0,0,0,0,2,0,16,13,6,0,2018,reg
Ethan Kutler,New York Red Bulls,D,4,1,101,0,2,1,0,0,0,2,0,1,0,0,0,2018,reg
Saad Abdul-Salaam,FC Cincinnati,D,4,3,273,0,2,1,0,0,0,1,1,5,3,1,0,2018,reg
RJ Allen,Orlando City SC,D,18,10,966,0,2,3,0,0,0,1,1,19,2,2,0,2018,reg
Jorgen Skjelvik,LA Galaxy,D,32,29,2585,0,2,4,1,0,0,1,1,46,14,6,0,2018,reg
Efrain Juarez,Vancouver Whitecaps,M,16,14,1159,0,2,4,1,0,0,2,0,24,8,4,2,2018,reg
Joseph Mora,DC United,D,30,28,2523,0,2,4,0,0,0,1,1,17,26,3,1,2018,reg
Danilo Acosta,LA Galaxy,D,12,10,896,0,2,4,2,0,0,0,2,17,13,0,0,2018,reg
Marlon Hairston,Minnesota United FC,M,15,13,1107,0,2,5,1,0,0,1,1,6,11,1,0,2018,reg
Shea Salinas,San Jose Earthquakes,M,25,20,1820,0,2,5,1,0,0,1,1,22,12,3,1,2018,reg
Servando Carrasco,LA Galaxy,M,19,10,1001,0,2,6,3,0,0,2,0,15,6,3,0,2018,reg
Mikey Ambrose,,D,9,8,731,0,2,6,0,0,0,2,0,4,5,1,0,2018,reg
Junior Moreno,DC United,M,20,17,1528,0,2,7,2,0,0,1,1,21,14,1,0,2018,reg
Vincent Bezecourt,New York Red Bulls,M,9,5,395,0,2,7,2,0,0,2,0,6,10,1,0,2018,reg
Raymon Gaddis,Philadelphia Union,D,28,25,2298,0,2,11,5,0,0,1,1,12,26,1,0,2018,reg
Gabriel Somi,New England Revolution,D,14,12,1043,0,2,11,2,0,0,1,1,7,5,3,0,2018,reg
Perry Kitchen,LA Galaxy,M,31,27,2339,0,2,13,2,0,0,2,0,48,17,7,0,2018,reg
Seth Sinovic,New England Revolution,D,23,19,1650,0,2,13,2,0,0,1,1,18,13,4,1,2018,reg
Cristian Martinez,Columbus Crew SC,M,14,11,841,0,2,14,5,0,0,2,0,13,13,1,0,2018,reg
Anibal Godoy,Nashville SC,M-D,27,27,2348,0,2,15,3,0,0,0,2,61,71,8,0,2018,reg
Mohamed El-Munir,LAFC,D,26,23,2089,0,2,23,8,0,0,1,1,34,18,6,1,2018,reg
Artur,Columbus Crew SC,M,32,32,2784,0,2,43,9,0,0,1,1,47,27,5,0,2018,reg
Ian Harkes,DC United,M,8,4,352,0,1,0,0,0,0,0,1,4,1,0,0,2018,reg
Connor Maloney,Columbus Crew SC,D,1,0,28,0,1,0,0,0,0,0,1,1,0,1,0,2018,reg
Drew Conner,Chicago Fire FC,M,11,5,462,0,1,0,0,0,0,0,1,8,1,2,1,2018,reg
Ayo Akinola,Toronto FC,F,4,0,45,0,1,0,0,0,0,1,0,2,2,0,0,2018,reg
Luke Mulholland,Real Salt Lake,M,2,1,91,0,1,0,0,0,0,1,0,0,3,0,0,2018,reg
Carter Manley,Minnesota United FC,D,8,4,502,0,1,0,0,0,0,0,1,3,2,0,0,2018,reg
Chris Duvall,Portland Timbers,D,15,14,1195,0,1,1,0,0,0,0,1,19,11,4,0,2018,reg
Matt Polster,New England Revolution,D,3,1,126,0,1,1,0,0,0,1,0,2,1,0,0,2018,reg
Kyle Duncan,New York Red Bulls,D,4,4,360,0,1,1,0,0,0,1,0,4,3,0,0,2018,reg
Waylon Francis,Columbus Crew SC,D,11,5,582,0,1,1,0,0,0,0,1,9,4,1,0,2018,reg
Donny Toia,Real Salt Lake,D,4,3,238,0,1,1,0,0,0,0,1,6,2,0,0,2018,reg
Fernando Bob,Minnesota United FC,M,7,7,616,0,1,1,0,0,0,1,0,15,11,2,1,2018,reg
Jorge Villafaña,Portland Timbers,F,8,7,655,0,1,1,1,0,0,0,1,4,8,0,0,2018,reg
Baggio Husidic,LA Galaxy,M,7,1,206,0,1,1,0,0,0,1,0,3,1,1,0,2018,reg
Nedum Onuoha,Real Salt Lake,D,2,1,92,0,1,1,0,0,0,1,0,1,0,0,0,2018,reg
Jerome Thiesson,Minnesota United FC,D,14,13,1106,0,1,2,0,0,0,0,1,16,3,0,0,2018,reg
Aaron Maund,Vancouver Whitecaps,D,10,10,900,0,1,2,0,0,0,0,1,6,3,0,0,2018,reg
Ashtone Morgan,Real Salt Lake,D,18,11,1009,0,1,2,1,0,0,1,0,17,8,3,0,2018,reg
Bruno Miranda,DC United,F,7,0,86,0,1,2,0,0,0,0,1,2,3,1,0,2018,reg
Jonathan Campbell,Chicago Fire FC,D,15,11,1005,0,1,2,1,0,0,0,1,2,2,1,0,2018,reg
Jared Watts,Colorado Rapids,D-M,7,7,535,0,1,2,0,0,0,1,0,2,2,1,0,2018,reg
Eric Miller,Nashville SC,D,18,13,1145,0,1,2,0,0,0,1,0,8,6,3,0,2018,reg
Bernie Ibini,Vancouver Whitecaps,M-F,8,6,422,0,1,3,2,0,0,0,1,5,4,0,0,2018,reg
Warren Creavalle,Philadelphia Union,M,17,6,681,0,1,3,1,0,0,0,1,10,11,2,0,2018,reg
Brad Smith,FC Dallas,D,6,6,446,0,1,3,0,0,0,1,0,7,4,1,0,2018,reg
Daniel Steres ,LA Galaxy,D,20,14,1322,0,1,3,0,0,0,1,0,13,7,2,0,2018,reg
Hector Jimenez,Columbus Crew SC,M,11,7,655,0,1,4,3,0,0,1,0,6,3,1,0,2018,reg
Jonathan Spector,Orlando City SC,D,13,13,1060,0,1,4,1,0,0,1,0,9,9,2,0,2018,reg
Collin Martin,Minnesota United FC,M,12,5,518,0,1,4,3,0,0,1,0,12,6,2,0,2018,reg
Jake Nerwinski,Vancouver Whitecaps,D,26,24,2212,0,1,4,1,0,0,1,0,24,24,2,0,2018,reg
Andrew Carleton,Atlanta United FC,M,7,2,161,0,1,5,3,0,0,1,0,4,1,0,0,2018,reg
Jaylin Lindsey,Sporting Kansas City,D,7,6,555,0,1,5,1,0,0,0,1,5,2,0,0,2018,reg
Luis Felipe,San Jose Earthquakes,M,13,11,974,0,1,6,1,0,0,1,0,16,8,4,0,2018,reg
Adam Lundkvist,Houston Dynamo,D,16,12,1200,0,1,6,1,0,0,0,1,18,15,4,0,2018,reg
Anton Nedyalkov,FC Dallas,D,9,9,770,0,1,6,1,0,0,1,0,5,7,1,0,2018,reg
Connor Lade,New York Red Bulls,D,21,15,1315,0,1,6,0,0,0,1,0,25,19,3,0,2018,reg
Jordan Harvey,LAFC,D,29,23,2140,0,1,7,0,0,0,1,0,26,16,2,1,2018,reg
Danny Wilson,Colorado Rapids,D,23,22,1935,0,1,7,1,0,0,1,0,22,11,7,0,2018,reg
Chris Durkin,DC United,M,23,16,1503,0,1,7,1,0,0,0,1,20,15,4,0,2018,reg
Eric Remedi,Atlanta United FC,M,13,12,1093,0,1,8,1,0,0,0,1,17,23,3,0,2018,reg
Sunday Stephen,Real Salt Lake,M,23,16,1414,0,1,8,1,0,0,1,0,35,17,6,0,2018,reg
Arturo Alvarez,Houston Dynamo,M,18,2,341,0,1,8,3,0,0,0,1,5,5,1,0,2018,reg
Frederic Brillant,DC United,D,27,24,2181,0,1,9,1,0,0,1,0,24,9,1,0,2018,reg
Alex Roldan,FC Dallas,M,19,7,732,0,1,10,2,0,0,0,1,18,8,2,0,2018,reg
Mason Toye,Minnesota United FC,F,17,2,340,0,1,11,5,0,0,0,1,10,4,3,1,2018,reg
Nick DeLeon,Toronto FC,M,15,12,1062,0,1,11,4,0,0,0,1,11,11,2,0,2018,reg
Jalil Anibaba,Nashville SC,D,31,29,2706,0,1,11,3,0,0,1,0,30,10,3,0,2018,reg
Zarek Valentin,Houston Dynamo,D,32,30,2721,0,1,12,0,0,0,1,0,20,13,4,0,2018,reg
Luis Solignac,Chicago Fire FC,F,11,8,702,0,1,12,2,0,0,1,0,6,8,0,0,2018,reg
Nouhou Tolo,FC Dallas,D,28,23,2037,0,1,15,3,0,0,1,0,22,28,8,0,2018,reg
Ben Sweat,,D,28,24,2197,0,1,16,4,0,0,0,1,17,6,3,0,2018,reg
Julio Cascante,Portland Timbers,D,21,18,1729,0,1,16,6,0,0,0,1,21,9,1,0,2018,reg
Oriol Rosell,Orlando City SC,M-D,22,18,1701,0,1,17,6,0,0,0,1,29,7,6,0,2018,reg
Ager Aketxe,Toronto FC,M,11,9,732,0,1,26,7,0,0,0,1,4,20,1,0,2018,reg
Charlie Ward,Houston Dynamo,M,0,0,0,0,0,0,0,0,0,0,0,0,0,0,0,2018,reg
Joao Pedro,LA Galaxy,M,3,1,85,0,0,0,0,0,0,0,0,4,1,1,0,2018,reg
Dylan Remick,Houston Dynamo,D,0,0,0,0,0,0,0,0,0,0,0,0,0,0,0,2018,reg
Dane Kelly,DC United,F,1,0,3,0,0,0,0,0,0,0,0,0,0,0,0,2018,reg
Fatai Alashe,FC Cincinnati,M,12,2,353,0,0,0,0,0,0,0,0,10,6,1,0,2018,reg
Michael Salazar,Houston Dynamo,F,0,0,0,0,0,0,0,0,0,0,0,0,0,0,0,2018,reg
Caleb Calvert,Colorado Rapids,F,1,0,35,0,0,0,0,0,0,0,0,0,0,0,0,2018,reg
Cedric Hountondji,New York City FC,D,1,0,1,0,0,0,0,0,0,0,0,0,0,0,0,2018,reg
Mike da Fonte,Colorado Rapids,D,0,0,0,0,0,0,0,0,0,0,0,0,0,0,0,2018,reg
Jalen Robinson,DC United,D,5,5,348,0,0,0,0,0,0,0,0,2,2,0,0,2018,reg
Kyle Fisher,Montreal Impact,D,0,0,0,0,0,0,0,0,0,0,0,0,0,0,0,2018,reg
Christian Dean,Chicago Fire FC,D,2,2,178,0,0,0,0,0,0,0,0,2,1,0,0,2018,reg
Stefano Bonomo,New York Red Bulls,F,1,0,1,0,0,0,0,0,0,0,0,0,0,0,0,2018,reg
Joel Qwiberg,San Jose Earthquakes,D,5,5,379,0,0,0,0,0,0,0,0,7,3,0,0,2018,reg
Emrah Klimenta,LA Galaxy,D,2,2,156,0,0,0,0,0,0,0,0,1,1,0,0,2018,reg
Tommy Redding,New York Red Bulls,D,1,1,90,0,0,0,0,0,0,0,0,1,0,0,0,2018,reg
Rafael Ramos,Chicago Fire FC,D,3,1,105,0,0,0,0,0,0,0,0,3,2,1,0,2018,reg
Louis Beland-Goyette,Montreal Impact,M,4,0,109,0,0,0,0,0,0,0,0,1,0,1,0,2018,reg
Foster Langsdorf,Portland Timbers,F,0,0,0,0,0,0,0,0,0,0,0,0,0,0,0,2018,reg
Seyi Adekoya,FC Dallas,F,0,0,0,0,0,0,0,0,0,0,0,0,0,0,0,2018,reg
Mo Adams,Atlanta United FC,M,15,10,908,0,0,0,0,0,0,0,0,21,4,3,1,2018,reg
Jordan Morris,FC Dallas,F,0,0,0,0,0,0,0,0,0,0,0,0,0,0,0,2018,reg
Taylor Peay,Real Salt Lake,D,1,0,1,0,0,0,0,0,0,0,0,0,0,0,0,2018,reg
Jose Hernandez,Atlanta United FC,D,1,0,17,0,0,0,0,0,0,0,0,0,0,0,0,2018,reg
Anibal Chala,FC Dallas,D,0,0,0,0,0,0,0,0,0,0,0,0,0,0,0,2018,reg
Cristhian Machado,New England Revolution,M,3,2,119,0,0,0,0,0,0,0,0,2,1,1,0,2018,reg
Pierre Da Silva,Orlando City SC,M,2,0,49,0,0,0,0,0,0,0,0,0,2,0,0,2018,reg
Josh Perez,LAFC,F,2,0,22,0,0,0,0,0,0,0,0,0,1,0,0,2018,reg
Hugo Arellano,LA Galaxy,D,0,0,0,0,0,0,0,0,0,0,0,0,0,0,0,2018,reg
George Malki,Houston Dynamo,D,0,0,0,0,0,0,0,0,0,0,0,0,0,0,0,2018,reg
Richie Marquez,Philadelphia Union,D,0,0,0,0,0,0,0,0,0,0,0,0,0,0,0,2018,reg
Myer Bevan,Vancouver Whitecaps,F,0,0,0,0,0,0,0,0,0,0,0,0,0,0,0,2018,reg
Jordan Cano,FC Dallas,D,0,0,0,0,0,0,0,0,0,0,0,0,0,0,0,2018,reg
Kris Reaves,FC Dallas,D,2,2,168,0,0,0,0,0,0,0,0,1,0,0,0,2018,reg
Jon Gallagher,Atlanta United FC,F,0,0,0,0,0,0,0,0,0,0,0,0,0,0,0,2018,reg
Marco Farfan,Portland Timbers,D,11,6,515,0,0,0,0,0,0,0,0,9,5,0,0,2018,reg
Colton Storm,Sporting Kansas City,D,0,0,0,0,0,0,0,0,0,0,0,0,0,0,0,2018,reg
Adonijah Reid,FC Dallas,F,0,0,0,0,0,0,0,0,0,0,0,0,0,0,0,2018,reg
Ricardo Perez,Colorado Rapids,M,0,0,0,0,0,0,0,0,0,0,0,0,0,0,0,2018,reg
Hassan Ndam,FC Cincinnati,D,1,1,90,0,0,0,0,0,0,0,0,1,1,0,0,2018,reg
Adam Najem,Philadelphia Union,M,0,0,0,0,0,0,0,0,0,0,0,0,0,0,0,2018,reg
Andrew Wheeler-Omiunu,Atlanta United FC,M,1,0,16,0,0,0,0,0,0,0,0,0,0,0,0,2018,reg
David Choiniere,Montreal Impact,M,1,0,12,0,0,0,0,0,0,0,0,0,0,0,0,2018,reg
Nicolas Samayoa,New England Revolution,D,0,0,0,0,0,0,0,0,0,0,0,0,0,0,0,2018,reg
Gordon Wild,LA Galaxy,F,0,0,0,0,0,0,0,0,0,0,0,0,0,0,0,2018,reg
Alan Mariano Miño,Toronto FC,M,1,0,25,0,0,0,0,0,0,0,0,0,2,0,0,2018,reg
James Murphy,LAFC,M,0,0,0,0,0,0,0,0,0,0,0,0,0,0,0,2018,reg
Amer Didic,Sporting Kansas City,D,0,0,0,0,0,0,0,0,0,0,0,0,0,0,0,2018,reg
Jose Leiton,Minnesota United FC,M,0,0,0,0,0,0,0,0,0,0,0,0,0,0,0,2018,reg
Sam Hamilton,Colorado Rapids,M,0,0,0,0,0,0,0,0,0,0,0,0,0,0,0,2018,reg
Eryk Williamson,Portland Timbers,M,0,0,0,0,0,0,0,0,0,0,0,0,0,0,0,2018,reg
Francis Atuahene,FC Dallas,F,0,0,0,0,0,0,0,0,0,0,0,0,0,0,0,2018,reg
Daniel Bedoya,New York City FC,M,0,0,0,0,0,0,0,0,0,0,0,0,0,0,0,2018,reg
Roberto Dominguez,Vancouver Whitecaps,D,0,0,0,0,0,0,0,0,0,0,0,0,0,0,0,2018,reg
Femi Hollinger-Janzen,New England Revolution,F,0,0,0,0,0,0,0,0,0,0,0,0,0,0,0,2018,reg
Chris Goslin,Atlanta United FC,M,0,0,0,0,0,0,0,0,0,0,0,0,0,0,0,2018,reg
Bryan Reynolds,FC Dallas,D,0,0,0,0,0,0,0,0,0,0,0,0,0,0,0,2018,reg
Paxton Pomykal,FC Dallas,M,6,1,125,0,0,0,0,0,0,0,0,1,2,0,0,2018,reg
Brandon Servania,FC Dallas,M,0,0,0,0,0,0,0,0,0,0,0,0,0,0,0,2018,reg
Efrain Alvarez,LA Galaxy,M,0,0,0,0,0,0,0,0,0,0,0,0,0,0,0,2018,reg
Sam Vines,Colorado Rapids,D,1,0,45,0,0,0,0,0,0,0,0,0,0,0,0,2018,reg
Kip Colvey,Colorado Rapids,M,3,3,208,0,0,0,0,0,0,0,0,1,0,0,0,2018,reg
Nico Czornomaz,LAFC,M,0,0,0,0,0,0,0,0,0,0,0,0,0,0,0,2018,reg
Victor Arboleda,Portland Timbers,F-M,1,0,31,0,0,0,0,0,0,0,0,0,1,0,0,2018,reg
Zachary Herivaux,New England Revolution,M,5,2,158,0,0,0,0,0,0,0,0,3,5,1,0,2018,reg
Anatole Abang,New York Red Bulls,F,0,0,0,0,0,0,0,0,0,0,0,0,0,0,0,2018,reg
Eric Ayuk,Philadelphia Union,M,0,0,0,0,0,0,0,0,0,0,0,0,0,0,0,2018,reg
Conor Donovan,Houston Dynamo,D,0,0,0,0,0,0,0,0,0,0,0,0,0,0,0,2018,reg
Josh Yaro,Philadelphia Union,D,0,0,0,0,0,0,0,0,0,0,0,0,0,0,0,2018,reg
Shawn Barry,Real Salt Lake,D,4,3,204,0,0,0,0,0,0,0,0,2,6,1,0,2018,reg
Harold Cummings,San Jose Earthquakes,D,21,21,1875,0,0,0,0,0,0,0,0,14,15,3,1,2018,reg
Kacper Przybylko,Philadelphia Union,F,0,0,0,0,0,0,0,0,0,0,0,0,0,0,0,2018,reg
Taylor Kemp,DC United,D,0,0,0,0,0,0,0,0,0,0,0,0,0,0,0,2018,reg
Jack Barmby,Portland Timbers,M-D,0,0,0,0,0,0,0,0,0,0,0,0,0,0,0,2018,reg
Jose Villarreal,Orlando City SC,M,3,0,45,0,0,0,0,0,0,0,0,1,0,0,0,2018,reg
Oliver Shannon,Atlanta United FC,M,0,0,0,0,0,0,0,0,0,0,0,0,0,0,0,2018,reg
Moises Hernandez,FC Dallas,D,0,0,0,0,0,0,0,0,0,0,0,0,0,0,0,2018,reg
Zakaria Diallo,Montreal Impact,D,0,0,0,0,0,0,0,0,0,0,0,0,0,0,0,2018,reg
Dillon Powers,Orlando City SC,M,3,0,69,0,0,0,0,0,0,0,0,1,1,0,0,2018,reg
Sheanon Williams,LA Galaxy,D-M,8,1,153,0,0,0,0,0,0,0,0,1,1,0,0,2018,reg
Marvin Emnes,Vancouver Whitecaps,M,0,0,0,0,0,0,0,0,0,0,0,0,0,0,0,2018,reg
Stefan Aigner,Colorado Rapids,M-F,1,0,11,0,0,0,0,0,0,0,0,1,0,0,0,2018,reg
David Edgar,Vancouver Whitecaps,D,0,0,0,0,0,0,0,0,0,0,0,0,0,0,0,2018,reg
Brad Evans,Sporting Kansas City,D-M,0,0,0,0,0,0,0,0,0,0,0,0,0,0,0,2018,reg
Marc Burch,Minnesota United FC,D,6,5,403,0,0,0,0,0,0,0,0,2,2,1,0,2018,reg
Roy Miller,Portland Timbers,D,0,0,0,0,0,0,0,0,0,0,0,0,0,0,0,2018,reg
Sal Zizzo,Atlanta United FC,D,6,1,157,0,0,0,0,0,0,0,0,4,0,0,0,2018,reg
Sean Franklin,Vancouver Whitecaps,D,11,9,834,0,0,0,0,0,0,0,0,12,2,0,0,2018,reg
Tony Beltran,Real Salt Lake,D,0,0,0,0,0,0,0,0,0,0,0,0,0,0,0,2018,reg
Vytas,DC United,D,3,0,21,0,0,0,0,0,0,0,0,1,0,0,0,2018,reg
Jared Jeffrey,DC United,M,2,0,2,0,0,0,0,0,0,0,0,0,0,0,0,2018,reg
Sam Cronin,Minnesota United FC,M,0,0,0,0,0,0,0,0,0,0,0,0,0,0,0,2018,reg
A.J. DeLaGarza,,D,4,4,360,0,0,0,0,0,0,0,0,6,2,0,0,2018,reg
Alfredo Ortuño,Real Salt Lake,F,3,1,119,0,0,0,0,0,0,0,0,1,1,0,0,2018,reg
Gaston Sauro,Columbus Crew SC,D,7,6,521,0,0,0,0,0,0,0,0,12,2,1,0,2018,reg
Andreu Fontas,Sporting Kansas City,D,2,1,92,0,0,0,0,0,0,0,0,1,2,0,0,2018,reg
Lagos Kunga,Atlanta United FC,F,0,0,0,0,0,0,0,0,0,0,0,0,0,0,0,2018,reg
David Norman Jr.,,M,0,0,0,0,0,0,0,0,0,0,0,0,0,0,0,2018,reg
Felix Chenkam,FC Dallas,F,0,0,0,0,0,0,0,0,0,0,0,0,0,0,0,2018,reg
Rodrigo Pacheco,LAFC,F,1,0,17,0,0,0,0,0,0,0,0,0,0,0,0,2018,reg
Mark Segbers,New England Revolution,M-D,1,0,45,0,0,0,0,0,0,0,0,1,1,0,0,2018,reg
Julian Dunn,Toronto FC,D,2,1,105,0,0,0,0,0,0,0,0,0,1,0,0,2018,reg
Paul Marie,San Jose Earthquakes,D,0,0,0,0,0,0,0,0,0,0,0,0,0,0,0,2018,reg
Jacob Akanyirige,San Jose Earthquakes,D,0,0,0,0,0,0,0,0,0,0,0,0,0,0,0,2018,reg
Gilbert Fuentes,San Jose Earthquakes,M,1,0,1,0,0,0,0,0,0,0,0,1,0,0,0,2018,reg
Matt Lewis,Sporting Kansas City,D,0,0,0,0,0,0,0,0,0,0,0,0,0,0,0,2018,reg
Wyatt Omsberg,Chicago Fire FC,D,7,4,385,0,0,0,0,0,0,0,0,4,1,1,0,2018,reg
Joe Scally,New York City FC,D,0,0,0,0,0,0,0,0,0,0,0,0,0,0,0,2018,reg
Mohamed Thiaw,San Jose Earthquakes,F,0,0,0,0,0,0,0,0,0,0,0,0,0,0,0,2018,reg
Nicolas Del Grecco,Chicago Fire FC,D,0,0,0,0,0,0,0,0,0,0,0,0,0,0,0,2018,reg
Bertrand Owundi Eko'o,Minnesota United FC,D,0,0,0,0,0,0,0,0,0,0,0,0,0,0,0,2018,reg
Olivier Mbaizo,Philadelphia Union,D,1,1,85,0,0,0,0,0,0,0,0,1,1,1,0,2018,reg
Edward Opoku,Columbus Crew SC,F,5,1,150,0,0,1,1,0,0,0,0,3,5,0,0,2018,reg
Cristian Casseres Jr.,New York Red Bulls,M,3,1,97,0,0,1,0,0,0,0,0,3,1,1,0,2018,reg
Ema Twumasi,FC Dallas,F,1,1,45,0,0,1,0,0,0,0,0,1,0,0,0,2018,reg
Ricky Lopez-Espin,Real Salt Lake,F,1,0,22,0,0,1,0,0,0,0,0,1,0,0,0,2018,reg
Tristan Blackmon,LAFC,D,10,5,492,0,0,1,1,0,0,0,0,10,4,1,0,2018,reg
Kevin Partida,San Jose Earthquakes,M,4,4,290,0,0,1,0,0,0,0,0,6,5,1,1,2018,reg
Shaft Brewer Jr.,LAFC,M-D,3,0,29,0,0,1,0,0,0,0,0,2,1,0,0,2018,reg
Michael Mancienne,New England Revolution,D,10,10,900,0,0,1,1,0,0,0,0,7,3,2,0,2018,reg
Francois Affolter,San Jose Earthquakes,D,9,7,676,0,0,1,0,0,0,0,0,9,2,2,0,2018,reg
Liam Ridgewell,Portland Timbers,D,13,13,1085,0,0,1,1,0,0,0,0,6,16,2,1,2018,reg
Drew Moor,Colorado Rapids,D,8,6,568,0,0,1,1,0,0,0,0,0,6,0,0,2018,reg
Yura Movsisyan,Chicago Fire FC,F,4,0,58,0,0,1,0,0,0,0,0,2,0,0,0,2018,reg
Jason Hernandez,Toronto FC,D,10,7,534,0,0,1,0,0,0,0,0,5,4,2,0,2018,reg
Mohammed Abu,DC United,M,4,0,93,0,0,1,0,0,0,0,0,3,2,0,0,2018,reg
Calum Mallace,LAFC,M,5,0,29,0,0,1,0,0,0,0,0,0,0,0,0,2018,reg
Adam Henley,Real Salt Lake,D,5,2,260,0,0,1,0,0,0,0,0,3,3,1,0,2018,reg
Matthew Real,Philadelphia Union,D,3,3,236,0,0,1,0,0,0,0,0,5,2,1,0,2018,reg
Modou Jadama,Portland Timbers,D,1,0,27,0,0,1,1,0,0,0,0,0,0,0,0,2018,reg
Tomas Conechny,Portland Timbers,M,4,1,72,0,0,1,0,0,0,0,0,0,0,0,0,2018,reg
Tony Alfaro,FC Dallas,D,4,3,220,0,0,1,0,0,0,0,0,7,0,2,1,2018,reg
Isaac Angking,New England Revolution,M,3,0,37,0,0,1,0,0,0,0,0,0,0,0,0,2018,reg
Chris Odoi-Atsem,DC United,D,1,0,12,0,0,1,1,0,0,0,0,0,0,0,0,2018,reg
Grant Lillard,,D,8,6,562,0,0,1,0,0,0,0,0,3,0,1,0,2018,reg
Brett Levis,Vancouver Whitecaps,D,14,13,960,0,0,1,0,0,0,0,0,12,8,0,0,2018,reg
Miles Robinson,Atlanta United FC,D,10,3,272,0,0,1,0,0,0,0,0,2,3,0,0,2018,reg
Kwame Awuah,New York City FC,M,6,1,143,0,0,1,0,0,0,0,0,5,1,0,0,2018,reg
Aidan Daniels,Toronto FC,M,1,0,12,0,0,1,0,0,0,0,0,0,0,0,0,2018,reg
Bradford Jamieson IV,LA Galaxy,F,6,3,271,0,0,1,0,0,0,0,0,10,3,1,0,2018,reg
Graham Smith,Sporting Kansas City,D,2,2,180,0,0,1,0,0,0,0,0,1,0,0,0,2018,reg
Tomas Hilliard-Arce,LA Galaxy,D,5,4,304,0,0,1,1,0,0,0,0,5,0,0,0,2018,reg
Victor Cabrera,Houston Dynamo,D,13,10,920,0,0,1,1,0,0,0,0,17,2,1,1,2018,reg
Harrison Heath,Minnesota United FC,M,4,1,121,0,0,1,0,0,0,0,0,3,0,2,1,2018,reg
Kharlton Belmar,Sporting Kansas City,F,4,0,65,0,0,2,0,0,0,0,0,2,1,0,0,2018,reg
Fabinho,Philadelphia Union,D,11,8,714,0,0,2,0,0,0,0,0,8,8,1,0,2018,reg
Cameron Lindley,Orlando City SC,M,3,3,201,0,0,2,0,0,0,0,0,2,3,1,0,2018,reg
Daniel Johnson,Chicago Fire FC,M,7,3,261,0,0,2,2,0,0,0,0,5,1,0,0,2018,reg
Shamit Shome,Montreal Impact,M,5,2,249,0,0,2,0,0,0,0,0,2,1,0,0,2018,reg
Jesus Ferreira,FC Dallas,F,1,0,3,0,0,2,0,0,0,0,0,0,0,0,0,2018,reg
Jordan McCrary,FC Dallas,D,15,9,890,0,0,2,0,0,0,0,0,12,11,3,1,2018,reg
Emiliano Amor,Sporting Kansas City,D,5,3,332,0,0,2,0,0,0,0,0,2,2,1,0,2018,reg
Omar Gaber,LAFC,D-M,7,2,254,0,0,2,0,0,0,0,0,3,2,1,0,2018,reg
Chris Mavinga,Toronto FC,D,12,11,935,0,0,2,0,0,0,0,0,12,5,3,1,2018,reg
Dominic Oduro,Montreal Impact,M,10,0,62,0,0,2,0,0,0,0,0,1,1,0,0,2018,reg
Marco Donadel,Montreal Impact,M,2,1,96,0,0,2,0,0,0,0,0,1,0,2,0,2018,reg
David Horst,Real Salt Lake,D,5,3,312,0,0,2,0,0,0,0,0,2,8,0,0,2018,reg
Aurelien Collin,Philadelphia Union,D,7,5,353,0,0,2,0,0,0,0,0,11,1,2,0,2018,reg
Demar Phillips,Real Salt Lake,D,5,5,360,0,0,2,0,0,0,0,0,5,2,2,0,2018,reg
Mathieu Choiniere,Montreal Impact,M,5,0,82,0,0,2,0,0,0,0,0,1,2,0,0,2018,reg
Simon Colyn,Vancouver Whitecaps,M,1,0,4,0,0,2,0,0,0,0,0,0,0,0,0,2018,reg
Mac Steeves,Houston Dynamo,F,3,0,26,0,0,2,1,0,0,0,0,0,0,0,0,2018,reg
Aaron Herrera,Real Salt Lake,D,16,14,1236,0,0,3,1,0,0,0,0,13,11,2,0,2018,reg
Danilo Silva,LAFC,D,10,9,722,0,0,3,1,0,0,0,0,10,6,2,0,2018,reg
Dejan Jakovic,LAFC,D,15,13,1147,0,0,3,0,0,0,0,0,8,2,2,1,2018,reg
Abel Aguilar,FC Dallas,M,4,1,131,0,0,3,0,0,0,0,0,4,2,0,0,2018,reg
Lamar Neagle,FC Dallas,M,6,0,110,0,0,3,1,0,0,0,0,2,5,1,0,2018,reg
Eric Calvillo,San Jose Earthquakes,M,3,2,165,0,0,3,2,0,0,0,0,5,2,1,0,2018,reg
Deklan Wynne,Colorado Rapids,D,25,22,2006,0,0,3,0,0,0,0,0,24,8,3,1,2018,reg
Fidel Escobar,New York Red Bulls,D,6,4,374,0,0,3,1,0,0,0,0,2,2,0,0,2018,reg
James Sands,New York City FC,M,3,3,223,0,0,3,1,0,0,0,0,8,3,0,0,2018,reg
Chris Wehan,San Jose Earthquakes,M,6,2,183,0,0,3,0,0,0,0,0,3,0,0,0,2018,reg
Adam Jahn,Atlanta United FC,F,8,0,68,0,0,3,0,0,0,0,0,3,2,0,0,2018,reg
Michael Petrasso,Montreal Impact,D,14,8,782,0,0,3,0,0,0,0,0,16,8,2,0,2018,reg
Henry Wingo,FC Dallas,M,5,1,144,0,0,3,1,0,0,0,0,3,2,1,0,2018,reg
Thomas McNamara,Houston Dynamo,M,10,4,370,0,0,3,0,0,0,0,0,7,2,4,0,2018,reg
Guillermo Hauche,New England Revolution,F-M,4,2,175,0,0,4,0,0,0,0,0,6,4,1,0,2018,reg
Brent Kallman,Minnesota United FC,D,24,22,1953,0,0,4,2,0,0,0,0,15,23,0,0,2018,reg
Carlos Ascues,Orlando City SC,D,9,9,755,0,0,4,1,0,0,0,0,8,4,2,0,2018,reg
Ben Spencer,Toronto FC,F,2,1,82,0,0,4,2,0,0,0,0,2,1,0,0,2018,reg
Eriq Zavaleta,Toronto FC,D,21,16,1488,0,0,4,0,0,0,0,0,15,3,4,0,2018,reg
Juan David Cabezas,Houston Dynamo,M,6,4,290,0,0,4,1,0,0,0,0,10,2,1,0,2018,reg
Jon Bakero,Chicago Fire FC,F,7,3,224,0,0,4,0,0,0,0,0,5,1,0,0,2018,reg
Brandon Vazquez,FC Cincinnati,F,8,0,86,0,0,4,2,0,0,0,0,1,3,1,0,2018,reg
Richie Laryea,Toronto FC,M,9,2,253,0,0,4,0,0,0,0,0,3,12,2,0,2018,reg
Axel Sjöberg,Columbus Crew SC,D,17,15,1334,0,0,4,2,0,0,0,0,12,7,0,0,2018,reg
Marcelo Silva,Real Salt Lake,D,18,18,1557,0,0,4,2,0,0,0,0,26,10,7,0,2018,reg
Collen Warner,Colorado Rapids,M,17,14,1239,0,0,4,0,0,0,0,0,35,15,6,1,2018,reg
Frantz Pangop,Minnesota United FC,M,9,1,175,0,0,4,0,0,0,0,0,1,7,0,0,2018,reg
Luis Gil,Houston Dynamo,M,12,3,272,0,0,5,3,0,0,0,0,3,2,1,0,2018,reg
Jorge Corrales,Montreal Impact,D,17,15,1292,0,0,5,1,0,0,0,0,14,11,5,0,2018,reg
Adolfo Machado,Houston Dynamo,D,21,18,1696,0,0,5,0,0,0,0,0,26,6,3,0,2018,reg
Giles Barnes,Colorado Rapids,M,12,6,543,0,0,5,1,0,0,0,0,6,18,0,0,2018,reg
Antonio Mlinar Delamea,New England Revolution,D,18,18,1516,0,0,5,0,0,0,0,0,26,11,8,1,2018,reg
Eloi Amagat,New York City FC,M,8,5,430,0,0,5,1,0,0,0,0,8,9,0,1,2018,reg
Mark McKenzie,Philadelphia Union,D,19,18,1629,0,0,5,1,0,0,0,0,14,7,4,0,2018,reg
Fabian Herbers,Chicago Fire FC,F,9,5,428,0,0,5,1,0,0,0,0,6,7,0,0,2018,reg
Liam Fraser,Toronto FC,M,10,7,615,0,0,5,2,0,0,0,0,10,4,2,0,2018,reg
Kortne Ford,Colorado Rapids,D,15,14,1141,0,0,5,1,0,0,0,0,19,6,7,0,2018,reg
Derrick Jones,Nashville SC,M,12,3,385,0,0,6,1,0,0,0,0,11,9,2,0,2018,reg
Maximiano,Minnesota United FC,M,11,6,576,0,0,6,1,0,0,0,0,18,7,6,1,2018,reg
Ariel Lassiter,LA Galaxy,F,7,1,94,0,0,6,3,0,0,0,0,1,3,0,0,2018,reg
PC,Orlando City SC,D,8,5,418,0,0,6,1,0,0,0,0,6,7,1,1,2018,reg
Andreas Ivan,New York Red Bulls,M,9,1,185,0,0,6,1,0,0,0,0,5,4,3,0,2018,reg
Guram Kashia,San Jose Earthquakes,D,12,12,1080,0,0,6,2,0,0,0,0,7,5,3,0,2018,reg
Shane O'Neill,FC Dallas,D,13,13,1118,0,0,6,1,0,0,0,0,9,3,0,1,2018,reg
Doneil Henry,Vancouver Whitecaps,D,14,14,1260,0,0,6,1,0,0,0,0,15,2,2,0,2018,reg
Marquinhos Pedroso,FC Dallas,D,13,13,1170,0,0,7,1,0,0,0,0,23,9,3,0,2018,reg
Kim Kee-hee,FC Dallas,D,29,28,2444,0,0,7,0,0,0,0,0,26,13,4,0,2018,reg
Eric Bird,Houston Dynamo,M,6,4,340,0,0,7,3,0,0,0,0,9,1,0,0,2018,reg
Aly Ghazal,Vancouver Whitecaps,M,22,17,1446,0,0,7,1,0,0,0,0,23,7,2,0,2018,reg
Pablo Aranguiz,FC Dallas,M,9,3,282,0,0,7,3,0,0,0,0,5,8,0,0,2018,reg
Kofi Opare,DC United,D,11,10,863,0,0,8,0,0,0,0,0,6,2,1,0,2018,reg
Josh Williams,Columbus Crew SC,D,21,16,1485,0,0,8,2,0,0,0,0,17,7,3,0,2018,reg
Rudy Camacho,Montreal Impact,D,18,18,1566,0,0,9,2,0,0,0,0,13,3,2,0,2018,reg
Roman Torres,,D,13,7,688,0,0,9,1,0,0,0,0,6,1,1,0,2018,reg
Jimmy Ockford,San Jose Earthquakes,D,15,11,1085,0,0,9,1,0,0,0,0,18,2,3,0,2018,reg
Tommy Thompson,San Jose Earthquakes,D,14,6,630,0,0,9,3,0,0,0,0,8,17,0,0,2018,reg
Sebastien Ibeagha,New York City FC,D,26,18,1717,0,0,10,3,0,0,0,0,14,14,1,0,2018,reg
Justen Glad,Real Salt Lake,D,33,33,2910,0,0,11,5,0,0,0,0,35,17,6,0,2018,reg
Andre Horta,LAFC,M,11,3,319,0,0,11,2,0,0,0,0,2,5,0,0,2018,reg
Luis Argudo,,M,18,6,630,0,0,11,2,0,0,0,0,15,8,0,0,2018,reg
Ken Krolicki,Montreal Impact,M,24,18,1588,0,0,12,4,0,0,0,0,17,30,5,0,2018,reg
Pablo Ruiz,Real Salt Lake,M,12,5,530,0,0,13,3,0,0,0,0,7,2,2,0,2018,reg
Claude Dielna,New England Revolution,D,17,15,1334,0,0,20,7,0,0,0,0,28,6,5,1,2018,reg
Alexi Gomez,Minnesota United FC,M-D,18,16,1322,0,0,22,7,0,0,0,0,20,16,4,0,2018,reg
Carlos Vela,LAFC,F,31,31,2726,34,15,160,71,18,16,10,5,12,86,1,0,2019,reg
Zlatan Ibrahimovic,LA Galaxy,F,29,29,2610,30,7,151,65,22,8,2,5,51,28,7,0,2019,reg
Josef Martinez,Atlanta United FC,F,29,29,2581,27,4,117,50,16,11,4,0,17,29,1,0,2019,reg
Diego Rossi,LAFC,F,34,33,2899,16,7,108,49,7,9,2,5,14,38,1,0,2019,reg
Heber,New York City FC,F,22,18,1575,15,4,56,26,6,9,3,1,20,17,1,0,2019,reg
Kacper Przybylko,Philadelphia Union,F,26,25,2241,15,4,81,37,8,7,3,1,37,24,5,0,2019,reg
Chris Wondolowski,San Jose Earthquakes,F,32,24,1982,15,2,79,33,8,7,1,1,17,9,3,1,2019,reg
Kei Kamara,Colorado Rapids,F,29,29,2541,14,1,94,44,10,4,0,1,39,47,5,1,2019,reg
Mauro Manotas,Houston Dynamo,F,32,28,2539,13,8,92,30,10,3,5,3,17,13,0,0,2019,reg
CJ Sapong,Chicago Fire FC,F,32,29,2551,13,2,62,27,8,5,2,0,43,56,3,0,2019,reg
Gyasi Zardes,Columbus Crew SC,F,28,28,2478,13,2,62,26,4,9,1,1,27,36,0,0,2019,reg
Alejandro Pozuelo,Toronto FC,M,30,28,2524,12,12,76,31,10,2,6,6,32,54,4,1,2019,reg
Nani,Orlando City SC,M,30,26,2277,12,10,64,26,8,4,4,6,26,37,4,0,2019,reg
Felipe Gutiérrez,Sporting Kansas City,M,32,31,2722,12,3,65,29,3,9,3,0,58,57,11,0,2019,reg
Alexandru Mitrita,New York City FC,F,29,24,2131,12,3,94,34,8,4,1,2,18,49,2,0,2019,reg
Nemanja Nikolic,Chicago Fire FC,F,31,25,2003,12,0,48,22,8,4,0,0,15,16,3,0,2019,reg
Wayne Rooney,DC United,F-M,28,27,2318,11,8,84,27,6,5,6,2,21,32,5,2,2019,reg
Daniel Royer,New York Red Bulls,M,31,26,2321,11,8,85,38,7,4,5,3,17,35,1,0,2019,reg
Jozy Altidore,Toronto FC,F,22,18,1691,11,7,50,24,6,5,5,2,30,33,4,0,2019,reg
Valentin Castellanos,New York City FC,F,30,23,2052,11,7,80,31,6,5,3,4,51,44,7,0,2019,reg
Pedro Santos,Columbus Crew SC,M,33,30,2763,11,6,75,21,8,3,3,3,33,81,7,0,2019,reg
Diego Rubio,Colorado Rapids,F,26,25,2065,11,5,49,15,6,5,2,3,40,63,10,1,2019,reg
Raul Ruidiaz ,FC Dallas,F,22,20,1793,11,3,72,28,6,5,1,2,18,16,0,0,2019,reg
Jeremy Ebobisse,Portland Timbers,F,34,25,2310,11,1,52,21,7,4,1,0,23,26,3,0,2019,reg
Brian Fernandez,Portland Timbers,F,19,16,1411,11,1,69,30,6,5,1,0,23,7,4,1,2019,reg
Carles Gil,New England Revolution,F,34,34,3052,10,14,67,24,3,7,6,8,15,87,6,0,2019,reg
Jordan Morris,FC Dallas,F,26,24,2047,10,7,42,20,7,3,5,2,16,13,2,0,2019,reg
Albert Rusnak,Real Salt Lake,M,29,28,2456,10,5,76,31,4,6,5,0,13,33,2,0,2019,reg
Darwin Quintero,Houston Dynamo,F,30,26,2208,10,5,81,27,4,6,2,3,27,33,5,0,2019,reg
Tesho Akindele,Orlando City SC,F-M,28,22,1880,10,2,42,21,7,3,2,0,20,16,1,0,2019,reg
Alberth Elis,Houston Dynamo,F,26,22,1921,9,10,82,33,7,2,8,2,38,56,6,1,2019,reg
Johnny Russell,Sporting Kansas City,F,28,24,2115,9,9,56,22,8,1,5,4,16,41,1,0,2019,reg
Saphir Taider,Montreal Impact,F,32,31,2728,9,7,73,24,3,6,4,3,24,57,2,0,2019,reg
Christian Ramirez,Houston Dynamo,F,27,20,1628,9,3,52,28,7,2,1,2,5,9,0,0,2019,reg
Brian White,New York Red Bulls,F,19,17,1345,9,2,29,12,3,6,1,1,13,9,1,0,2019,reg
Gustavo Bou,New England Revolution,F,14,13,1155,9,2,61,25,5,4,1,1,8,14,1,0,2019,reg
Sam Johnson,Real Salt Lake,F,24,15,1301,9,0,31,12,6,3,0,0,15,11,1,0,2019,reg
Diego Valeri,Portland Timbers,M,31,29,2600,8,16,83,32,5,3,8,8,26,32,4,0,2019,reg
Adama Diomande,LAFC,F,25,15,1436,8,7,58,18,4,4,3,4,20,16,1,0,2019,reg
Jesus Ferreira,FC Dallas,F,33,29,2453,8,6,59,22,5,3,4,2,27,21,5,0,2019,reg
Jefferson Savarino,Real Salt Lake,F,28,27,2320,8,5,79,37,8,0,4,1,21,56,1,1,2019,reg
Vako,San Jose Earthquakes,M,32,24,2097,8,5,110,36,4,4,3,2,19,22,1,0,2019,reg
Fredy Montero,Vancouver Whitecaps,F,32,22,2098,8,3,60,24,5,3,1,2,35,48,2,1,2019,reg
Krisztian Nemeth,Sporting Kansas City,F,24,18,1559,8,2,53,18,7,1,1,1,29,27,5,1,2019,reg
Orji Okwonkwo,Montreal Impact,M,28,24,1784,8,2,55,15,6,2,2,0,33,16,4,0,2019,reg
Maximiliano Moralez,New York City FC,M,29,28,2434,7,20,51,25,5,2,10,10,48,79,7,0,2019,reg
Nicolás Lodeiro,FC Dallas,M,28,28,2500,7,12,53,18,4,3,10,2,45,108,7,0,2019,reg
Memo Rodriguez,Houston Dynamo,M,26,16,1392,7,5,47,20,5,2,3,2,19,29,3,0,2019,reg
Dom Dwyer,Orlando City SC,F,27,16,1614,7,4,66,26,4,3,1,3,37,33,7,1,2019,reg
Ethan Finlay,Minnesota United FC,M,33,22,1912,7,3,36,11,4,3,3,0,18,21,3,0,2019,reg
Andre Shinyashiki,Colorado Rapids,F,31,18,1670,7,3,51,19,5,2,2,1,26,31,3,0,2019,reg
Zdenek Ondrasek,FC Dallas,F,17,7,747,7,2,26,15,6,1,2,0,20,7,2,0,2019,reg
Allan Cruz,FC Cincinnati,M,22,21,1743,7,1,38,21,5,2,1,0,19,41,5,0,2019,reg
Yordy Reyna,Vancouver Whitecaps,M-F,25,22,1988,7,1,60,27,3,4,1,0,35,54,5,0,2019,reg
Marco Fabian,Philadelphia Union,M,23,15,1249,7,1,65,21,4,3,0,1,25,21,5,1,2019,reg
Julian Gressel,DC United,M,33,31,2693,6,12,69,25,4,2,9,3,36,14,3,0,2019,reg
Sebastian Blanco,Portland Timbers,M-F,30,28,2511,6,11,106,32,2,4,4,7,38,26,8,0,2019,reg
Magnus Eriksson,San Jose Earthquakes,F,32,32,2807,6,10,88,23,5,1,7,3,34,68,5,0,2019,reg
Cristian Penilla,New England Revolution,F,30,18,1780,6,8,58,20,3,3,6,2,20,31,2,0,2019,reg
Aleksandar Katai,Chicago Fire FC,M,29,24,2103,6,7,105,31,4,2,4,3,40,23,3,1,2019,reg
Latif Blessing,LAFC,F,34,29,2689,6,6,42,10,4,2,3,3,54,90,7,0,2019,reg
Cristian Roldan,FC Dallas,M,29,29,2538,6,5,31,10,4,2,5,0,26,62,4,1,2019,reg
Uriel Antuna,LA Galaxy,M,31,29,2427,6,5,49,18,4,2,3,2,23,54,1,0,2019,reg
Emmanuel Ledesma,FC Cincinnati,M,26,20,1767,6,5,49,12,2,4,4,1,29,35,4,0,2019,reg
Damir Kreilach,Real Salt Lake,M,32,32,2666,6,5,59,15,4,2,4,1,31,61,6,1,2019,reg
Nick DeLeon,Toronto FC,M,32,23,1856,6,4,42,17,2,4,3,1,28,19,2,0,2019,reg
Shea Salinas,San Jose Earthquakes,M,28,12,1337,6,3,21,9,4,2,2,1,15,14,3,0,2019,reg
David Accam,Nashville SC,F,23,12,1001,6,3,24,12,5,1,2,1,22,14,1,0,2019,reg
Mason Toye,Minnesota United FC,F,17,9,820,6,3,27,13,2,4,2,1,11,10,2,1,2019,reg
Lucas Rodriguez,DC United,M,33,31,2707,6,3,41,12,3,3,1,2,35,86,5,0,2019,reg
Dominique Badji,Nashville SC,F,28,24,2040,6,3,41,20,3,3,3,0,30,38,6,0,2019,reg
Ryan Hollingshead,FC Dallas,M,34,33,2961,6,3,44,17,5,1,2,1,29,44,3,0,2019,reg
Luciano Acosta,DC United,M-F,31,22,2119,6,2,58,19,4,2,2,0,37,38,0,1,2019,reg
Paul Arriola,DC United,M-F,29,28,2433,6,2,60,23,4,2,1,1,43,35,6,1,2019,reg
Teal Bunbury,New England Revolution,F,32,25,2191,6,2,62,21,3,3,1,1,34,32,2,0,2019,reg
Michael Barrios,FC Dallas,M,32,31,2731,5,15,56,18,5,0,8,7,53,36,6,0,2019,reg
Przemyslaw Frankowski,Chicago Fire FC,M,31,24,2300,5,9,55,24,2,3,8,1,25,18,3,0,2019,reg
Pity Martinez,Atlanta United FC,M,32,26,2151,5,9,83,24,3,2,6,3,19,59,2,0,2019,reg
Ilsinho,Philadelphia Union,M,28,7,1083,5,8,22,10,5,0,5,3,11,22,2,0,2019,reg
Alejandro Romero Gamarra,New York Red Bulls,M,26,21,1925,5,6,36,13,1,4,3,3,8,10,0,2,2019,reg
Jonathan Lewis,Colorado Rapids,F,22,12,1113,5,4,17,9,1,4,2,2,11,11,3,0,2019,reg
Ismael Tajouri-Shradi,New York City FC,F,19,11,940,5,4,26,11,1,4,2,2,11,16,1,0,2019,reg
Jonathan Osorio,Toronto FC,M,24,18,1756,5,4,27,14,3,2,3,1,11,21,2,0,2019,reg
Corey Baird,Real Salt Lake,F,31,23,2104,5,4,31,14,2,3,2,2,35,21,6,0,2019,reg
Chris Mueller,Orlando City SC,F,29,16,1370,5,4,40,13,3,2,2,2,13,23,1,0,2019,reg
Juan Fernando Caicedo,New England Revolution,F,27,13,1068,5,3,26,9,0,5,2,1,14,20,2,0,2019,reg
Harry Shipp,FC Dallas,M,25,15,1382,5,3,32,12,4,1,1,2,9,19,1,0,2019,reg
Tomas Martinez,Houston Dynamo,M,33,30,2329,5,3,53,11,3,2,2,1,46,44,2,0,2019,reg
Danny Hoesen,San Jose Earthquakes,F,30,12,1464,5,3,59,25,4,1,1,2,18,13,1,0,2019,reg
Kelvin Leerdam,FC Dallas,D,29,27,2393,5,2,22,5,4,1,1,1,35,10,7,1,2019,reg
Angelo Rodriguez,Minnesota United FC,F,28,21,1751,5,2,55,20,3,2,1,1,42,33,2,0,2019,reg
Benji Michel,Orlando City SC,F,17,9,943,5,1,11,9,3,2,1,0,13,20,0,0,2019,reg
Lassi Lappalainen,Montreal Impact,M,11,8,683,5,1,17,9,4,1,1,0,0,1,0,0,2019,reg
Reto Ziegler,FC Dallas,D,32,32,2880,5,0,26,13,3,2,0,0,32,11,5,0,2019,reg
Nicolas Gaitan,Chicago Fire FC,M,27,25,2012,4,12,34,13,4,0,9,3,19,38,2,1,2019,reg
Jamiro Monteiro,Philadelphia Union,M,26,22,2048,4,9,50,21,2,2,2,7,35,38,3,0,2019,reg
Mark-Anthony Kaye,LAFC,M,31,27,2501,4,8,36,13,3,1,6,2,49,45,7,0,2019,reg
Maximiliano Urruti,Montreal Impact,F,31,27,2436,4,6,54,21,2,2,2,4,41,53,5,1,2019,reg
Nicolas Mezquida,Colorado Rapids,F-M,32,11,1405,4,6,66,27,3,1,4,2,28,30,4,0,2019,reg
Alexander Ring,New York City FC,M,31,31,2790,4,5,47,15,2,2,4,1,67,26,12,0,2019,reg
Alejandro Bedoya,Philadelphia Union,M,32,32,2834,4,4,27,9,2,2,3,1,38,11,6,0,2019,reg
Benny Feilhaber,Colorado Rapids,M,26,20,1724,4,4,28,6,3,1,1,3,33,33,6,0,2019,reg
Fafa Picault,FC Dallas,M,32,21,1866,4,4,53,23,1,3,4,0,22,36,4,0,2019,reg
Kekuta Manneh,FC Cincinnati,F,27,15,1498,4,3,29,9,2,2,0,3,9,38,0,1,2019,reg
Ezequiel Barco,Atlanta United FC,M,15,11,980,4,3,32,16,1,3,1,2,3,41,1,0,2019,reg
Cristhian Paredes,Portland Timbers,M,22,19,1651,4,2,37,10,3,1,1,1,27,25,2,0,2019,reg
Francisco Calvo ,Chicago Fire FC,D,30,28,2565,4,2,43,11,1,3,2,0,32,15,7,1,2019,reg
Doneil Henry,Vancouver Whitecaps,D,25,24,2123,4,1,12,6,3,1,0,1,10,11,4,0,2019,reg
Sergio Santos,Philadelphia Union,F,17,5,622,4,1,21,7,4,0,1,0,24,12,2,0,2019,reg
Hassani Dotson,Minnesota United FC,M-D,24,15,1403,4,0,15,7,3,1,0,0,16,12,2,0,2019,reg
Jordan Hamilton,Columbus Crew SC,F,18,7,679,4,0,24,12,4,0,0,0,9,10,0,0,2019,reg
Justin Meram,Real Salt Lake,M,29,18,1649,4,0,27,11,4,0,0,0,36,16,3,0,2019,reg
Eduard Atuesta,LAFC,M,30,30,2636,3,11,43,17,3,0,8,3,44,45,8,0,2019,reg
Cristian Pavon,LA Galaxy,M,11,11,974,3,8,34,15,0,3,4,4,3,11,1,0,2019,reg
Sebastian Lletget,LA Galaxy,M,29,27,2316,3,6,32,11,3,0,3,3,16,25,4,0,2019,reg
Favio Alvarez,LA Galaxy,M,18,16,1272,3,5,32,13,0,3,1,4,15,12,5,0,2019,reg
Jackson Yueill,San Jose Earthquakes,M,32,29,2668,3,5,36,8,1,2,3,2,26,29,2,0,2019,reg
Inbeom Hwang,Vancouver Whitecaps,M,34,31,2807,3,5,48,15,2,1,2,3,25,38,5,0,2019,reg
Cristian Casseres Jr.,New York Red Bulls,M,23,21,1801,3,4,25,6,1,2,1,3,52,60,5,0,2019,reg
Kevin Molino,Minnesota United FC,M,17,11,910,3,4,29,9,3,0,2,2,6,15,1,0,2019,reg
Michael Bradley,Toronto FC,M,27,26,2372,3,3,22,5,0,3,2,1,30,12,4,0,2019,reg
Alex Muyl,New York Red Bulls,M,24,17,1401,3,3,23,11,2,1,0,3,29,24,4,0,2019,reg
Darren Mattocks,FC Cincinnati,F,21,13,1274,3,3,27,9,1,2,3,0,20,20,0,0,2019,reg
Zakaria Diallo,Montreal Impact,D,24,23,2037,3,2,11,3,0,3,1,1,17,22,2,1,2019,reg
Jesus Medina,New York City FC,M,18,6,726,3,2,16,8,3,0,2,0,14,12,1,0,2019,reg
Tsubasa Endoh,Toronto FC,M,13,10,878,3,2,19,11,2,1,1,1,3,9,1,0,2019,reg
Tommy Smith,Colorado Rapids,D,27,27,2415,3,2,23,9,1,2,1,1,16,7,3,1,2019,reg
Yohan Croizet,Sporting Kansas City,M,20,12,1091,3,2,24,12,2,1,2,0,17,16,4,0,2019,reg
Djordje Mihailovic,Chicago Fire FC,M,27,16,1448,3,2,24,8,2,1,1,1,21,25,4,0,2019,reg
Ulises Segura,DC United,M,33,19,1788,3,2,28,7,3,0,1,1,14,27,1,0,2019,reg
Brenden Aaronson,Philadelphia Union,M,28,25,1722,3,2,34,9,2,1,1,1,16,35,3,0,2019,reg
Santiago Mosquera,FC Dallas,M,23,12,1171,3,2,36,13,3,0,1,1,12,26,0,0,2019,reg
Juan Agudelo,,F,28,21,1954,3,2,37,10,2,1,0,2,46,29,7,0,2019,reg
Lucas Venuto,Vancouver Whitecaps,M,22,12,1132,3,1,14,6,1,2,0,1,6,22,3,0,2019,reg
Fabian Herbers,Chicago Fire FC,F,17,7,775,3,1,18,6,3,0,0,1,17,11,3,0,2019,reg
Ignacio Piatti,Montreal Impact,M,11,9,757,3,1,20,4,0,3,1,0,16,17,1,0,2019,reg
Ike Opara,Minnesota United FC,D,30,29,2566,3,1,22,5,3,0,1,0,18,8,4,0,2019,reg
Gianluca Busio,Sporting Kansas City,M-F,22,10,923,3,1,27,11,2,1,0,1,11,17,1,0,2019,reg
Ola Kamara,DC United,F,5,3,257,3,0,8,6,1,2,0,0,2,4,0,0,2019,reg
Tom Barlow,New York Red Bulls,F,12,8,605,3,0,15,8,2,1,0,0,9,4,0,0,2019,reg
Anthony Jackson-Hamel,Montreal Impact,F,16,6,618,3,0,16,6,1,2,0,0,7,9,0,0,2019,reg
Bojan Krkic,Montreal Impact,M,8,7,608,3,0,18,6,2,1,0,0,2,13,0,0,2019,reg
Daniel Steres ,LA Galaxy,D,30,30,2615,3,0,20,6,1,2,0,0,19,9,4,1,2019,reg
Cristian Espinoza,San Jose Earthquakes,M,30,30,2533,2,13,95,36,1,1,7,6,39,28,6,2,2019,reg
Marc Rzatkowski,New York Red Bulls,M,28,26,2317,2,8,41,15,2,0,4,4,31,55,4,0,2019,reg
Marky Delgado,Toronto FC,M,30,29,2554,2,7,41,8,1,1,2,5,28,25,4,0,2019,reg
Gerso Fernandes,Sporting Kansas City,F,25,20,1749,2,6,40,15,1,1,2,4,37,47,5,0,2019,reg
Ilie Sanchez,Sporting Kansas City,M,32,27,2509,2,5,20,4,1,1,4,1,26,16,7,1,2019,reg
Paxton Pomykal,FC Dallas,M,25,20,1876,2,5,28,10,0,2,5,0,26,63,4,0,2019,reg
Luis Diaz,Columbus Crew SC,M,13,9,797,2,4,18,9,0,2,1,3,10,17,1,0,2019,reg
Darlington Nagbe,Columbus Crew SC,M,33,32,2825,2,4,21,4,2,0,3,1,17,45,2,0,2019,reg
Jorge Moreira,Portland Timbers,D,26,25,2233,2,4,29,7,1,1,4,0,40,24,7,0,2019,reg
Bradley Wright-Phillips,LAFC,F,24,9,1098,2,4,33,11,1,1,2,2,24,23,3,0,2019,reg
Sebastian Saucedo,Real Salt Lake,F,26,13,1189,2,4,41,15,2,0,4,0,25,50,6,0,2019,reg
Sam Nicholson,Colorado Rapids,F,27,19,1769,2,4,49,17,0,2,3,1,29,51,2,0,2019,reg
Jonathan dos Santos,LA Galaxy,M,29,29,2546,2,3,14,5,1,1,3,0,32,20,5,0,2019,reg
Chris Pontius,LA Galaxy,M,18,6,697,2,3,18,5,2,0,2,1,5,7,0,0,2019,reg
Thomas McNamara,Houston Dynamo,M,33,15,1530,2,3,18,8,1,1,1,2,15,24,3,0,2019,reg
Diego Fagundez,New England Revolution,M,25,13,1176,2,3,22,8,2,0,3,0,13,2,2,0,2019,reg
Victor Rodriguez,FC Dallas,M,17,14,1124,2,3,26,10,0,2,2,1,8,25,1,0,2019,reg
Brandon Servania,FC Dallas,M,18,13,1118,2,3,27,9,2,0,3,0,17,14,2,0,2019,reg
Jay Chapman,,M,17,5,522,2,2,7,2,1,1,2,0,6,2,1,0,2019,reg
Theo Bair,Vancouver Whitecaps,F,17,10,824,2,2,12,7,0,2,1,1,13,4,1,0,2019,reg
Omir Fernandez,New York Red Bulls,M,18,3,568,2,2,12,6,1,1,1,1,8,20,0,0,2019,reg
Cole Bassett,Colorado Rapids,M,20,14,1063,2,2,13,7,1,1,1,1,7,8,1,0,2019,reg
Omar Browne,Montreal Impact,M,10,5,564,2,2,16,4,2,0,1,1,15,17,1,0,2019,reg
Brandon Bye,New England Revolution,D,30,30,2657,2,2,22,7,2,0,2,0,37,20,4,1,2019,reg
Abu Danladi,Nashville SC,F,24,4,704,2,2,22,6,1,1,2,0,20,6,3,0,2019,reg
Frederic Brillant,DC United,D,34,33,2961,2,2,27,9,2,0,1,1,26,8,5,0,2019,reg
Romell Quioto,Montreal Impact,M,18,8,794,2,2,27,12,1,1,2,0,7,16,5,1,2019,reg
Kellyn Acosta,Colorado Rapids,M,31,30,2619,2,2,35,12,2,0,1,1,47,20,9,1,2019,reg
Will Bruin,FC Dallas,F,9,4,428,2,1,8,5,2,0,0,1,11,8,1,0,2019,reg
Antonio Mlinar Delamea,New England Revolution,D,17,16,1366,2,1,8,2,1,1,0,1,26,10,7,1,2019,reg
Osvaldo Alonso,Minnesota United FC,M,27,27,2368,2,1,12,3,2,0,0,1,32,53,4,0,2019,reg
Romario Ibarra,Minnesota United FC,M,8,4,381,2,1,12,8,0,2,0,1,4,2,1,0,2019,reg
Santiago Patiño,Orlando City SC,F,11,3,322,2,1,12,3,0,2,1,0,14,9,1,0,2019,reg
Tommy Thompson,San Jose Earthquakes,D,30,28,2296,2,1,13,4,1,1,1,0,25,40,7,1,2019,reg
Danny Wilson,Colorado Rapids,D,20,15,1329,2,1,13,5,2,0,0,1,27,8,4,0,2019,reg
Aaron Long,New York Red Bulls,D,24,24,2115,2,1,19,5,1,1,0,1,16,20,3,0,2019,reg
Marvin Loria,Portland Timbers,M,19,8,699,2,1,20,13,2,0,0,1,12,14,3,0,2019,reg
Dairon Asprilla,Portland Timbers,M-F,13,7,565,2,1,21,7,1,1,1,0,14,5,1,1,2019,reg
Brandon Vazquez,FC Cincinnati,F,11,7,637,2,1,22,8,1,1,1,0,5,5,1,0,2019,reg
Bryan Acosta,FC Dallas,M,26,23,2074,2,1,54,11,1,1,1,0,64,20,12,0,2019,reg
Josh Williams,Columbus Crew SC,D,16,15,1281,2,0,5,2,2,0,0,0,13,6,2,0,2019,reg
Marcelo Silva,Real Salt Lake,D,19,14,1342,2,0,7,3,2,0,0,0,16,10,2,1,2019,reg
Ebenezer Ofori,New York City FC,M,20,14,1261,2,0,8,2,1,1,0,0,18,8,2,0,2019,reg
Michael Boxall,Minnesota United FC,D,29,29,2577,2,0,10,3,2,0,0,0,26,15,3,0,2019,reg
Gaston Sauro,Columbus Crew SC,D,15,15,1285,2,0,11,3,2,0,0,0,16,4,4,0,2019,reg
Nicolas Benezet,Colorado Rapids,F,8,5,438,2,0,14,4,0,2,0,0,5,16,2,0,2019,reg
Cory Burke,Philadelphia Union,F,7,5,490,2,0,14,5,2,0,0,0,13,8,2,0,2019,reg
Patrick Mullins,Toronto FC,F,17,6,542,2,0,15,4,1,1,0,0,8,6,0,0,2019,reg
Erik Hurtado,Sporting Kansas City,F,13,8,815,2,0,20,9,1,1,0,0,22,12,1,0,2019,reg
Larrys Mabiala,Portland Timbers,D,22,22,1904,2,0,22,7,1,1,0,0,33,6,6,1,2019,reg
Jack Elliott,Philadelphia Union,D,34,34,3060,2,0,25,10,2,0,0,0,21,14,4,0,2019,reg
Jan Gregus,Minnesota United FC,M,30,30,2679,1,12,59,16,0,1,9,3,35,24,4,1,2019,reg
Jack Price,Colorado Rapids,M,27,25,2233,1,11,4,2,1,0,9,2,17,10,9,1,2019,reg
Haris Medunjanin,FC Cincinnati,M,34,34,3060,1,10,34,7,0,1,7,3,31,13,6,0,2019,reg
Anton Tinnerholm,New York City FC,D,30,30,2632,1,8,32,12,1,0,4,4,22,28,4,0,2019,reg
Romain Metanire,Minnesota United FC,D,27,27,2430,1,7,11,3,1,0,4,3,21,20,5,0,2019,reg
Michael Amir Murillo,New York Red Bulls,D,22,18,1694,1,6,12,3,1,0,2,4,38,24,5,1,2019,reg
Diego Polenta,LA Galaxy,D,28,28,2520,1,6,18,4,1,0,3,3,26,14,10,1,2019,reg
Jordan Harvey,LAFC,D,30,28,2366,1,5,11,3,1,0,1,4,35,12,4,0,2019,reg
Federico Higuain,DC United,F,14,13,1133,1,5,19,7,1,0,4,1,3,14,2,0,2019,reg
Leonardo Jara,DC United,D,30,25,2291,1,5,34,4,1,0,4,1,27,30,5,0,2019,reg
Ali Adnan,Vancouver Whitecaps,D,28,28,2412,1,5,38,14,1,0,3,2,26,47,8,0,2019,reg
Hector Jimenez,Columbus Crew SC,M,23,19,1626,1,4,7,3,1,0,1,3,12,3,1,0,2019,reg
Tristan Blackmon,LAFC,D,18,15,1377,1,4,9,2,1,0,3,1,8,4,3,0,2019,reg
Rolf Feltscher,LA Galaxy,D,25,25,2183,1,4,17,3,1,0,3,1,26,24,7,0,2019,reg
Dax McCarty,Nashville SC,M,32,32,2850,1,4,21,6,1,0,1,3,36,38,4,0,2019,reg
Hector Villalba,Atlanta United FC,F,20,10,938,1,4,36,9,1,0,2,2,6,6,0,0,2019,reg
Franco Escobar,Atlanta United FC,D,25,22,2012,1,3,7,2,1,0,2,1,31,21,9,0,2019,reg
Tomas Conechny,Portland Timbers,M,16,2,348,1,3,10,5,0,1,3,0,5,5,2,0,2019,reg
Bacary Sagna,Montreal Impact,D,26,25,2180,1,3,13,4,0,1,3,0,15,23,7,1,2019,reg
Brandt Bronico,Chicago Fire FC,M,29,20,1864,1,3,14,5,1,0,2,1,28,12,2,0,2019,reg
Justin Morrow,Toronto FC,D,28,26,2349,1,3,15,5,1,0,3,0,18,19,2,1,2019,reg
Emerson Hyndman,Atlanta United FC,M,15,10,983,1,3,15,6,1,0,2,1,9,4,1,0,2019,reg
Joe Corona,LA Galaxy,M,31,26,2324,1,3,18,4,1,0,3,0,43,37,6,0,2019,reg
Sacha Kljestan,LA Galaxy,M,23,13,1352,1,3,19,6,0,1,3,0,19,11,3,1,2019,reg
Luis Argudo,,M,21,10,1062,1,3,19,6,0,1,1,2,15,14,1,0,2019,reg
Bastian Schweinsteiger,Chicago Fire FC,M,30,30,2676,1,3,24,4,1,0,2,1,31,31,10,0,2019,reg
Keegan Rosenberry,Colorado Rapids,D,34,34,3060,1,3,24,2,0,1,2,1,33,9,3,0,2019,reg
Roland Lamah,FC Cincinnati,M,28,22,1782,1,3,29,11,0,1,1,2,13,28,0,1,2019,reg
Nick Besler,Real Salt Lake,M,17,7,727,1,2,3,2,1,0,1,1,15,12,4,0,2019,reg
Jalil Anibaba,Nashville SC,D,22,19,1764,1,2,5,2,1,0,0,2,12,8,3,1,2019,reg
Kenny Saief,FC Cincinnati,M,9,6,566,1,2,5,2,0,1,0,2,15,15,0,0,2019,reg
Steven Beitashour,LAFC,D,25,24,1881,1,2,6,2,0,1,1,1,26,15,3,0,2019,reg
Jorgen Skjelvik,LA Galaxy,D,20,19,1681,1,2,6,1,0,1,2,0,26,7,4,0,2019,reg
Kyle Duncan,New York Red Bulls,D,13,13,1080,1,2,6,1,0,1,1,1,21,24,4,0,2019,reg
Victor Ulloa,,M,26,22,1945,1,2,9,3,1,0,1,1,20,9,4,0,2019,reg
Tosaint Ricketts,Vancouver Whitecaps,F,8,6,482,1,2,10,5,0,1,1,1,4,1,1,0,2019,reg
Harry Novillo,Montreal Impact,M,11,5,439,1,2,11,4,1,0,0,2,6,8,1,0,2019,reg
Richie Laryea,Toronto FC,M,20,16,1468,1,2,17,4,1,0,1,1,12,53,6,0,2019,reg
Nick Lima,San Jose Earthquakes,D,24,21,1810,1,2,17,4,1,0,1,1,27,23,4,0,2019,reg
Andreas Ivan,New York Red Bulls,M,12,5,486,1,2,21,6,0,1,1,1,10,7,0,0,2019,reg
Mathieu Deplagne,FC Cincinnati,D,33,33,2878,1,2,23,7,1,0,2,0,27,25,4,0,2019,reg
Miguel Ibarra ,FC Dallas,M,22,16,1505,1,2,23,3,0,1,1,1,16,12,4,0,2019,reg
Leonardo Bertone,FC Cincinnati,M,25,22,2055,1,2,28,5,0,1,2,0,28,9,9,0,2019,reg
Sean Nealis,New York Red Bulls,D,9,3,452,1,1,2,1,0,1,1,0,6,3,1,0,2019,reg
Anthony Fontana,Philadelphia Union,M,8,0,119,1,1,3,1,1,0,1,0,5,2,0,0,2019,reg
Mo Adams,Atlanta United FC,M,14,6,574,1,1,3,2,0,1,1,0,15,8,5,0,2019,reg
Connor Lade,New York Red Bulls,D,11,10,845,1,1,5,1,1,0,1,0,11,13,0,0,2019,reg
Graham Smith,Sporting Kansas City,D,11,10,882,1,1,8,4,1,0,1,0,8,5,1,0,2019,reg
Amro Tarek,New York Red Bulls,D,20,19,1477,1,1,8,4,1,0,1,0,16,5,5,1,2019,reg
Bressan,FC Dallas,D,18,12,1119,1,1,8,5,1,0,1,0,21,8,1,0,2019,reg
Ayo Akinola,Toronto FC,F,8,2,253,1,1,8,3,1,0,1,0,3,4,1,0,2019,reg
Shamit Shome,Montreal Impact,M,27,18,1627,1,1,8,3,0,1,1,0,29,19,3,0,2019,reg
Carlos Ascues,Orlando City SC,D,17,14,1113,1,1,9,3,1,0,1,0,25,9,2,0,2019,reg
Michaell Chirinos,Vancouver Whitecaps,F,7,4,412,1,1,10,6,0,1,0,1,9,6,2,0,2019,reg
Handwalla Bwana,FC Dallas,M,15,6,567,1,1,10,4,1,0,1,0,5,4,1,0,2019,reg
Reggie Cannon,FC Dallas,D,28,26,2268,1,1,10,1,1,0,1,0,21,31,7,0,2019,reg
Lass Bangoura,Vancouver Whitecaps,M,17,7,634,1,1,11,4,0,1,0,1,13,8,1,0,2019,reg
Donny Toia,Real Salt Lake,D,24,24,2143,1,1,11,2,0,1,1,0,21,9,3,0,2019,reg
Omar Gonzalez,Toronto FC,D,14,14,1260,1,1,12,4,0,1,1,0,7,4,0,0,2019,reg
Felipe,DC United,M,27,22,1918,1,1,12,3,0,1,0,1,32,28,6,0,2019,reg
Josh Perez,LAFC,F,13,4,454,1,1,12,6,1,0,0,1,7,7,0,0,2019,reg
Derrick Etienne Jr.,Columbus Crew SC,M,16,7,684,1,1,13,6,1,0,0,1,8,19,0,0,2019,reg
DeJuan Jones,New England Revolution,D,20,14,1296,1,1,13,4,0,1,1,0,5,7,0,0,2019,reg
Quincy Amarikwa,DC United,F,23,3,414,1,1,13,4,1,0,1,0,19,10,3,0,2019,reg
Matt Hedges,FC Dallas,D,33,33,2884,1,1,13,3,1,0,0,1,12,8,5,1,2019,reg
Erik Godoy,Vancouver Whitecaps,D,29,28,2596,1,1,13,2,1,0,0,1,29,8,6,0,2019,reg
Andy Rose,Vancouver Whitecaps,M,24,20,1850,1,1,14,4,0,1,0,1,12,10,2,0,2019,reg
Wilfried Zahibo,New England Revolution,M,24,18,1509,1,1,14,3,1,0,1,0,43,16,7,1,2019,reg
Emmanuel Boateng,DC United,M,24,7,930,1,1,14,5,0,1,1,0,9,3,1,0,2019,reg
Gary Mackay-Steven,New York City FC,F,12,5,525,1,1,17,7,0,1,1,0,3,4,0,0,2019,reg
Walker Zimmerman,Nashville SC,D,25,25,2169,1,1,21,5,1,0,1,0,31,12,7,1,2019,reg
Keaton Parks,New York City FC,M,22,14,1317,1,1,21,12,1,0,1,0,28,17,3,0,2019,reg
Leandro Gonzalez Pirez,,D,31,31,2701,1,1,22,5,0,1,1,0,49,49,11,1,2019,reg
Ronald Matarrita,New York City FC,D,24,24,1979,1,1,25,6,0,1,0,1,30,12,7,1,2019,reg
Will Johnson,Orlando City SC,D,21,20,1697,1,1,28,6,0,1,1,0,12,24,2,0,2019,reg
Steven Birnbaum,DC United,D,34,34,3032,1,1,29,6,0,1,0,1,35,14,5,0,2019,reg
Daniel Salloi,Sporting Kansas City,F,28,16,1541,1,1,49,16,1,0,0,1,20,21,1,1,2019,reg
Ashtone Morgan,Real Salt Lake,D,9,3,308,1,0,1,1,1,0,0,0,8,3,1,0,2019,reg
Francis Atuahene,FC Dallas,F,1,0,26,1,0,2,1,0,1,0,0,0,0,0,0,2019,reg
Sebastian Anderson,Colorado Rapids,D,6,5,317,1,0,2,1,1,0,0,0,7,2,1,1,2019,reg
Juan David Cabezas,Houston Dynamo,M,15,5,532,1,0,3,1,0,1,0,0,16,6,4,0,2019,reg
Darwin Ceren,Houston Dynamo,M,13,5,530,1,0,4,2,0,1,0,0,11,11,1,0,2019,reg
Michael Mancienne,New England Revolution,D,16,13,1189,1,0,4,1,0,1,0,0,26,4,4,1,2019,reg
Andres Rios,San Jose Earthquakes,F,10,1,263,1,0,4,2,1,0,0,0,4,17,1,0,2019,reg
Chris Durkin,DC United,M,13,7,636,1,0,4,1,0,1,0,0,13,12,1,0,2019,reg
Kemar Lawrence,New York Red Bulls,D,22,19,1729,1,0,5,1,1,0,0,0,15,17,5,0,2019,reg
Derek Cornelius,Vancouver Whitecaps,D,17,16,1426,1,0,5,2,0,1,0,0,18,5,4,0,2019,reg
Scott Sutter,Vancouver Whitecaps,D,16,9,980,1,0,5,2,0,1,0,0,4,10,0,0,2019,reg
Rodolfo Zelaya,LAFC,F,4,1,118,1,0,6,2,0,1,0,0,3,2,0,0,2019,reg
Jake Nerwinski,Vancouver Whitecaps,D,26,24,2023,1,0,6,1,0,1,0,0,20,19,1,0,2019,reg
Raheem Edwards,Minnesota United FC,M,4,2,244,1,0,7,4,1,0,0,0,9,4,2,0,2019,reg
Romario Williams,Atlanta United FC,F,9,1,159,1,0,7,4,0,1,0,0,5,6,0,0,2019,reg
Giancarlo Gonzalez,LA Galaxy,D,20,15,1430,1,0,7,2,0,1,0,0,22,3,5,0,2019,reg
Carlos Gruezo,FC Dallas,M,9,9,784,1,0,7,1,0,1,0,0,16,5,2,0,2019,reg
Adrien Perez,LAFC,F,12,1,206,1,0,7,3,0,1,0,0,3,0,0,0,2019,reg
Botond Barath,Sporting Kansas City,D,21,20,1749,1,0,8,2,0,1,0,0,26,8,6,0,2019,reg
Fatai Alashe,FC Cincinnati,M,11,4,434,1,0,8,5,1,0,0,0,9,7,2,0,2019,reg
Nedum Onuoha,Real Salt Lake,D,27,26,2336,1,0,9,4,1,0,0,0,13,9,2,0,2019,reg
Rudy Camacho,Montreal Impact,D,17,16,1464,1,0,9,3,1,0,0,0,15,6,4,0,2019,reg
Rashawn Dally,FC Cincinnati,F,12,8,546,1,0,10,4,1,0,0,0,4,1,0,0,2019,reg
Auston Trusty,Colorado Rapids,D,22,22,1966,1,0,11,4,0,1,0,0,31,13,4,1,2019,reg
Mohamed El-Munir,LAFC,D,15,4,581,1,0,11,3,0,1,0,0,17,6,2,0,2019,reg
Joao Plata,Real Salt Lake,F,17,2,305,1,0,14,5,1,0,0,0,4,4,0,0,2019,reg
Youness Mokhtar,Columbus Crew SC,M,8,5,442,1,0,14,5,1,0,0,0,6,3,1,0,2019,reg
Roman Torres,,D,17,12,1127,1,0,14,4,1,0,0,0,4,5,2,0,2019,reg
Judson,San Jose Earthquakes,M,27,23,1915,1,0,15,4,1,0,0,0,56,18,10,0,2019,reg
Eddie Segura,LAFC,D,34,33,2955,1,0,16,2,1,0,0,0,28,9,1,0,2019,reg
Kendall Waston,FC Cincinnati,D,25,24,2175,1,0,18,4,1,0,0,0,32,15,9,1,2019,reg
Fanendo Adi,Columbus Crew SC,F,12,7,695,1,0,20,6,0,1,0,0,12,13,1,0,2019,reg
Bill Tuiloma,Portland Timbers,D-M,25,21,1919,1,0,28,6,0,1,0,0,12,12,1,0,2019,reg
Kai Wagner,Philadelphia Union,D,30,30,2691,0,8,6,0,0,0,6,2,33,26,6,1,2019,reg
Brad Smith,FC Dallas,D,25,22,1974,0,6,11,4,0,0,5,1,10,12,0,0,2019,reg
Jorge Villafaña,Portland Timbers,F,23,22,1947,0,5,8,0,0,0,5,0,19,16,0,0,2019,reg
Ruan,Orlando City SC,D,25,23,2096,0,5,8,4,0,0,5,0,19,37,1,0,2019,reg
Edgar Castillo,Atlanta United FC,D,20,20,1693,0,5,16,1,0,0,2,3,16,14,2,0,2019,reg
Kyle Beckerman,Real Salt Lake,M,25,24,2134,0,5,17,4,0,0,4,1,41,27,9,0,2019,reg
Wil Trapp,,M,28,26,2329,0,4,4,0,0,0,3,1,19,17,5,0,2019,reg
Adam Lundkvist,Houston Dynamo,D,28,26,2387,0,4,6,0,0,0,3,1,34,14,4,0,2019,reg
Lee Nguyen,,M,23,11,1170,0,4,18,7,0,0,0,4,17,16,3,0,2019,reg
Aaron Herrera,Real Salt Lake,D,32,31,2768,0,4,19,5,0,0,4,0,31,14,7,1,2019,reg
Mauricio Pereyra,Orlando City SC,M,6,5,394,0,3,3,1,0,0,2,1,9,5,1,0,2019,reg
Russell Teibert,Vancouver Whitecaps,M,27,26,2202,0,3,8,2,0,0,2,1,13,13,1,0,2019,reg
Auro,Toronto FC,D,23,22,1889,0,3,8,3,0,0,1,2,14,26,0,0,2019,reg
Joao Moutinho,Orlando City SC,D,16,15,1221,0,3,9,2,0,0,2,1,16,10,1,0,2019,reg
Efrain Alvarez,LA Galaxy,M,14,4,518,0,3,12,5,0,0,3,0,4,5,2,1,2019,reg
Junior Moreno,DC United,M,29,29,2551,0,3,12,3,0,0,3,0,30,17,3,1,2019,reg
Roger Espinoza,Sporting Kansas City,M,16,15,1149,0,3,16,6,0,0,3,0,27,23,4,3,2019,reg
Maynor Figueroa,Houston Dynamo,D,25,25,2249,0,3,28,4,0,0,3,0,19,25,6,1,2019,reg
Perry Kitchen,LA Galaxy,M,8,6,573,0,2,0,0,0,0,0,2,12,4,0,0,2019,reg
Jon Erice,Vancouver Whitecaps,M,21,21,1752,0,2,2,0,0,0,0,2,23,22,2,0,2019,reg
DaMarcus Beasley,Houston Dynamo,D,12,12,1032,0,2,3,0,0,0,1,1,7,15,0,0,2019,reg
Ben Sweat,,D,18,13,1265,0,2,4,3,0,0,1,1,19,9,4,0,2019,reg
Johan Kappelhof,Chicago Fire FC,D,29,29,2562,0,2,6,1,0,0,2,0,32,10,5,0,2019,reg
Anibal Godoy,Nashville SC,M-D,15,15,1344,0,2,6,2,0,0,2,0,37,29,8,0,2019,reg
Cristian Higuita,Orlando City SC,M,9,7,648,0,2,6,1,0,0,1,1,14,15,5,0,2019,reg
Diego Chara,Portland Timbers,M,30,29,2606,0,2,7,1,0,0,0,2,69,54,11,1,2019,reg
Jacori Hayes,Minnesota United FC,M,19,8,848,0,2,7,2,0,0,1,1,6,31,0,0,2019,reg
Everton Luiz,Real Salt Lake,M,27,24,2106,0,2,8,2,0,0,2,0,41,39,8,0,2019,reg
Tajon Buchanan,New England Revolution,F,10,4,391,0,2,11,2,0,0,1,1,5,9,0,0,2019,reg
Daniel Lovitz,Nashville SC,D,28,28,2520,0,2,12,6,0,0,0,2,28,11,5,0,2019,reg
Sean Davis,New York Red Bulls,M,30,28,2557,0,2,13,3,0,0,2,0,32,23,0,0,2019,reg
Joevin Jones,FC Dallas,D-M,17,9,921,0,2,14,7,0,0,2,0,10,16,2,0,2019,reg
Harrison Afful,Columbus Crew SC,D,22,22,1905,0,2,19,8,0,0,1,1,13,15,3,1,2019,reg
Florian Jungwirth,San Jose Earthquakes,D,30,30,2671,0,2,19,6,0,0,1,1,39,32,4,0,2019,reg
Kelyn Rowe,New England Revolution,M,18,9,870,0,2,23,7,0,0,2,0,17,14,2,0,2019,reg
Graham Zusi,Sporting Kansas City,M,27,26,2351,0,2,37,7,0,0,2,0,22,33,5,0,2019,reg
Robinho,Orlando City SC,M,25,16,1322,0,2,39,13,0,0,2,0,20,18,0,0,2019,reg
Ryan Telfer,Toronto FC,F,1,0,3,0,1,0,0,0,0,1,0,0,0,0,0,2019,reg
Erik Holt,Real Salt Lake,D,5,5,371,0,1,0,0,0,0,0,1,6,1,0,0,2019,reg
Niko Hamalainen,LAFC,D,3,1,95,0,1,0,0,0,0,1,0,5,0,0,0,2019,reg
Eric Alexander,FC Cincinnati,M,6,4,312,0,1,0,0,0,0,0,1,4,0,0,0,2019,reg
Collin Martin,Minnesota United FC,M,3,2,184,0,1,1,0,0,0,0,1,8,2,0,0,2019,reg
Warren Creavalle,Philadelphia Union,M,13,5,367,0,1,1,0,0,0,0,1,6,8,0,0,2019,reg
Danilo Acosta,LA Galaxy,D,8,8,670,0,1,1,0,0,0,0,1,3,4,1,0,2019,reg
Bryan Reynolds,FC Dallas,D,10,1,112,0,1,1,0,0,0,0,1,3,3,0,0,2019,reg
Jeremiah Gutjahr,Chicago Fire FC,M,8,5,502,0,1,1,0,0,0,0,1,3,5,1,0,2019,reg
Florian Valot,New York Red Bulls,M,2,2,125,0,1,1,0,0,0,0,1,0,1,0,0,2019,reg
Brent Kallman,Minnesota United FC,D,16,14,1281,0,1,1,0,0,0,1,0,12,11,2,0,2019,reg
Matthew Real,Philadelphia Union,D,3,1,67,0,1,1,0,0,0,1,0,1,1,1,0,2019,reg
Saad Abdul-Salaam,FC Cincinnati,D,18,11,1062,0,1,1,0,0,0,1,0,12,8,2,0,2019,reg
Andrew Farrell,New England Revolution,D,29,29,2603,0,1,1,0,0,0,0,1,18,24,7,0,2019,reg
Olivier Mbaizo,Philadelphia Union,D,3,2,195,0,1,1,0,0,0,1,0,2,2,0,0,2019,reg
Emil Cuello,LA Galaxy,M,9,2,189,0,1,2,0,0,0,1,0,4,1,1,0,2019,reg
Tony Rocha,New York City FC,M,17,9,871,0,1,2,0,0,0,0,1,15,13,1,0,2019,reg
Jose Bizama,Houston Dynamo,D,5,4,354,0,1,2,1,0,0,1,0,4,7,1,0,2019,reg
Clement Bayiha,Montreal Impact,M,11,4,469,0,1,2,1,0,0,0,1,2,4,0,0,2019,reg
Donovan Pines,DC United,D,10,9,785,0,1,2,0,0,0,0,1,8,4,1,0,2019,reg
Lawrence Olum,Minnesota United FC,D,10,5,543,0,1,2,0,0,0,0,1,6,2,0,0,2019,reg
Jorge Corrales,Montreal Impact,D,19,14,1135,0,1,2,0,0,0,0,1,22,7,4,1,2019,reg
Raymon Gaddis,Philadelphia Union,D,34,34,2963,0,1,3,0,0,0,0,1,18,13,2,0,2019,reg
Nicolas Hasler,Chicago Fire FC,D,12,8,708,0,1,3,1,0,0,1,0,3,7,0,0,2019,reg
Andrew Gutman,FC Cincinnati,D,8,5,482,0,1,3,0,0,0,1,0,3,7,2,0,2019,reg
Dion Pereira,Atlanta United FC,M,18,7,663,0,1,3,2,0,0,1,0,6,7,0,0,2019,reg
Alejandro Fuenmayor,Houston Dynamo,D,8,8,699,0,1,3,0,0,0,0,1,9,7,3,0,2019,reg
Erickson Gallardo,Toronto FC,F-M,5,4,244,0,1,3,0,0,0,1,0,6,1,0,0,2019,reg
Scott Caldwell,New England Revolution,M,20,12,1079,0,1,3,2,0,0,0,1,16,21,2,0,2019,reg
Edwin Cerrillo,FC Dallas,M,12,11,918,0,1,4,0,0,0,0,1,20,6,2,0,2019,reg
Alex Roldan,FC Dallas,M,9,5,442,0,1,4,0,0,0,0,1,3,6,0,0,2019,reg
Alex Crognale,Columbus Crew SC,D,12,9,881,0,1,4,0,0,0,0,1,11,8,5,0,2019,reg
Josue Colman,Orlando City SC,M,8,1,154,0,1,4,1,0,0,1,0,0,1,0,0,2019,reg
Dillon Powers,Orlando City SC,M,7,7,620,0,1,4,1,0,0,0,1,6,10,0,0,2019,reg
Aljaz Struna,Houston Dynamo,D,29,29,2610,0,1,4,2,0,0,1,0,27,9,4,0,2019,reg
Chris Mavinga,Toronto FC,D,26,24,2112,0,1,5,2,0,0,1,0,22,17,5,0,2019,reg
Andrew Wooten,Philadelphia Union,F,7,4,352,0,1,5,2,0,0,0,1,1,4,0,0,2019,reg
Peter-Lee Vassell,LAFC,M,6,2,177,0,1,5,3,0,0,0,1,2,0,0,0,2019,reg
Paul Marie,San Jose Earthquakes,D,9,3,345,0,1,6,2,0,0,1,0,5,10,1,0,2019,reg
Mathieu Choiniere,Montreal Impact,M,17,6,681,0,1,7,0,0,0,0,1,14,17,1,0,2019,reg
Liam Fraser,Toronto FC,M,9,9,810,0,1,7,1,0,0,1,0,14,8,3,0,2019,reg
Jordy Delem,FC Dallas,M,23,17,1439,0,1,7,0,0,0,1,0,26,22,4,0,2019,reg
Eduardo Sosa,Columbus Crew SC,M,8,4,323,0,1,7,2,0,0,0,1,7,8,1,0,2019,reg
PC,Vancouver Whitecaps,D,18,9,812,0,1,7,1,0,0,1,0,26,12,4,0,2019,reg
Joseph Mora,DC United,D,20,18,1595,0,1,7,0,0,0,1,0,16,21,3,0,2019,reg
Renzo Zambrano,Portland Timbers,M,10,9,785,0,1,7,1,0,0,1,0,13,15,4,1,2019,reg
Julian Araujo,LA Galaxy,D,18,10,891,0,1,7,2,0,0,1,0,19,5,3,0,2019,reg
Dave Romney,Nashville SC,D,12,10,928,0,1,8,5,0,0,1,0,4,2,0,0,2019,reg
Jimmy Medranda ,Nashville SC,D,10,2,176,0,1,8,2,0,0,1,0,3,3,1,0,2019,reg
Dillon Serna,Colorado Rapids,M,14,6,580,0,1,8,2,0,0,1,0,11,4,0,0,2019,reg
Romain Alessandrini,LA Galaxy,M,5,5,281,0,1,8,3,0,0,1,0,7,5,1,0,2019,reg
A.J. DeLaGarza,,D,23,23,1995,0,1,8,2,0,0,1,0,25,26,6,0,2019,reg
Lamine Sane,Orlando City SC,D,26,25,2274,0,1,8,1,0,0,1,0,12,11,4,0,2019,reg
Brek Shea,,D,19,10,907,0,1,8,3,0,0,1,0,17,8,0,0,2019,reg
Seth Sinovic,New England Revolution,D,22,21,1911,0,1,10,1,0,0,0,1,22,11,4,0,2019,reg
Andres Flores,Portland Timbers,M,15,9,778,0,1,10,1,0,0,1,0,12,6,0,0,2019,reg
Brooks Lennon,Atlanta United FC,D,28,16,1539,0,1,10,2,0,0,1,0,23,8,3,0,2019,reg
Julio Cascante,Portland Timbers,D,22,16,1440,0,1,10,3,0,0,0,1,28,4,4,1,2019,reg
Marcos Lopez,San Jose Earthquakes,D,18,15,1168,0,1,10,4,0,0,1,0,19,28,7,1,2019,reg
Zachary Brault-Guillard,Montreal Impact,D,13,9,871,0,1,11,5,0,0,1,0,11,3,1,0,2019,reg
Vincent Bezecourt,New York Red Bulls,M,8,7,453,0,1,11,3,0,0,1,0,10,5,0,0,2019,reg
Eric Remedi,Atlanta United FC,M,28,25,2055,0,1,11,3,0,0,1,0,32,47,6,0,2019,reg
Josh Sims,New York Red Bulls,M,7,5,478,0,1,11,3,0,0,0,1,5,10,0,0,2019,reg
Micheal Azira,Chicago Fire FC,M,23,18,1659,0,1,11,3,0,0,0,1,26,15,4,0,2019,reg
Laurent Ciman,Toronto FC,D,17,14,1262,0,1,11,3,0,0,0,1,12,2,3,0,2019,reg
Jeff Larentowicz,Atlanta United FC,M,27,15,1465,0,1,11,1,0,0,1,0,27,10,4,1,2019,reg
Jacob Shaffelburg,Toronto FC,M-F,10,8,672,0,1,11,4,0,0,1,0,5,8,0,0,2019,reg
Joseph-Claude Gyau,FC Cincinnati,M,8,5,461,0,1,12,5,0,0,1,0,14,10,0,1,2019,reg
Kim Kee-hee,FC Dallas,D,30,30,2622,0,1,14,1,0,0,1,0,31,9,6,0,2019,reg
Oriol Rosell,Orlando City SC,M-D,20,16,1465,0,1,15,2,0,0,1,0,24,12,6,0,2019,reg
Andy Polo,Portland Timbers,M,19,12,1047,0,1,15,3,0,0,0,1,7,6,1,0,2019,reg
Boniek Garcia,Houston Dynamo,M,32,30,2584,0,1,16,3,0,0,1,0,49,40,6,0,2019,reg
Gustav Svensson,FC Dallas,M,22,21,1813,0,1,19,4,0,0,1,0,18,17,1,0,2019,reg
David Guzman,Columbus Crew SC,M,21,17,1489,0,1,21,3,0,0,0,1,37,21,6,0,2019,reg
Matias Vera,Houston Dynamo,M,30,30,2639,0,1,22,0,0,0,0,1,51,28,9,1,2019,reg
Zachary Herivaux,New England Revolution,M,0,0,0,0,0,0,0,0,0,0,0,0,0,0,0,2019,reg
Daniel Bedoya,New York City FC,M,1,0,1,0,0,0,0,0,0,0,0,0,0,0,0,2019,reg
Deklan Wynne,Colorado Rapids,D,11,11,917,0,0,0,0,0,0,0,0,8,2,0,0,2019,reg
Modou Jadama,Portland Timbers,D,1,1,90,0,0,0,0,0,0,0,0,2,0,0,0,2019,reg
Ben Mines,New York Red Bulls,M,0,0,0,0,0,0,0,0,0,0,0,0,0,0,0,2019,reg
Oniel Fisher,DC United,D,0,0,0,0,0,0,0,0,0,0,0,0,0,0,0,2019,reg
Cristian Colman,FC Dallas,F,0,0,0,0,0,0,0,0,0,0,0,0,0,0,0,2019,reg
Tomas Hilliard-Arce,LA Galaxy,D,0,0,0,0,0,0,0,0,0,0,0,0,0,0,0,2019,reg
Foster Langsdorf,Portland Timbers,F,2,0,25,0,0,0,0,0,0,0,0,0,0,0,0,2019,reg
Eric Calvillo,San Jose Earthquakes,M,2,1,73,0,0,0,0,0,0,0,0,1,1,0,0,2019,reg
Brian Wright,New England Revolution,F,2,0,10,0,0,0,0,0,0,0,0,0,1,0,0,2019,reg
Bradford Jamieson IV,LA Galaxy,F,0,0,0,0,0,0,0,0,0,0,0,0,0,0,0,2019,reg
Jimmy Ockford,San Jose Earthquakes,D,0,0,0,0,0,0,0,0,0,0,0,0,0,0,0,2019,reg
Luke Mulholland,Real Salt Lake,M,1,0,19,0,0,0,0,0,0,0,0,0,0,0,0,2019,reg
Blake Smith,FC Cincinnati,D,0,0,0,0,0,0,0,0,0,0,0,0,0,0,0,2019,reg
Marco Farfan,Portland Timbers,D,3,3,190,0,0,0,0,0,0,0,0,3,1,2,0,2019,reg
Michael Baldisimo,Vancouver Whitecaps,M,0,0,0,0,0,0,0,0,0,0,0,0,0,0,0,2019,reg
Shandon Hopeau,FC Dallas,F,1,0,32,0,0,0,0,0,0,0,0,0,1,0,0,2019,reg
Lagos Kunga,Atlanta United FC,F,0,0,0,0,0,0,0,0,0,0,0,0,0,0,0,2019,reg
Wan Kuzain Wan Kamal,Sporting Kansas City,M,0,0,0,0,0,0,0,0,0,0,0,0,0,0,0,2019,reg
Matt Hundley,Colorado Rapids,F,0,0,0,0,0,0,0,0,0,0,0,0,0,0,0,2019,reg
Sam Junqua,Houston Dynamo,D,0,0,0,0,0,0,0,0,0,0,0,0,0,0,0,2019,reg
David Norman Jr.,,M,0,0,0,0,0,0,0,0,0,0,0,0,0,0,0,2019,reg
Julian Dunn,Toronto FC,D,0,0,0,0,0,0,0,0,0,0,0,0,0,0,0,2019,reg
Noble Okello,Toronto FC,M,0,0,0,0,0,0,0,0,0,0,0,0,0,0,0,2019,reg
Daniel Kinumbe,Montreal Impact,D,1,1,67,0,0,0,0,0,0,0,0,2,1,0,0,2019,reg
Jacob Akanyirige,San Jose Earthquakes,D,0,0,0,0,0,0,0,0,0,0,0,0,0,0,0,2019,reg
Gilbert Fuentes,San Jose Earthquakes,M,1,0,2,0,0,0,0,0,0,0,0,0,1,0,0,2019,reg
Andre Reynolds II,Chicago Fire FC,D,0,0,0,0,0,0,0,0,0,0,0,0,0,0,0,2019,reg
Georges Mukumbilwa,Vancouver Whitecaps,D-M,1,0,9,0,0,0,0,0,0,0,0,0,0,0,0,2019,reg
Juan Pablo Torres,New York City FC,M,1,0,1,0,0,0,0,0,0,0,0,0,0,0,0,2019,reg
Griffin Dorsey,Toronto FC,M,1,0,3,0,0,0,0,0,0,0,0,1,0,0,0,2019,reg
Kevin Partida,San Jose Earthquakes,M,1,0,1,0,0,0,0,0,0,0,0,0,0,0,0,2019,reg
Tate Schmitt,Real Salt Lake,M,6,1,92,0,0,0,0,0,0,0,0,2,3,0,0,2019,reg
Sam Raben,Colorado Rapids,D,0,0,0,0,0,0,0,0,0,0,0,0,0,0,0,2019,reg
Logan Gdula,FC Cincinnati,D,0,0,0,0,0,0,0,0,0,0,0,0,0,0,0,2019,reg
Luis Arriaga,Real Salt Lake,F,2,0,4,0,0,0,0,0,0,0,0,0,0,0,0,2019,reg
Luis Felipe,San Jose Earthquakes,M,3,0,39,0,0,0,0,0,0,0,0,3,1,1,0,2019,reg
Isaac Angking,New England Revolution,M,0,0,0,0,0,0,0,0,0,0,0,0,0,0,0,2019,reg
Nicolas Firmino,New England Revolution,M,0,0,0,0,0,0,0,0,0,0,0,0,0,0,0,2019,reg
Cameron Duke,Sporting Kansas City,M,0,0,0,0,0,0,0,0,0,0,0,0,0,0,0,2019,reg
Pablo Ruiz,Real Salt Lake,M,0,0,0,0,0,0,0,0,0,0,0,0,0,0,0,2019,reg
Jaylin Lindsey,Sporting Kansas City,D,1,1,90,0,0,0,0,0,0,0,0,0,0,0,0,2019,reg
Chris Goslin,Atlanta United FC,M,0,0,0,0,0,0,0,0,0,0,0,0,0,0,0,2019,reg
Amar Sejdic,Montreal Impact,M,1,1,68,0,0,0,0,0,0,0,0,0,1,0,0,2019,reg
Kortne Ford,Colorado Rapids,D,0,0,0,0,0,0,0,0,0,0,0,0,0,0,0,2019,reg
Chris Odoi-Atsem,DC United,D,3,1,134,0,0,0,0,0,0,0,0,0,1,0,0,2019,reg
Jon Gallagher,Atlanta United FC,F,0,0,0,0,0,0,0,0,0,0,0,0,0,0,0,2019,reg
Jean-Christophe Koffi,New York Red Bulls,M,0,0,0,0,0,0,0,0,0,0,0,0,0,0,0,2019,reg
Brendan McDonough,Vancouver Whitecaps,D,1,1,66,0,0,0,0,0,0,0,0,0,1,0,0,2019,reg
Gordon Wild,LA Galaxy,F,0,0,0,0,0,0,0,0,0,0,0,0,0,0,0,2019,reg
Luiz Fernando,Atlanta United FC,M,0,0,0,0,0,0,0,0,0,0,0,0,0,0,0,2019,reg
Derrick Jones,Nashville SC,M,2,0,57,0,0,0,0,0,0,0,0,1,3,0,0,2019,reg
Juninho,LA Galaxy,M,2,0,8,0,0,0,0,0,0,0,0,0,0,0,0,2019,reg
Corben Bone,FC Cincinnati,M,6,2,186,0,0,0,0,0,0,0,0,0,0,0,0,2019,reg
Dejan Jakovic,LAFC,D,3,2,181,0,0,0,0,0,0,0,0,1,1,1,0,2019,reg
Kevin Kratz,Atlanta United FC,M,1,0,1,0,0,0,0,0,0,0,0,0,0,0,0,2019,reg
Rodney Wallace,Sporting Kansas City,D,1,1,27,0,0,0,0,0,0,0,0,1,1,0,0,2019,reg
Tony Beltran,Real Salt Lake,D,0,0,0,0,0,0,0,0,0,0,0,0,0,0,0,2019,reg
Francois Affolter,San Jose Earthquakes,D,1,1,90,0,0,0,0,0,0,0,0,1,0,0,0,2019,reg
Rod Fanni,Montreal Impact,D,3,3,270,0,0,0,0,0,0,0,0,0,1,0,0,2019,reg
Jimmy McLaughlin,FC Cincinnati,M,0,0,0,0,0,0,0,0,0,0,0,0,0,0,0,2019,reg
Adam Henley,Real Salt Lake,D,0,0,0,0,0,0,0,0,0,0,0,0,0,0,0,2019,reg
Greg Garza,FC Cincinnati,D,13,11,908,0,0,0,0,0,0,0,0,5,10,1,0,2019,reg
RJ Allen,Philadelphia Union,D,0,0,0,0,0,0,0,0,0,0,0,0,0,0,0,2019,reg
Servando Carrasco,LA Galaxy,M,16,3,388,0,0,0,0,0,0,0,0,13,0,2,0,2019,reg
Moises Hernandez,FC Dallas,D,0,0,0,0,0,0,0,0,0,0,0,0,0,0,0,2019,reg
Gabriel Somi,New England Revolution,D,0,0,0,0,0,0,0,0,0,0,0,0,0,0,0,2019,reg
Bismark Adjei-Boateng,Colorado Rapids,M,0,0,0,0,0,0,0,0,0,0,0,0,0,0,0,2019,reg
Jonathan Campbell,FC Dallas,D,4,4,360,0,0,0,0,0,0,0,0,3,0,1,0,2019,reg
Mikey Ambrose,,D,4,3,266,0,0,0,0,0,0,0,0,3,1,2,0,2019,reg
Eric Bird,Houston Dynamo,M,0,0,0,0,0,0,0,0,0,0,0,0,0,0,0,2019,reg
Alejandro Guido,LAFC,M,0,0,0,0,0,0,0,0,0,0,0,0,0,0,0,2019,reg
Chris Duvall,Portland Timbers,D,1,1,90,0,0,0,0,0,0,0,0,0,2,0,0,2019,reg
Nazmi Albadawi,FC Cincinnati,M,1,0,9,0,0,0,0,0,0,0,0,1,1,0,0,2019,reg
Callum Montgomery,FC Dallas,D,0,0,0,0,0,0,0,0,0,0,0,0,0,0,0,2019,reg
Antonio Bustamante,DC United,M,0,0,0,0,0,0,0,0,0,0,0,0,0,0,0,2019,reg
Akeem Ward,DC United,D,1,1,48,0,0,0,0,0,0,0,0,3,0,0,0,2019,reg
Simon Colyn,Vancouver Whitecaps,M,0,0,0,0,0,0,0,0,0,0,0,0,0,0,0,2019,reg
Diedie Traore,LA Galaxy,D,4,3,220,0,0,0,0,0,0,0,0,3,9,0,0,2019,reg
Griffin Yow,DC United,F,2,1,59,0,0,0,0,0,0,0,0,0,0,0,0,2019,reg
Wyatt Omsberg,Chicago Fire FC,D,0,0,0,0,0,0,0,0,0,0,0,0,0,0,0,2019,reg
Carter Manley,Minnesota United FC,D,1,1,90,0,0,0,0,0,0,0,0,0,1,0,0,2019,reg
Tyler Freeman,Sporting Kansas City,F,0,0,0,0,0,0,0,0,0,0,0,0,0,0,0,2019,reg
Erik McCue,Houston Dynamo,D,0,0,0,0,0,0,0,0,0,0,0,0,0,0,0,2019,reg
Julian Vazquez,Real Salt Lake,F,0,0,0,0,0,0,0,0,0,0,0,0,0,0,0,2019,reg
Karifa Yao,Montreal Impact,D,0,0,0,0,0,0,0,0,0,0,0,0,0,0,0,2019,reg
Justin Haak,New York City FC,M,3,0,6,0,0,0,0,0,0,0,0,0,0,0,0,2019,reg
Joe Scally,New York City FC,D,0,0,0,0,0,0,0,0,0,0,0,0,0,0,0,2019,reg
George Bello,Atlanta United FC,D,0,0,0,0,0,0,0,0,0,0,0,0,0,0,0,2019,reg
Edward Opoku,Columbus Crew SC,F,0,0,0,0,0,0,0,0,0,0,0,0,0,0,0,2019,reg
Michee Ngalina,Philadelphia Union,F,1,0,9,0,0,0,0,0,0,0,0,1,0,0,0,2019,reg
Diego Palacios,LAFC,D,2,1,92,0,0,0,0,0,0,0,0,1,1,0,0,2019,reg
Cade Cowell,San Jose Earthquakes,F,0,0,0,0,0,0,0,0,0,0,0,0,0,0,0,2019,reg
Siad Haji,San Jose Earthquakes,M,4,0,41,0,0,0,0,0,0,0,0,1,1,0,0,2019,reg
Jasser Khmiri,Vancouver Whitecaps,D,1,1,90,0,0,1,0,0,0,0,0,0,1,0,0,2019,reg
Ema Twumasi,FC Dallas,F,2,0,27,0,0,1,0,0,0,0,0,0,0,0,0,2019,reg
Alfonso Ocampo-Chavez,FC Dallas,F,3,1,82,0,0,1,1,0,0,0,0,2,2,0,0,2019,reg
Ricardo Pepi,FC Dallas,F,7,0,71,0,0,1,1,0,0,0,0,0,1,0,0,2019,reg
Javi Perez,LAFC,M,1,0,12,0,0,1,0,0,0,0,0,0,0,0,0,2019,reg
Jalen Robinson,DC United,D,10,5,413,0,0,1,0,0,0,0,0,0,3,0,0,2019,reg
Kevin Garcia,Houston Dynamo,D,12,8,812,0,0,1,0,0,0,0,0,12,3,1,0,2019,reg
Harold Cummings,San Jose Earthquakes,D,16,16,1392,0,0,1,1,0,0,0,0,16,12,5,0,2019,reg
Drew Moor,Colorado Rapids,D,13,11,1022,0,0,1,1,0,0,0,0,8,4,2,0,2019,reg
Brett Levis,Vancouver Whitecaps,D,9,3,330,0,0,1,0,0,0,0,0,4,5,1,0,2019,reg
Grant Lillard,,D,4,2,206,0,0,1,0,0,0,0,0,1,2,0,0,2019,reg
Andrew Carleton,Atlanta United FC,M,3,0,64,0,0,1,0,0,0,0,0,1,1,0,0,2019,reg
Shaft Brewer Jr.,LAFC,M-D,1,1,90,0,0,1,0,0,0,0,0,2,1,0,0,2019,reg
Kamal Miller,Orlando City SC,D,16,14,1350,0,0,1,0,0,0,0,0,6,4,1,0,2019,reg
Douglas Martinez,Real Salt Lake,F,1,1,64,0,0,1,0,0,0,0,0,1,1,0,0,2019,reg
Felipe Hernandez,Sporting Kansas City,M,2,1,95,0,0,1,0,0,0,0,0,3,2,0,0,2019,reg
Niko Hansen,Houston Dynamo,F,13,2,279,0,0,1,0,0,0,0,0,5,3,1,0,2019,reg
Alex De John,Orlando City SC,D,6,6,406,0,0,1,0,0,0,0,0,3,3,1,0,2019,reg
Michael Salazar,Houston Dynamo,F,7,1,153,0,0,1,0,0,0,0,0,3,1,0,0,2019,reg
Justin Portillo ,Real Salt Lake,M,4,2,194,0,0,1,0,0,0,0,0,5,2,1,1,2019,reg
Tommy McCabe,FC Cincinnati,M,6,2,244,0,0,1,0,0,0,0,0,1,0,0,0,2019,reg
Mark McKenzie,Philadelphia Union,D,7,6,537,0,0,1,0,0,0,0,0,5,5,0,0,2019,reg
Forrest Lasso,FC Cincinnati,D,5,4,393,0,0,2,1,0,0,0,0,4,6,2,0,2019,reg
John Nelson,FC Dallas,D,9,4,451,0,0,2,0,0,0,0,0,1,2,0,0,2019,reg
Emanuel Cecchini,FC Dallas,M,4,1,155,0,0,2,0,0,0,0,0,3,1,1,0,2019,reg
Ronaldo Peña,Houston Dynamo,F,4,2,157,0,0,2,0,0,0,0,0,5,4,3,0,2019,reg
Marcus Epps,New York Red Bulls,M,3,1,109,0,0,2,1,0,0,0,0,1,2,0,0,2019,reg
Ken Krolicki,Montreal Impact,M,10,5,523,0,0,2,0,0,0,0,0,16,7,2,0,2019,reg
Niki Jackson,Colorado Rapids,F,4,0,35,0,0,2,1,0,0,0,0,2,0,0,0,2019,reg
Aboubacar Keita,Columbus Crew SC,D,10,8,801,0,0,2,0,0,0,0,0,6,6,0,0,2019,reg
Abdul Rwatubyaye,Colorado Rapids,D,2,1,164,0,0,2,0,0,0,0,0,3,0,1,0,2019,reg
James Sands,New York City FC,M,19,18,1488,0,0,2,1,0,0,0,0,25,10,4,0,2019,reg
Ballou Jean-Yves Tabla,Montreal Impact,F,4,1,127,0,0,2,0,0,0,0,0,1,0,0,0,2019,reg
Rece Buckmaster,New York Red Bulls,D,6,6,540,0,0,2,0,0,0,0,0,4,6,1,0,2019,reg
Jonathan Bornstein,Chicago Fire FC,D,11,11,914,0,0,2,0,0,0,0,0,11,12,1,0,2019,reg
Wilfried Moimbe,Minnesota United FC,D,4,4,336,0,0,2,0,0,0,0,0,4,2,0,0,2019,reg
Chris McCann,DC United,M-D,6,4,319,0,0,2,0,0,0,0,0,2,1,0,0,2019,reg
Matt Besler,Sporting Kansas City,D,27,25,2115,0,0,2,0,0,0,0,0,13,10,3,1,2019,reg
Danilo Silva,LAFC,D,5,2,222,0,0,2,0,0,0,0,0,5,3,1,0,2019,reg
Johan Blomberg,Colorado Rapids,M,3,1,88,0,0,2,0,0,0,0,0,1,0,1,1,2019,reg
Edwin Gyasi,FC Dallas,M,4,1,82,0,0,2,1,0,0,0,0,2,3,0,0,2019,reg
Lucas Melano,Portland Timbers,F,8,1,121,0,0,2,0,0,0,0,0,4,2,1,0,2019,reg
Fabinho,Philadelphia Union,D,1,1,90,0,0,2,0,0,0,0,0,2,1,0,0,2019,reg
Kofi Opare,Colorado Rapids,D,3,3,270,0,0,2,0,0,0,0,0,1,1,0,0,2019,reg
Thomas Chacon,Minnesota United FC,M,2,1,85,0,0,2,1,0,0,0,0,2,3,0,0,2019,reg
Diego Campos,Chicago Fire FC,D-M,10,5,439,0,0,3,1,0,0,0,0,2,1,1,0,2019,reg
Sebastien Ibeagha,New York City FC,D,23,11,1112,0,0,3,1,0,0,0,0,13,6,1,0,2019,reg
Waylon Francis,Columbus Crew SC,D,17,16,1382,0,0,3,0,0,0,0,0,23,10,3,0,2019,reg
Shane O'Neill,FC Dallas,D,11,8,838,0,0,3,0,0,0,0,0,7,2,2,0,2019,reg
Zarek Valentin,Houston Dynamo,D,21,17,1623,0,0,3,0,0,0,0,0,18,5,5,0,2019,reg
Andreu Fontas,Sporting Kansas City,D,13,10,964,0,0,3,1,0,0,0,0,7,5,2,0,2019,reg
Florentin Pogba,Atlanta United FC,D,13,8,780,0,0,3,1,0,0,0,0,15,4,2,0,2019,reg
Zoltan Stieber,DC United,M-F,9,3,301,0,0,3,1,0,0,0,0,3,0,0,0,2019,reg
Justin Hoyte,FC Cincinnati,D,17,16,1477,0,0,3,1,0,0,0,0,11,1,3,0,2019,reg
Cristian Martinez,Chicago Fire FC,M,5,0,50,0,0,3,1,0,0,0,0,0,2,0,0,2019,reg
Justin Rennicks,New England Revolution,F,2,1,106,0,0,3,0,0,0,0,0,1,1,0,0,2019,reg
Thomas Roberts,FC Dallas,M,6,3,237,0,0,3,1,0,0,0,0,3,2,0,0,2019,reg
Ethan Zubak,LA Galaxy,F,3,0,40,0,0,3,1,0,0,0,0,1,0,0,0,2019,reg
Eric Miller,Nashville SC,D,11,9,764,0,0,3,0,0,0,0,0,11,4,2,0,2019,reg
Gedion Zelalem,New York City FC,M,9,5,436,0,0,3,2,0,0,0,0,6,1,1,0,2019,reg
Henry Wingo,FC Dallas,M,6,2,200,0,0,3,0,0,0,0,0,1,0,0,0,2019,reg
Andre Horta,LAFC,M,4,2,184,0,0,4,0,0,0,0,0,1,1,1,0,2019,reg
Connor Maloney,Columbus Crew SC,D,10,9,798,0,0,4,1,0,0,0,0,8,8,1,0,2019,reg
Eryk Williamson,Portland Timbers,M,7,3,234,0,0,4,1,0,0,0,0,4,3,1,0,2019,reg
Michael Parkhurst,Atlanta United FC,D,20,15,1443,0,0,4,2,0,0,0,0,11,8,3,0,2019,reg
Maikel van der Werff,FC Cincinnati,D,11,11,990,0,0,4,1,0,0,0,0,12,8,2,0,2019,reg
Terrence Boyd,Toronto FC,F,11,3,339,0,0,4,2,0,0,0,0,5,6,1,0,2019,reg
Marquinhos Pedroso,FC Dallas,D,6,4,406,0,0,4,1,0,0,0,0,4,2,0,0,2019,reg
Mathias Jorgensen,New York Red Bulls,F,5,1,117,0,0,4,1,0,0,0,0,2,1,1,0,2019,reg
Danny Leyva,FC Dallas,M,6,4,413,0,0,4,0,0,0,0,0,6,6,1,0,2019,reg
Marcelo,Chicago Fire FC,D,16,12,1147,0,0,5,1,0,0,0,0,17,7,1,0,2019,reg
Jukka Raitala,Montreal Impact,D,26,23,2083,0,0,5,1,0,0,0,0,19,16,2,0,2019,reg
Aurelien Collin,Philadelphia Union,D,6,6,530,0,0,5,0,0,0,0,0,5,4,2,0,2019,reg
Sam Vines,Colorado Rapids,D,26,23,2149,0,0,5,0,0,0,0,0,11,10,2,0,2019,reg
Nouhou Tolo,FC Dallas,D,22,9,790,0,0,5,2,0,0,0,0,17,18,5,0,2019,reg
Chase Gasper,Minnesota United FC,D,15,14,1292,0,0,5,1,0,0,0,0,26,15,6,1,2019,reg
Axel Sjöberg,Columbus Crew SC,D,7,5,435,0,0,5,1,0,0,0,0,6,3,0,1,2019,reg
Caleb Stanko,FC Cincinnati,M,23,16,1438,0,0,5,2,0,0,0,0,26,19,3,0,2019,reg
Eriq Zavaleta,Toronto FC,D,16,11,1015,0,0,5,1,0,0,0,0,12,1,2,1,2019,reg
Marlon Hairston,Minnesota United FC,M,12,5,412,0,0,6,4,0,0,0,0,1,11,0,0,2019,reg
Xavier Arreaga,FC Dallas,D,14,12,1119,0,0,6,1,0,0,0,0,15,11,3,2,2019,reg
Kyle Smith,Orlando City SC,D,23,15,1384,0,0,6,2,0,0,0,0,20,4,4,0,2019,reg
Ricardo Clark,Columbus Crew SC,M,7,4,361,0,0,6,0,0,0,0,0,6,7,0,0,2019,reg
Luis Martins,Sporting Kansas City,D,10,9,829,0,0,6,3,0,0,0,0,7,7,2,0,2019,reg
Amando Moreno,Chicago Fire FC,M-F,7,0,77,0,0,6,2,0,0,0,0,1,0,0,0,2019,reg
Carlos Fierro,San Jose Earthquakes,M,7,2,225,0,0,7,1,0,0,0,0,1,7,0,0,2019,reg
Chad Marshall,FC Dallas,D,8,8,720,0,0,7,1,0,0,0,0,6,2,0,0,2019,reg
JJ Williams,Atlanta United FC,F,7,3,325,0,0,7,1,0,0,0,0,5,5,0,0,2019,reg
Justin Dhillon,FC Dallas,F,5,3,264,0,0,7,3,0,0,0,0,5,2,0,0,2019,reg
Alvas Powell,,D,13,10,968,0,0,7,3,0,0,0,0,14,18,1,0,2019,reg
Justen Glad,Real Salt Lake,D,23,23,2064,0,0,8,2,0,0,0,0,20,11,2,0,2019,reg
Victor Cabrera,Houston Dynamo,D,16,13,1178,0,0,9,1,0,0,0,0,13,8,2,0,2019,reg
Guram Kashia,San Jose Earthquakes,D,23,21,1905,0,0,9,3,0,0,0,0,22,6,2,0,2019,reg
Robin Jansson,Orlando City SC,D,28,28,2421,0,0,10,0,0,0,0,0,17,11,6,1,2019,reg
Nick Hagglund,FC Cincinnati,D,22,20,1802,0,0,10,2,0,0,0,0,17,5,2,0,2019,reg
Sebastian Mendez,Orlando City SC,M,23,20,1814,0,0,10,0,0,0,0,0,40,13,7,0,2019,reg
Russell Canouse,DC United,M,26,25,2149,0,0,10,0,0,0,0,0,38,26,5,0,2019,reg
Pablo Aranguiz,FC Dallas,M,11,7,562,0,0,11,2,0,0,0,0,12,15,0,0,2019,reg
Luis Silva,FC Dallas,F,5,2,197,0,0,11,4,0,0,0,0,1,1,0,0,2019,reg
Maxime Chanot,New York City FC,D,31,31,2790,0,0,12,1,0,0,0,0,32,21,11,0,2019,reg
Jonathan Mensah,Columbus Crew SC,D,24,23,2151,0,0,12,3,0,0,0,0,19,6,6,0,2019,reg
Samuel Piette,Montreal Impact,M,25,25,2220,0,0,12,1,0,0,0,0,30,36,6,0,2019,reg
Joaquin Ardaiz,Vancouver Whitecaps,F,16,3,405,0,0,12,4,0,0,0,0,8,4,1,0,2019,reg
Lalas Abubakar,Colorado Rapids,D,23,23,2070,0,0,13,4,0,0,0,0,27,10,7,0,2019,reg
Claude Dielna,Portland Timbers,D,15,12,1086,0,0,13,1,0,0,0,0,17,7,3,0,2019,reg
Robin Lod,Minnesota United FC,M,10,6,583,0,0,13,6,0,0,0,0,8,4,0,0,2019,reg
Rasmus Schuller,Minnesota United FC,M,15,11,924,0,0,15,1,0,0,0,0,15,9,1,0,2019,reg
Artur,Columbus Crew SC,M,30,28,2452,0,0,15,3,0,0,0,0,48,17,4,0,2019,reg
Frankie Amaya,FC Cincinnati,M,19,15,1241,0,0,16,5,0,0,0,0,18,28,2,0,2019,reg
Tim Parker,New York Red Bulls,D,31,26,2387,0,0,16,2,0,0,0,0,21,12,5,1,2019,reg
Alexander Callens,New York City FC,D,24,24,2160,0,0,17,1,0,0,0,0,25,31,3,0,2019,reg
Brian Rodriguez,LAFC,F,7,5,385,0,0,17,5,0,0,0,0,5,5,0,0,2019,reg
Miles Robinson,Atlanta United FC,D,34,33,2978,0,0,19,6,0,0,0,0,23,26,4,0,2019,reg
Luis Alberto Caicedo,New England Revolution,M,31,27,2359,0,0,22,2,0,0,0,0,79,57,6,0,2019,reg
David Ferreira,,M,4,4,390,2,3,9,4,1,1,1,2,7,7,0,0,2010,post
Bobby Convey,,M,3,3,270,2,1,6,3,0,2,0,1,5,3,0,0,2010,post
Edson Buddle,,F,3,3,234,2,0,5,2,1,1,0,0,5,4,0,0,2010,post
Conor Casey,,F,4,4,419,2,0,11,3,0,2,0,0,11,5,2,0,2010,post
Marvin Chávez,,M,4,4,309,1,2,6,3,0,1,1,1,4,10,1,0,2010,post
Omar Gonzalez,,D,3,3,270,1,1,3,3,1,0,0,1,2,1,0,0,2010,post
George John,,D,3,3,300,1,0,2,2,0,1,0,0,2,2,0,0,2010,post
Kosuke Kimura,,D,4,4,381,1,0,2,1,1,0,0,0,2,2,0,0,2010,post
Eric Avila,,M,2,0,18,1,0,2,1,1,0,0,0,1,1,0,0,2010,post
Fabian Espindola,,F,2,2,163,1,0,4,2,0,1,0,0,1,2,0,0,2010,post
Robbie Findley,,F,2,0,47,1,0,4,2,1,0,0,0,1,1,0,0,2010,post
Eddie Gaven,,M,2,2,210,1,0,4,1,1,0,0,0,1,7,0,0,2010,post
Steve Zakuani,,M,2,2,180,1,0,4,2,0,1,0,0,1,4,0,0,2010,post
Robbie Rogers,,D,2,2,180,1,0,6,3,1,0,0,0,0,3,1,0,2010,post
Joel Lindpere,,M,2,2,179,1,0,6,3,0,1,0,0,4,2,0,0,2010,post
Jeff Cunningham,,F,3,1,191,1,0,6,3,1,0,0,0,1,1,0,0,2010,post
Juan Pablo Angel,,F,2,2,180,1,0,6,2,1,0,0,0,3,1,0,0,2010,post
Pablo Mastroeni,,M,4,4,420,1,0,6,3,1,0,0,0,9,2,1,0,2010,post
Chris Wondolowski,,F,3,3,270,1,0,7,4,0,1,0,0,1,3,1,0,2010,post
Dax McCarty,,M,4,4,387,1,0,8,3,0,1,0,0,4,6,0,0,2010,post
Brek Shea,,D,4,3,265,0,2,1,1,0,0,0,2,2,3,0,0,2010,post
Andy Williams,,M,2,2,158,0,2,4,1,0,0,1,1,2,3,1,0,2010,post
David Beckham,,M,3,3,270,0,2,9,5,0,0,2,0,3,4,2,0,2010,post
Omar Cummings,,F,4,4,398,0,2,15,4,0,0,1,1,2,5,0,0,2010,post
Jair Benítez,,D,4,4,387,0,1,0,0,0,0,1,0,2,6,2,0,2010,post
Brian Mullan,,D,4,4,376,0,1,1,1,0,0,1,0,8,4,1,0,2010,post
Nat Borchers,,D,2,2,180,0,1,1,0,0,0,1,0,3,0,1,0,2010,post
Arturo Alvarez,,M,3,0,69,0,1,2,0,0,0,0,1,0,1,0,0,2010,post
Ugo Ihemelu,,D,4,4,390,0,1,2,0,0,0,0,1,1,1,0,0,2010,post
Nate Jaqua,,F,2,0,22,0,1,2,1,0,0,0,1,1,0,0,0,2010,post
Emmanuel Ekpo,,M,2,2,171,0,1,2,1,0,0,1,0,3,3,1,0,2010,post
Scott Sealy,,F,3,3,242,0,1,2,0,0,0,0,1,7,8,0,0,2010,post
Atiba Harris,,D,3,3,285,0,1,3,1,0,0,0,1,10,3,0,1,2010,post
Guillermo Barros Schelotto,,F,2,2,188,0,1,3,1,0,0,1,0,2,3,1,0,2010,post
Juan Agudelo,,F,2,2,174,0,1,4,2,0,0,1,0,2,3,0,0,2010,post
Ryan Johnson,,F,3,3,270,0,1,5,2,0,0,0,1,3,6,0,0,2010,post
Tim Ward,,D,3,3,270,0,0,0,0,0,0,0,0,3,3,0,0,2010,post
Brad Evans,,D-M,0,0,0,0,0,0,0,0,0,0,0,0,0,0,0,2010,post
Danny O'Rourke,,D,0,0,0,0,0,0,0,0,0,0,0,0,0,0,0,2010,post
Jason Garey,,F,2,0,77,0,0,0,0,0,0,0,0,1,0,0,0,2010,post
Tyson Wahl,,D,0,0,0,0,0,0,0,0,0,0,0,0,0,0,0,2010,post
James Riley,,D,2,2,180,0,0,0,0,0,0,0,0,1,1,0,0,2010,post
Marvell Wynne,,D,4,4,420,0,0,0,0,0,0,0,0,2,1,0,0,2010,post
Carlos Mendes,,D,2,2,174,0,0,0,0,0,0,0,0,3,0,0,0,2010,post
Seth Stammler,,M-D,0,0,0,0,0,0,0,0,0,0,0,0,0,0,0,2010,post
Khari Stephenson,,M,2,0,26,0,0,0,0,0,0,0,0,0,0,0,0,2010,post
Cornell Glen,,F,0,0,0,0,0,0,0,0,0,0,0,0,0,0,0,2010,post
Andrew Boyens,,D,0,0,0,0,0,0,0,0,0,0,0,0,0,0,0,2010,post
Chris Albright,,D,2,2,174,0,0,0,0,0,0,0,0,3,2,0,0,2010,post
Tyrone Marshall,,D,2,1,115,0,0,0,0,0,0,0,0,2,1,0,0,2010,post
Milton Rodriguez,,F,1,1,32,0,0,0,0,0,0,0,0,1,1,0,0,2010,post
Pat Noonan,,F,0,0,0,0,0,0,0,0,0,0,0,0,0,0,0,2010,post
Peter Vagenas,,M,0,0,0,0,0,0,0,0,0,0,0,0,0,0,0,2010,post
Ramiro Corrales,,M,2,2,135,0,0,0,0,0,0,0,0,1,1,1,0,2010,post
Leandre Griffit,,M,0,0,0,0,0,0,0,0,0,0,0,0,0,0,0,2010,post
Emilio Rentería,,F,0,0,0,0,0,0,0,0,0,0,0,0,0,0,0,2010,post
Robbie Russell,,D,2,2,146,0,0,0,0,0,0,0,0,1,1,0,0,2010,post
Heath Pearce,,D,0,0,0,0,0,0,0,0,0,0,0,0,0,0,0,2010,post
Carey Talley,,D,0,0,0,0,0,0,0,0,0,0,0,0,0,0,0,2010,post
Chris Klein,,M,0,0,0,0,0,0,0,0,0,0,0,0,0,0,0,2010,post
Chris Leitch,,D,1,1,57,0,0,0,0,0,0,0,0,0,0,0,0,2010,post
Duncan Oughton,,D,0,0,0,0,0,0,0,0,0,0,0,0,0,0,0,2010,post
André Luiz,,M,0,0,0,0,0,0,0,0,0,0,0,0,0,0,0,2010,post
Carl Robinson,,M,1,0,1,0,0,0,0,0,0,0,0,0,1,0,0,2010,post
Eddie Lewis,,M,3,3,256,0,0,0,0,0,0,0,0,1,2,0,0,2010,post
Gino Padula,,D,0,0,0,0,0,0,0,0,0,0,0,0,0,0,0,2010,post
Gregg Berhalter,,D,1,0,6,0,0,0,0,0,0,0,0,0,1,0,0,2010,post
Claudio Lopez,,F,1,0,38,0,0,0,0,0,0,0,0,0,0,0,0,2010,post
Mike Petke,,D,0,0,0,0,0,0,0,0,0,0,0,0,0,0,0,2010,post
Julien Baudet,,D,4,0,88,0,0,0,0,0,0,0,0,2,0,0,0,2010,post
Dema Kovalenko,,M,3,3,209,0,0,0,0,0,0,0,0,8,3,2,0,2010,post
Ciaran O'Brien,,M,0,0,0,0,0,0,0,0,0,0,0,0,0,0,0,2010,post
Rauwshan McKenzie,,D,0,0,0,0,0,0,0,0,0,0,0,0,0,0,0,2010,post
Bryan Jordan,,D,0,0,0,0,0,0,0,0,0,0,0,0,0,0,0,2010,post
Javier Morales,,M,1,1,69,0,0,0,0,0,0,0,0,5,3,1,1,2010,post
Adam Moffat,,M,0,0,0,0,0,0,0,0,0,0,0,0,0,0,0,2010,post
Danleigh Borman,,D,0,0,0,0,0,0,0,0,0,0,0,0,0,0,0,2010,post
Eric Brunner,,D,1,1,120,0,0,0,0,0,0,0,0,1,2,0,0,2010,post
Bobby Burling,,D,0,0,0,0,0,0,0,0,0,0,0,0,0,0,0,2010,post
Patrick Ianni,,D-M,2,2,167,0,0,0,0,0,0,0,0,1,1,1,0,2010,post
Jason Hernandez,,D,3,3,270,0,0,0,0,0,0,0,0,1,1,0,0,2010,post
Chris Wingert,,D,1,1,90,0,0,0,0,0,0,0,0,0,1,0,0,2010,post
Sinisa Ubiparipovic,,F-M,0,0,0,0,0,0,0,0,0,0,0,0,0,0,0,2010,post
Todd Dunivant,,D,1,0,10,0,0,0,0,0,0,0,0,1,0,0,0,2010,post
Taylor Graham,,D,0,0,0,0,0,0,0,0,0,0,0,0,0,0,0,2010,post
Pablo Campos,,F,0,0,0,0,0,0,0,0,0,0,0,0,0,0,0,2010,post
Alex Cazumba,,M,1,0,35,0,0,0,0,0,0,0,0,1,2,1,0,2010,post
Brian Nielsen,,M,0,0,0,0,0,0,0,0,0,0,0,0,0,0,0,2010,post
Álvaro Fernández,,M,2,0,61,0,0,0,0,0,0,0,0,2,1,0,0,2010,post
Bruno Guarda,,M,0,0,0,0,0,0,0,0,0,0,0,0,0,0,0,2010,post
Kyle Davies,,D,0,0,0,0,0,0,0,0,0,0,0,0,0,0,0,2010,post
Ross Schunk,,F,0,0,0,0,0,0,0,0,0,0,0,0,0,0,0,2010,post
Peri Marosevic,,F,0,0,0,0,0,0,0,0,0,0,0,0,0,0,0,2010,post
A.J. DeLaGarza,,D,3,3,270,0,0,0,0,0,0,0,0,3,3,0,0,2010,post
Tony Beltran,,D,1,1,90,0,0,0,0,0,0,0,0,0,3,0,0,2010,post
Alex Nimo,,F-M,0,0,0,0,0,0,0,0,0,0,0,0,0,0,0,2010,post
David Horst,,D,0,0,0,0,0,0,0,0,0,0,0,0,0,0,0,2010,post
Luke Sassano,,D,0,0,0,0,0,0,0,0,0,0,0,0,0,0,0,2010,post
Jeremy Hall,,D-M,2,0,7,0,0,0,0,0,0,0,0,0,0,0,0,2010,post
Quincy Amarikwa,,F,1,0,1,0,0,0,0,0,0,0,0,0,0,0,0,2010,post
Brad Ring,,D,0,0,0,0,0,0,0,0,0,0,0,0,0,0,0,2010,post
Jean-Marc Alexandre,,F,1,0,17,0,0,0,0,0,0,0,0,0,0,0,0,2010,post
Jhon Kennedy Hurtado,,D,0,0,0,0,0,0,0,0,0,0,0,0,0,0,0,2010,post
Dilly Duka,,M,0,0,0,0,0,0,0,0,0,0,0,0,0,0,0,2010,post
Ike Opara,,D,0,0,0,0,0,0,0,0,0,0,0,0,0,0,0,2010,post
Michael Stephens,,M,0,0,0,0,0,0,0,0,0,0,0,0,0,0,0,2010,post
Danny Earls,,D,0,0,0,0,0,0,0,0,0,0,0,0,0,0,0,2010,post
Ross LaBauex,,M,0,0,0,0,0,0,0,0,0,0,0,0,0,0,0,2010,post
Tim Ream,,D,2,2,180,0,0,0,0,0,0,0,0,2,2,0,0,2010,post
Tony Tchani,,M,0,0,0,0,0,0,0,0,0,0,0,0,0,0,0,2010,post
Eric Alexander,,M,2,0,5,0,0,0,0,0,0,0,0,0,0,0,0,2010,post
Leonardo,,D,0,0,0,0,0,0,0,0,0,0,0,0,0,0,0,2010,post
Mike Seamon,,M-F,0,0,0,0,0,0,0,0,0,0,0,0,0,0,0,2010,post
Paulo Jr.,,F,1,0,17,0,0,0,0,0,0,0,0,0,0,0,0,2010,post
Josh Williams,,D,0,0,0,0,0,0,0,0,0,0,0,0,0,0,0,2010,post
Davy Armstrong,,M,0,0,0,0,0,0,0,0,0,0,0,0,0,0,0,2010,post
Nelson González,,M,0,0,0,0,0,0,0,0,0,0,0,0,0,0,0,2010,post
Joey Gjertsen,,M,0,0,0,0,0,0,0,0,0,0,0,0,0,0,0,2010,post
David Estrada,,M-F,0,0,0,0,0,0,0,0,0,0,0,0,0,0,0,2010,post
Conor Chinn,,F,0,0,0,0,0,0,0,0,0,0,0,0,0,0,0,2010,post
Steven Beitashour,,D,0,0,0,0,0,0,0,0,0,0,0,0,0,0,0,2010,post
Zach Loyd,,D,4,1,221,0,0,0,0,0,0,0,0,4,2,2,0,2010,post
Edson Edward,,D,0,0,0,0,0,0,0,0,0,0,0,0,0,0,0,2010,post
Jason Yeisley,,F,0,0,0,0,0,0,0,0,0,0,0,0,0,0,0,2010,post
Justin Morrow,,D,0,0,0,0,0,0,0,0,0,0,0,0,0,0,0,2010,post
Omar Jasseh,,M,0,0,0,0,0,0,0,0,0,0,0,0,0,0,0,2010,post
Collen Warner,,M,1,0,34,0,0,0,0,0,0,0,0,0,1,0,0,2010,post
Luis Gil,,M,0,0,0,0,0,0,0,0,0,0,0,0,0,0,0,2010,post
Andre Akpan,,F,0,0,0,0,0,0,0,0,0,0,0,0,0,0,0,2010,post
Roger Levesque,,M,0,0,0,0,0,0,0,0,0,0,0,0,0,0,0,2010,post
Zach Scott,,D,0,0,0,0,0,0,0,0,0,0,0,0,0,0,0,2010,post
Yohance Marshall,,D,0,0,0,0,0,0,0,0,0,0,0,0,0,0,0,2010,post
Scott Palguta,,D,0,0,0,0,0,0,0,0,0,0,0,0,0,0,0,2010,post
Tristan Bowen,,F,1,0,19,0,0,0,0,0,0,0,0,1,0,0,0,2010,post
Giorgi Chirgadze,,F,0,0,0,0,0,0,0,0,0,0,0,0,0,0,0,2010,post
Austin da Luz,,M,0,0,0,0,0,0,0,0,0,0,0,0,0,0,0,2010,post
Irving Garcia,,M,0,0,0,0,0,0,0,0,0,0,0,0,0,0,0,2010,post
Bryan Leyva,,M,0,0,0,0,0,0,0,0,0,0,0,0,0,0,0,2010,post
Andrew Wiedeman,,F,0,0,0,0,0,0,0,0,0,0,0,0,0,0,0,2010,post
Chris Schuler,,D,0,0,0,0,0,0,0,0,0,0,0,0,0,0,0,2010,post
Miguel Montaño,,F,0,0,0,0,0,0,0,0,0,0,0,0,0,0,0,2010,post
Shaun Francis,,D,2,2,210,0,0,1,0,0,0,0,0,2,0,1,0,2010,post
Jackson Goncalves,,M,4,4,302,0,0,1,0,0,0,0,0,6,0,0,0,2010,post
Ruben Luna,,F,1,0,13,0,0,1,1,0,0,0,0,0,1,0,0,2010,post
Sanna Nyassi,,M,2,2,119,0,0,1,1,0,0,0,0,5,1,0,0,2010,post
Mike Fucito,,F,1,0,26,0,0,1,0,0,0,0,0,0,0,0,0,2010,post
Sam Cronin,,M,3,3,238,0,0,1,0,0,0,0,0,4,0,0,0,2010,post
Jámison Olave,,D,2,2,180,0,0,1,0,0,0,0,0,5,0,1,0,2010,post
Macoumba Kandji,,F,3,0,81,0,0,1,1,0,0,0,0,1,0,0,0,2010,post
Jeff Parke,,D,1,1,65,0,0,1,0,0,0,0,0,1,1,0,0,2010,post
Anthony Wallace,,D,4,4,333,0,0,1,0,0,0,0,0,4,2,1,0,2010,post
Brandon McDonald,,D,3,3,270,0,0,1,0,0,0,0,0,2,1,0,0,2010,post
Sean Franklin,,D,3,3,270,0,0,1,1,0,0,0,0,3,2,0,0,2010,post
Andy Iro,,D,1,1,90,0,0,1,1,0,0,0,0,1,0,0,0,2010,post
Frankie Hejduk,,D,2,2,210,0,0,1,1,0,0,0,0,2,1,0,0,2010,post
Thierry Henry,,F,1,0,6,0,0,1,0,0,0,0,0,0,0,0,0,2010,post
Jovan Kirovski,,M-F,2,0,25,0,0,1,0,0,0,0,0,1,0,1,0,2010,post
Andrés Mendoza,,F,2,1,87,0,0,1,0,0,0,0,0,0,0,0,0,2010,post
Chad Marshall,,D,2,2,210,0,0,1,1,0,0,0,0,2,2,0,0,2010,post
Alvaro Saborio,,F,2,2,133,0,0,1,1,0,0,0,0,1,1,0,0,2010,post
Eduardo da Silva,,F,3,0,84,0,0,1,0,0,0,0,0,2,1,0,0,2010,post
Salou Ibrahim,,F,1,0,6,0,0,1,1,0,0,0,0,0,0,0,0,2010,post
Kevin Burns,,M,2,0,45,0,0,2,0,0,0,0,0,1,1,0,0,2010,post
Ned Grabavoy,,M,2,2,163,0,0,2,1,0,0,0,0,3,1,1,0,2010,post
Wells Thompson,,D,3,2,195,0,0,2,0,0,0,0,0,1,2,0,0,2010,post
Roy Miller,,D,2,2,180,0,0,2,0,0,0,0,0,3,0,1,0,2010,post
Kyle Beckerman,,M,2,2,180,0,0,2,1,0,0,0,0,3,0,0,0,2010,post
Brian Carroll,,M,2,2,204,0,0,2,0,0,0,0,0,3,1,2,0,2010,post
Chris Birchall,,M,3,0,61,0,0,2,0,0,0,0,0,1,1,1,0,2010,post
Drew Moor,,D,4,4,420,0,0,2,1,0,0,0,0,3,6,0,0,2010,post
Nathan Sturgis,,M,2,2,145,0,0,2,2,0,0,0,0,1,2,0,0,2010,post
Leonardo González,,D,2,2,180,0,0,2,0,0,0,0,0,5,2,0,0,2010,post
Daniel Hernandez,,M,4,4,390,0,0,3,0,0,0,0,0,5,7,1,0,2010,post
Steven Lenhart,,F,2,1,98,0,0,3,0,0,0,0,0,2,2,0,0,2010,post
Osvaldo Alonso,,M,2,2,180,0,0,3,2,0,0,0,0,3,3,0,0,2010,post
Jamie Smith,,M,2,2,210,0,0,3,1,0,0,0,0,2,5,1,0,2010,post
Will Johnson,,D,2,1,112,0,0,3,2,0,0,0,0,0,4,0,0,2010,post
Dane Richards,,M,2,2,180,0,0,4,0,0,0,0,0,2,4,0,0,2010,post
Juninho,,M,3,3,270,0,0,5,1,0,0,0,0,4,0,1,0,2010,post
Mike Magee,,M,3,3,225,0,0,5,2,0,0,0,0,4,5,0,0,2010,post
Rafa Márquez,,M,2,2,180,0,0,5,2,0,0,0,0,5,4,0,0,2010,post
Blaise Nkufo,,F,2,2,180,0,0,5,2,0,0,0,0,0,6,1,0,2010,post
Landon Donovan,,M-F,3,3,270,0,0,6,2,0,0,0,0,2,7,0,0,2010,post
Geovanni Deiberson,,F,3,3,229,0,0,6,2,0,0,0,0,2,4,0,0,2010,post
Fredy Montero,,F,2,2,180,0,0,7,2,0,0,0,0,3,3,1,0,2010,post
Mehdi Ballouchy,,M,2,2,179,0,0,7,3,0,0,0,0,2,1,1,0,2010,post
Jeff Larentowicz,,M,4,4,420,0,0,9,4,0,0,0,0,4,6,0,0,2010,post
Landon Donovan,,M-F,4,4,360,3,1,11,5,3,0,1,0,7,10,2,0,2011,post
Alvaro Saborio,,F,3,3,256,3,0,8,4,2,1,0,0,6,7,0,0,2011,post
Mike Magee,,M,4,4,360,3,0,9,3,2,1,0,0,1,5,0,0,2011,post
Andre Hainault,,D,4,4,360,2,0,4,3,0,2,0,0,8,1,1,0,2011,post
Teal Bunbury,,F,3,3,246,2,0,7,3,0,2,0,0,5,4,1,0,2011,post
Brian Ching,,F,4,4,320,1,1,6,3,1,0,0,1,6,12,0,0,2011,post
Robbie Keane,,F,4,4,352,1,1,11,3,1,0,1,0,2,3,0,0,2011,post
Thierry Henry,,F,3,3,270,1,1,12,4,0,1,0,1,8,4,2,0,2011,post
Ned Grabavoy,,M,3,0,64,1,0,1,1,1,0,0,0,1,2,0,0,2011,post
Sébastien Le Toux,,F,2,2,180,1,0,2,1,1,0,0,0,1,1,0,0,2011,post
Carlo Costly,,F,4,0,64,1,0,3,1,0,1,0,0,3,1,1,0,2011,post
Aurelien Collin,,D,3,3,270,1,0,4,1,1,0,0,0,5,1,0,0,2011,post
Lamar Neagle,,M,2,1,136,1,0,5,3,1,0,0,0,2,0,0,0,2011,post
CJ Sapong,,F,3,3,270,1,0,5,5,1,0,0,0,8,7,0,0,2011,post
Osvaldo Alonso,,M,2,2,180,1,0,6,1,1,0,0,0,1,1,1,0,2011,post
Calen Carr,,F,4,4,299,1,0,6,3,0,1,0,0,7,4,1,0,2011,post
Luke Rodgers,,F,2,2,170,1,0,6,3,0,1,0,0,2,4,1,0,2011,post
Joel Lindpere,,M,3,3,267,1,0,7,3,0,1,0,0,3,5,0,0,2011,post
Omar Cummings,,F,3,3,203,1,0,10,3,1,0,0,0,0,4,0,0,2011,post
David Beckham,,M,4,4,348,0,4,7,1,0,0,3,1,8,11,1,0,2011,post
Javier Morales,,M,3,3,258,0,3,2,2,0,0,2,1,4,10,1,0,2011,post
Graham Zusi,,M,3,3,270,0,2,4,0,0,0,2,0,5,3,0,0,2011,post
Brad Davis,,M,3,3,219,0,2,4,2,0,0,1,1,4,1,0,0,2011,post
Jámison Olave,,D,2,2,114,0,1,0,0,0,0,0,1,3,0,0,0,2011,post
Mehdi Ballouchy,,M,3,0,44,0,1,0,0,0,0,0,1,1,1,0,0,2011,post
Chris Wingert,,D,3,3,270,0,1,0,0,0,0,1,0,3,1,0,0,2011,post
Kosuke Kimura,,D,2,2,126,0,1,0,0,0,0,1,0,0,0,0,0,2011,post
Luiz Camargo,,M,4,4,360,0,1,0,0,0,0,0,1,5,0,2,0,2011,post
Justin Mapp,,M,2,1,92,0,1,1,0,0,0,1,0,0,2,0,0,2011,post
Brian Mullan,,D,3,3,270,0,1,1,0,0,0,1,0,5,9,1,0,2011,post
Júlio César,,D,3,3,239,0,1,1,0,0,0,0,1,1,5,2,0,2011,post
Dane Richards,,M,3,3,262,0,1,2,1,0,0,0,1,5,5,0,0,2011,post
Michael Farfan,,M,2,2,180,0,1,3,1,0,0,1,0,3,1,0,0,2011,post
Fredy Montero,,F,2,2,180,0,1,5,1,0,0,1,0,5,5,1,0,2011,post
Cam Weaver,,F,0,0,0,0,0,0,0,0,0,0,0,0,0,0,0,2011,post
Jean-Marc Alexandre,,F,0,0,0,0,0,0,0,0,0,0,0,0,0,0,0,2011,post
O'Brian White,,F,0,0,0,0,0,0,0,0,0,0,0,0,0,0,0,2011,post
Jhon Kennedy Hurtado,,D,2,2,180,0,0,0,0,0,0,0,0,3,1,0,0,2011,post
A.J. DeLaGarza,,D,4,4,360,0,0,0,0,0,0,0,0,8,0,0,0,2011,post
Omar Gonzalez,,D,4,4,360,0,0,0,0,0,0,0,0,3,9,0,0,2011,post
Jeremy Hall,,D-M,0,0,0,0,0,0,0,0,0,0,0,0,0,0,0,2011,post
Michael Holody,,D,0,0,0,0,0,0,0,0,0,0,0,0,0,0,0,2011,post
Brian Nielsen,,M,0,0,0,0,0,0,0,0,0,0,0,0,0,0,0,2011,post
Luke Sassano,,D,0,0,0,0,0,0,0,0,0,0,0,0,0,0,0,2011,post
Emmanuel Ekpo,,M,0,0,0,0,0,0,0,0,0,0,0,0,0,0,0,2011,post
Keon Daniel,,M,0,0,0,0,0,0,0,0,0,0,0,0,0,0,0,2011,post
Bruno Guarda,,M,0,0,0,0,0,0,0,0,0,0,0,0,0,0,0,2011,post
Joe Tait,,D,0,0,0,0,0,0,0,0,0,0,0,0,0,0,0,2011,post
Milos Stojcev,,M,0,0,0,0,0,0,0,0,0,0,0,0,0,0,0,2011,post
John Rooney,,M,0,0,0,0,0,0,0,0,0,0,0,0,0,0,0,2011,post
Julius James,,D,1,1,90,0,0,0,0,0,0,0,0,0,1,0,0,2011,post
Chance Myers,,D,3,3,270,0,0,0,0,0,0,0,0,5,4,0,0,2011,post
Rauwshan McKenzie,,D,0,0,0,0,0,0,0,0,0,0,0,0,0,0,0,2011,post
Sean Franklin,,D,4,4,360,0,0,0,0,0,0,0,0,3,4,2,0,2011,post
Bryan Jordan,,D,0,0,0,0,0,0,0,0,0,0,0,0,0,0,0,2011,post
Tony Beltran,,D,2,1,98,0,0,0,0,0,0,0,0,3,1,1,0,2011,post
Taylor Graham,,D,0,0,0,0,0,0,0,0,0,0,0,0,0,0,0,2011,post
Todd Dunivant,,D,4,4,360,0,0,0,0,0,0,0,0,1,4,0,0,2011,post
Hunter Freeman,,D,0,0,0,0,0,0,0,0,0,0,0,0,0,0,0,2011,post
Arturo Alvarez,,M,0,0,0,0,0,0,0,0,0,0,0,0,0,0,0,2011,post
Dax McCarty,,M,2,2,123,0,0,0,0,0,0,0,0,1,1,0,0,2011,post
Maykel Galindo,,F,0,0,0,0,0,0,0,0,0,0,0,0,0,0,0,2011,post
Colin Clark,,M,1,0,12,0,0,0,0,0,0,0,0,1,0,0,0,2011,post
Jack Stewart,,D,0,0,0,0,0,0,0,0,0,0,0,0,0,0,0,2011,post
Nat Borchers,,D,1,1,84,0,0,0,0,0,0,0,0,0,0,0,0,2011,post
Blake Wagner,,D-M,0,0,0,0,0,0,0,0,0,0,0,0,0,0,0,2011,post
Anthony Wallace,,D,0,0,0,0,0,0,0,0,0,0,0,0,0,0,0,2011,post
Patrick Ianni,,D-M,0,0,0,0,0,0,0,0,0,0,0,0,0,0,0,2011,post
Shavar Thomas,,D,0,0,0,0,0,0,0,0,0,0,0,0,0,0,0,2011,post
Nate Jaqua,,F,0,0,0,0,0,0,0,0,0,0,0,0,0,0,0,2011,post
Carl Robinson,,M,0,0,0,0,0,0,0,0,0,0,0,0,0,0,0,2011,post
Stefani Miglioranzi,,M,1,1,62,0,0,0,0,0,0,0,0,1,0,1,0,2011,post
Gregg Berhalter,,D,0,0,0,0,0,0,0,0,0,0,0,0,0,0,0,2011,post
Nick Kounenakis ,,D,0,0,0,0,0,0,0,0,0,0,0,0,0,0,0,2011,post
Conor Casey,,F,0,0,0,0,0,0,0,0,0,0,0,0,0,0,0,2011,post
Frankie Hejduk,,D,0,0,0,0,0,0,0,0,0,0,0,0,0,0,0,2011,post
Jovan Kirovski,,M-F,0,0,0,0,0,0,0,0,0,0,0,0,0,0,0,2011,post
Daniel Cruz,,M,1,0,23,0,0,0,0,0,0,0,0,1,0,0,0,2011,post
Eddie Robinson,,D,0,0,0,0,0,0,0,0,0,0,0,0,0,0,0,2011,post
Tyrone Marshall,,D,1,0,21,0,0,0,0,0,0,0,0,1,0,0,1,2011,post
Chris Albright,,D,0,0,0,0,0,0,0,0,0,0,0,0,0,0,0,2011,post
Koke,,F,0,0,0,0,0,0,0,0,0,0,0,0,0,0,0,2011,post
Carlos Ruiz,,F,0,0,0,0,0,0,0,0,0,0,0,0,0,0,0,2011,post
Jeff Cunningham,,F,1,0,15,0,0,0,0,0,0,0,0,0,0,0,0,2011,post
Pablo Mastroeni,,M,0,0,0,0,0,0,0,0,0,0,0,0,0,0,0,2011,post
Blaise Nkufo,,F,0,0,0,0,0,0,0,0,0,0,0,0,0,0,0,2011,post
Dasan Robinson,,D,0,0,0,0,0,0,0,0,0,0,0,0,0,0,0,2011,post
Brad Evans,,D-M,2,2,111,0,0,0,0,0,0,0,0,0,2,0,0,2011,post
Danny O'Rourke,,D,0,0,0,0,0,0,0,0,0,0,0,0,0,0,0,2011,post
Jason Garey,,F,0,0,0,0,0,0,0,0,0,0,0,0,0,0,0,2011,post
James Riley,,D,1,1,90,0,0,0,0,0,0,0,0,2,1,0,0,2011,post
Kevin Burns,,M,0,0,0,0,0,0,0,0,0,0,0,0,0,0,0,2011,post
Bobby Boswell,,D,4,4,360,0,0,0,0,0,0,0,0,3,4,1,0,2011,post
Michael Harrington,,D,0,0,0,0,0,0,0,0,0,0,0,0,0,0,0,2011,post
Tyson Wahl,,D,0,0,0,0,0,0,0,0,0,0,0,0,0,0,0,2011,post
Ricardo Villar,,M,1,1,82,0,0,0,0,0,0,0,0,1,3,0,0,2011,post
David Ferreira,,M,0,0,0,0,0,0,0,0,0,0,0,0,0,0,0,2011,post
Milton Rodriguez,,F,0,0,0,0,0,0,0,0,0,0,0,0,0,0,0,2011,post
Pat Noonan,,F,0,0,0,0,0,0,0,0,0,0,0,0,0,0,0,2011,post
Chad Marshall,,D,1,1,90,0,0,0,0,0,0,0,0,2,0,0,0,2011,post
Craig Rocastle,,M,0,0,0,0,0,0,0,0,0,0,0,0,0,0,0,2011,post
Ryan Smith,,M,0,0,0,0,0,0,0,0,0,0,0,0,0,0,0,2011,post
Emilio Rentería,,F,1,0,25,0,0,0,0,0,0,0,0,0,0,0,0,2011,post
Mauro Rosales,,M,0,0,0,0,0,0,0,0,0,0,0,0,0,0,0,2011,post
Omar Bravo,,F,1,0,5,0,0,0,0,0,0,0,0,0,0,0,0,2011,post
Eddie Gaven,,M,1,1,90,0,0,0,0,0,0,0,0,0,1,0,0,2011,post
Servando Carrasco,,M,0,0,0,0,0,0,0,0,0,0,0,0,0,0,0,2011,post
Mike Jones,,D,0,0,0,0,0,0,0,0,0,0,0,0,0,0,0,2011,post
Bobby Warshaw,,D,0,0,0,0,0,0,0,0,0,0,0,0,0,0,0,2011,post
Josue Soto,,D-M,0,0,0,0,0,0,0,0,0,0,0,0,0,0,0,2011,post
Ryan Richter,,D,0,0,0,0,0,0,0,0,0,0,0,0,0,0,0,2011,post
Will Bruin,,F,3,0,37,0,0,0,0,0,0,0,0,0,0,0,0,2011,post
Alex Dixon,,M,0,0,0,0,0,0,0,0,0,0,0,0,0,0,0,2011,post
Kofi Sarkodie,,D,0,0,0,0,0,0,0,0,0,0,0,0,0,0,0,2011,post
Moises Hernandez,,D,0,0,0,0,0,0,0,0,0,0,0,0,0,0,0,2011,post
Victor Ulloa,,M,0,0,0,0,0,0,0,0,0,0,0,0,0,0,0,2011,post
Jonathan Top,,F,0,0,0,0,0,0,0,0,0,0,0,0,0,0,0,2011,post
Chris Agorsor,,F,0,0,0,0,0,0,0,0,0,0,0,0,0,0,0,2011,post
Sacir Hot,,D,0,0,0,0,0,0,0,0,0,0,0,0,0,0,0,2011,post
Jack McBean,,F,0,0,0,0,0,0,0,0,0,0,0,0,0,0,0,2011,post
Scott Lorenz,,D,0,0,0,0,0,0,0,0,0,0,0,0,0,0,0,2011,post
Fabian Castillo,,M-F,1,0,8,0,0,0,0,0,0,0,0,0,0,0,0,2011,post
Konrad Warzycha,,M,0,0,0,0,0,0,0,0,0,0,0,0,0,0,0,2011,post
Kevin Ellis,,D,0,0,0,0,0,0,0,0,0,0,0,0,0,0,0,2011,post
Danny Earls,,D,0,0,0,0,0,0,0,0,0,0,0,0,0,0,0,2011,post
Tony Tchani,,M,1,1,90,0,0,0,0,0,0,0,0,0,2,0,0,2011,post
Leonardo,,D,0,0,0,0,0,0,0,0,0,0,0,0,0,0,0,2011,post
Andre Akpan,,F,0,0,0,0,0,0,0,0,0,0,0,0,0,0,0,2011,post
Shaun Francis,,D,0,0,0,0,0,0,0,0,0,0,0,0,0,0,0,2011,post
Bryan Leyva,,M,0,0,0,0,0,0,0,0,0,0,0,0,0,0,0,2011,post
Andrew Wiedeman,,F,0,0,0,0,0,0,0,0,0,0,0,0,0,0,0,2011,post
Ruben Luna,,F,0,0,0,0,0,0,0,0,0,0,0,0,0,0,0,2011,post
Paulo Jr.,,F,0,0,0,0,0,0,0,0,0,0,0,0,0,0,0,2011,post
Zach Pfeffer,,M,0,0,0,0,0,0,0,0,0,0,0,0,0,0,0,2011,post
Matt Kassel,,D-M,0,0,0,0,0,0,0,0,0,0,0,0,0,0,0,2011,post
Rich Balchan,,D,1,1,90,0,0,0,0,0,0,0,0,0,0,0,0,2011,post
Andy Adlard,,M,0,0,0,0,0,0,0,0,0,0,0,0,0,0,0,2011,post
Bernardo Añor,,M,0,0,0,0,0,0,0,0,0,0,0,0,0,0,0,2011,post
Justin Meram,,M,0,0,0,0,0,0,0,0,0,0,0,0,0,0,0,2011,post
Eric Gehrig,,D,0,0,0,0,0,0,0,0,0,0,0,0,0,0,0,2011,post
Cole Grossman,,M,0,0,0,0,0,0,0,0,0,0,0,0,0,0,0,2011,post
Sebastián Miranda,,D,1,1,70,0,0,0,0,0,0,0,0,1,0,1,0,2011,post
Dejan Rusmir,,M,0,0,0,0,0,0,0,0,0,0,0,0,0,0,0,2011,post
Amadou Sanyang,,D,0,0,0,0,0,0,0,0,0,0,0,0,0,0,0,2011,post
Cody Arnoux,,F,0,0,0,0,0,0,0,0,0,0,0,0,0,0,0,2011,post
Nelson González,,M,0,0,0,0,0,0,0,0,0,0,0,0,0,0,0,2011,post
Matt Besler,,D,3,3,270,0,0,0,0,0,0,0,0,3,1,0,0,2011,post
Steve Zakuani,,M,0,0,0,0,0,0,0,0,0,0,0,0,0,0,0,2011,post
Korede Aiyegbusi,,D,0,0,0,0,0,0,0,0,0,0,0,0,0,0,0,2011,post
Seth Sinovic,,D,3,3,265,0,0,0,0,0,0,0,0,4,3,0,0,2011,post
David Estrada,,M-F,0,0,0,0,0,0,0,0,0,0,0,0,0,0,0,2011,post
Zach Loyd,,D,1,1,90,0,0,0,0,0,0,0,0,1,2,0,0,2011,post
Edson Edward,,D,0,0,0,0,0,0,0,0,0,0,0,0,0,0,0,2011,post
Birahim Diop,,M,1,0,11,0,0,0,0,0,0,0,0,0,0,0,0,2011,post
Francisco Navas Cobo,,M,0,0,0,0,0,0,0,0,0,0,0,0,0,0,0,2011,post
Jordan Graye,,D,0,0,0,0,0,0,0,0,0,0,0,0,0,0,0,2011,post
Collen Warner,,M,0,0,0,0,0,0,0,0,0,0,0,0,0,0,0,2011,post
Daneil Cyrus,,D,0,0,0,0,0,0,0,0,0,0,0,0,0,0,0,2011,post
Peterson Joseph,,M,0,0,0,0,0,0,0,0,0,0,0,0,0,0,0,2011,post
Michael Stephens,,M,2,0,12,0,0,0,0,0,0,0,0,0,0,0,0,2011,post
Amobi Okugo,,D-M,0,0,0,0,0,0,0,0,0,0,0,0,0,0,0,2011,post
Kyle Nakazawa,,M,0,0,0,0,0,0,0,0,0,0,0,0,0,0,0,2011,post
Lawrence Olum,,D,0,0,0,0,0,0,0,0,0,0,0,0,0,0,0,2011,post
Morgan Langley,,M,0,0,0,0,0,0,0,0,0,0,0,0,0,0,0,2011,post
Yordany Álvarez,,M,1,0,14,0,0,0,0,0,0,0,0,0,0,0,0,2011,post
Nico Muñiz,,M,0,0,0,0,0,0,0,0,0,0,0,0,0,0,0,2011,post
Mike Seamon,,M-F,0,0,0,0,0,0,0,0,0,0,0,0,0,0,0,2011,post
Miguel López,,M,0,0,0,0,0,0,0,0,0,0,0,0,0,0,0,2011,post
Joseph Nane,,M,1,1,56,0,0,0,0,0,0,0,0,2,1,1,0,2011,post
Juan Diego González,,D,0,0,0,0,0,0,0,0,0,0,0,0,0,0,0,2011,post
Miguel Montaño,,F,0,0,0,0,0,0,0,0,0,0,0,0,0,0,0,2011,post
Sean Alvarado,,D,0,0,0,0,0,0,0,0,0,0,0,0,0,0,0,2011,post
Levi Houapeu,,F,0,0,0,0,0,0,0,0,0,0,0,0,0,0,0,2011,post
Gabriel Farfan,,M,2,2,157,0,0,0,0,0,0,0,0,4,3,2,0,2011,post
Tyler Lassiter,,D,0,0,0,0,0,0,0,0,0,0,0,0,0,0,0,2011,post
Josh Janniere,,M,0,0,0,0,0,0,0,0,0,0,0,0,0,0,0,2011,post
Donny Toia,,D,0,0,0,0,0,0,0,0,0,0,0,0,0,0,0,2011,post
Teddy Schneider,,D,0,0,0,0,0,0,0,0,0,0,0,0,0,0,0,2011,post
Je-Vaughn Watson,,D,3,0,64,0,0,0,0,0,0,0,0,1,0,0,0,2011,post
Eddie Ababio,,D,1,0,10,0,0,0,0,0,0,0,0,0,0,0,0,2011,post
Santiago Prim,,M,0,0,0,0,0,0,0,0,0,0,0,0,0,0,0,2011,post
Aaron Horton,,F,0,0,0,0,0,0,0,0,0,0,0,0,0,0,0,2011,post
Artur Aghasyan,,F,0,0,0,0,0,0,0,0,0,0,0,0,0,0,0,2011,post
Soony Saad,,F,2,0,4,0,0,0,0,0,0,0,0,1,0,0,0,2011,post
Ben Sippola,,M,0,0,0,0,0,0,0,0,0,0,0,0,0,0,0,2011,post
Tom Heinemann,,F,1,0,5,0,0,0,0,0,0,0,0,0,0,0,0,2011,post
Korey Veeder,,D,0,0,0,0,0,0,0,0,0,0,0,0,0,0,0,2011,post
Josh Williams,,D,0,0,0,0,0,0,0,0,0,0,0,0,0,0,0,2011,post
Michael Tetteh,,D,0,0,0,0,0,0,0,0,0,0,0,0,0,0,0,2011,post
Dan Keat,,M,0,0,0,0,0,0,0,0,0,0,0,0,0,0,0,2011,post
Hector Jimenez,,M,0,0,0,0,0,0,0,0,0,0,0,0,0,0,0,2011,post
Dustin McCarty,,M,0,0,0,0,0,0,0,0,0,0,0,0,0,0,0,2011,post
Paolo Cardozo,,M,1,0,1,0,0,0,0,0,0,0,0,0,0,0,0,2011,post
Ryan Thomas,,D,0,0,0,0,0,0,0,0,0,0,0,0,0,0,0,2011,post
Corey Hertzog,,F,0,0,0,0,0,0,0,0,0,0,0,0,0,0,0,2011,post
Marcos Paullo,,M,0,0,0,0,0,0,0,0,0,0,0,0,0,0,0,2011,post
Davy Armstrong,,M,0,0,0,0,0,0,0,0,0,0,0,0,0,0,0,2011,post
Steven Emory,,M,0,0,0,0,0,0,0,0,0,0,0,0,0,0,0,2011,post
Juan Agudelo,,F,1,0,26,0,0,1,0,0,0,0,0,1,0,0,0,2011,post
Daniel Hernandez,,M,1,1,90,0,0,1,0,0,0,0,0,4,2,1,0,2011,post
Jéferson,,M,2,0,20,0,0,1,1,0,0,0,0,0,0,0,0,2011,post
Zach Scott,,D,1,1,90,0,0,1,1,0,0,0,0,0,1,0,0,2011,post
Scott Palguta,,D,2,1,121,0,0,1,0,0,0,0,0,1,0,0,0,2011,post
Leonardo González,,D,2,2,180,0,0,1,0,0,0,0,0,7,2,1,0,2011,post
Chris Schuler,,D,3,2,238,0,0,1,0,0,0,0,0,4,2,0,0,2011,post
Ross LaBauex,,M,2,1,96,0,0,1,0,0,0,0,0,1,6,0,0,2011,post
Tim Ream,,D,3,3,270,0,0,1,1,0,0,0,0,3,1,1,0,2011,post
Wells Thompson,,D,3,2,202,0,0,1,0,0,0,0,0,2,3,0,0,2011,post
Marvell Wynne,,D,3,3,270,0,0,1,0,0,0,0,0,4,4,0,0,2011,post
Jermaine Taylor,,D,2,1,141,0,0,1,1,0,0,0,0,1,1,0,0,2011,post
Caleb Folan,,F,2,2,113,0,0,1,1,0,0,0,0,2,2,0,0,2011,post
Jan Gunnar Solli,,D,2,2,169,0,0,1,0,0,0,0,0,3,0,1,1,2011,post
Teemu Tainio,,M,3,3,196,0,0,1,0,0,0,0,0,7,1,0,0,2011,post
Miguel Comminges,,D,3,3,270,0,0,1,0,0,0,0,0,6,0,1,0,2011,post
Ugo Ihemelu,,D,1,1,90,0,0,1,0,0,0,0,0,1,0,1,0,2011,post
Drew Moor,,D,2,2,149,0,0,1,0,0,0,0,0,0,2,0,0,2011,post
Carlos Mendes,,D,2,1,98,0,0,1,0,0,0,0,0,0,0,0,0,2011,post
Stephen Keel,,D,3,3,270,0,0,1,1,0,0,0,0,1,1,0,0,2011,post
Roger Espinoza,,M,3,3,210,0,0,1,0,0,0,0,0,3,4,2,0,2011,post
Stéphane Auvray,,M,1,0,74,0,0,1,0,0,0,0,0,1,0,0,0,2011,post
Quincy Amarikwa,,F,1,0,45,0,0,1,1,0,0,0,0,0,2,0,0,2011,post
George John,,D,1,1,90,0,0,1,0,0,0,0,0,2,1,0,0,2011,post
Corey Ashe,,M,4,4,354,0,0,2,0,0,0,0,0,2,8,0,0,2011,post
Andrew Jacobson,,M,1,1,67,0,0,2,0,0,0,0,0,0,0,0,0,2011,post
Jamie Smith,,M,1,1,74,0,0,2,1,0,0,0,0,1,0,0,0,2011,post
Veljko Paunovic,,F,1,1,67,0,0,2,1,0,0,0,0,1,1,0,0,2011,post
Chris Birchall,,M,4,1,157,0,0,2,1,0,0,0,0,3,0,0,0,2011,post
Danny Califf,,D,2,2,180,0,0,2,0,0,0,0,0,1,0,0,0,2011,post
Davy Arnaud,,M,3,0,81,0,0,2,2,0,0,0,0,2,2,1,0,2011,post
Andy Williams,,M,3,3,222,0,0,2,1,0,0,0,0,4,2,0,0,2011,post
Jair Benítez,,D,1,1,90,0,0,2,1,0,0,0,0,1,0,0,0,2011,post
Roy Miller,,D,3,3,270,0,0,2,0,0,0,0,0,3,0,0,0,2011,post
Robbie Rogers,,D,1,1,90,0,0,2,0,0,0,0,0,1,0,0,0,2011,post
Juninho,,M,3,3,270,0,0,2,1,0,0,0,0,3,2,1,1,2011,post
Josh Gardner,,M,1,1,90,0,0,2,1,0,0,0,0,1,2,0,0,2011,post
Sammy Ochoa,,F,2,1,77,0,0,2,0,0,0,0,0,2,2,0,0,2011,post
Maicon Santos,,F,1,0,17,0,0,2,1,0,0,0,0,0,0,0,0,2011,post
Roger Torres,,M,2,0,45,0,0,2,2,0,0,0,0,2,1,0,0,2011,post
Dilly Duka,,M,1,1,65,0,0,2,1,0,0,0,0,2,1,0,0,2011,post
Luis Gil,,M,3,0,22,0,0,2,1,0,0,0,0,0,0,0,0,2011,post
Sheanon Williams,,D-M,2,2,180,0,0,3,1,0,0,0,0,3,4,1,0,2011,post
Jack McInerney,,F,2,1,118,0,0,3,1,0,0,0,0,1,4,0,0,2011,post
Roger Levesque,,M,2,0,82,0,0,3,0,0,0,0,0,3,1,1,0,2011,post
Will Johnson,,D,3,3,270,0,0,3,2,0,0,0,0,2,3,0,0,2011,post
Robbie Russell,,D,3,3,250,0,0,3,2,0,0,0,0,3,2,0,0,2011,post
Chad Barrett,,F,3,3,211,0,0,3,1,0,0,0,0,2,1,0,0,2011,post
Adam Cristman,,F,3,1,89,0,0,3,0,0,0,0,0,3,1,1,0,2011,post
Andrés Mendoza,,F,1,1,90,0,0,3,1,0,0,0,0,0,1,0,0,2011,post
Erik Friberg,,M,2,1,120,0,0,3,0,0,0,0,0,2,1,1,0,2011,post
Álvaro Fernández,,M,2,2,91,0,0,3,0,0,0,0,0,0,2,0,0,2011,post
Danny Cruz,,M-F,4,4,290,0,0,3,1,0,0,0,0,4,9,1,0,2011,post
Macoumba Kandji,,F,3,0,102,0,0,3,2,0,0,0,0,2,3,0,0,2011,post
Geoff Cameron,,D,4,4,360,0,0,3,2,0,0,0,0,1,0,0,0,2011,post
Brek Shea,,D,1,1,90,0,0,3,1,0,0,0,0,0,2,0,0,2011,post
Adam Moffat,,M,4,4,360,0,0,4,0,0,0,0,0,1,3,1,0,2011,post
Jeff Parke,,D,2,2,180,0,0,4,1,0,0,0,0,1,4,0,0,2011,post
Kyle Beckerman,,M,3,3,270,0,0,4,0,0,0,0,0,3,0,0,0,2011,post
Freddy Adu,,F,2,0,37,0,0,4,2,0,0,0,0,0,1,0,0,2011,post
Jeff Larentowicz,,M,3,3,270,0,0,4,0,0,0,0,0,4,1,0,0,2011,post
Carlos Valdés,,D,2,2,180,0,0,4,3,0,0,0,0,4,0,1,0,2011,post
Mike Fucito,,F,2,1,103,0,0,5,2,0,0,0,0,0,2,0,0,2011,post
Marvin Chávez,,M,1,1,73,0,0,5,0,0,0,0,0,0,1,0,0,2011,post
Danny Mwanga,,F,2,2,142,0,0,5,1,0,0,0,0,0,1,0,0,2011,post
Brian Carroll,,M,2,2,180,0,0,5,2,0,0,0,0,4,0,1,0,2011,post
Jackson Goncalves,,M,1,1,90,0,0,6,4,0,0,0,0,2,2,0,0,2011,post
Rafa Márquez,,M,2,2,180,0,0,7,1,0,0,0,0,0,7,0,1,2011,post
Fabian Espindola,,F,3,3,270,0,0,7,3,0,0,0,0,6,5,1,0,2011,post
Sanna Nyassi,,M,3,3,269,0,0,7,4,0,0,0,0,6,2,2,0,2011,post
Kei Kamara,,F,3,3,269,0,0,8,4,0,0,0,0,3,5,0,0,2011,post
Robbie Keane,,F,6,6,540,6,1,18,10,3,3,1,0,6,9,0,0,2012,post
Will Bruin,,F,6,6,491,4,1,18,8,2,2,1,0,6,2,0,0,2012,post
Mike Magee,,M,6,6,540,3,1,10,4,2,1,0,1,5,1,0,0,2012,post
Landon Donovan,,M-F,5,5,444,2,3,12,4,2,0,1,2,7,6,1,0,2012,post
Nick DeLeon,,M,4,4,360,2,0,4,3,0,2,0,0,2,0,0,0,2012,post
Calen Carr,,F,4,4,251,1,2,11,4,0,1,1,1,4,11,1,0,2012,post
Zach Scott,,D,3,2,183,1,1,1,1,1,0,1,0,1,1,0,0,2012,post
Boniek Garcia,,M,6,6,540,1,1,3,2,0,1,1,0,9,7,1,0,2012,post
Adam Moffat,,M,6,6,456,1,1,6,1,1,0,0,1,5,1,0,0,2012,post
Alan Gordon,,F,2,0,42,1,0,1,1,1,0,0,0,1,1,0,0,2012,post
Darren Mattocks,,F,1,1,59,1,0,1,1,0,1,0,0,0,2,0,0,2012,post
Andre Hainault,,D,3,2,215,1,0,2,1,1,0,0,0,4,2,0,0,2012,post
Seth Sinovic,,D,2,2,180,1,0,2,1,1,0,0,0,1,2,0,0,2012,post
Víctor Bernárdez,,D,2,2,102,1,0,2,2,0,1,0,0,4,1,1,0,2012,post
Kofi Sarkodie,,D,6,6,527,1,0,3,3,1,0,0,0,6,4,1,0,2012,post
Alex,,M,1,0,45,1,0,4,1,1,0,0,0,0,2,0,0,2012,post
Mario Martinez,,M,4,2,201,1,0,5,3,0,1,0,0,1,9,0,0,2012,post
Eddie Johnson,,F,3,2,205,1,0,7,3,1,0,0,0,2,5,1,0,2012,post
Omar Gonzalez,,D,6,6,540,1,0,7,1,1,0,0,0,6,15,1,0,2012,post
Branko Boskovic,,M,4,4,321,1,0,9,2,1,0,0,0,2,6,0,0,2012,post
Sean Franklin,,D,5,5,450,0,4,2,1,0,0,3,1,2,1,0,0,2012,post
Brad Davis,,M,6,6,526,0,3,4,1,0,0,1,2,6,11,1,0,2012,post
Juninho,,M,6,5,412,0,2,7,1,0,0,2,0,8,3,1,0,2012,post
Tommy Meyer,,D,6,6,540,0,1,0,0,0,0,0,1,7,1,0,0,2012,post
Matt Watson,,M,1,1,80,0,1,1,1,0,0,0,1,1,0,0,0,2012,post
Justin Morrow,,D,2,2,180,0,1,1,0,0,0,1,0,2,0,0,0,2012,post
Robbie Russell,,D,3,3,270,0,1,1,0,0,0,0,1,2,2,0,0,2012,post
 Christian Wilhelmsson,,M,4,3,244,0,1,2,0,0,0,1,0,9,5,0,0,2012,post
Luiz Camargo,,M,3,1,120,0,1,2,0,0,0,1,0,3,0,0,0,2012,post
Maicon Santos,,F,1,1,90,0,1,3,0,0,0,1,0,0,4,0,0,2012,post
Christian Tiffert,,M,4,4,318,0,1,3,2,0,0,1,0,5,3,0,0,2012,post
Patrick Nyarko,,F-M,1,1,90,0,1,3,2,0,0,1,0,1,5,0,0,2012,post
Fredy Montero,,F,4,4,317,0,1,4,1,0,0,0,1,5,3,0,0,2012,post
Graham Zusi,,M,2,2,180,0,1,5,0,0,0,1,0,7,4,1,0,2012,post
Brad Evans,,D-M,4,4,360,0,1,6,4,0,0,0,1,5,4,1,0,2012,post
Kei Kamara,,F,2,2,180,0,1,7,1,0,0,1,0,2,5,1,0,2012,post
David Beckham,,M,6,6,513,0,1,8,3,0,0,1,0,6,4,1,0,2012,post
Lionard Pajoy,,F,4,4,326,0,1,8,3,0,0,0,1,6,6,1,0,2012,post
Daniel Steres ,,D,0,0,0,0,0,0,0,0,0,0,0,0,0,0,0,2012,post
Cesar Diaz Pizarro,,F,0,0,0,0,0,0,0,0,0,0,0,0,0,0,0,2012,post
Kyle Miller,,M,0,0,0,0,0,0,0,0,0,0,0,0,0,0,0,2012,post
Greg Klazura ,,D-M,0,0,0,0,0,0,0,0,0,0,0,0,0,0,0,2012,post
Kellen Gulley,,F,0,0,0,0,0,0,0,0,0,0,0,0,0,0,0,2012,post
Jose Villarreal,,M,1,0,6,0,0,0,0,0,0,0,0,0,0,0,0,2012,post
Jose Angulo,,F,0,0,0,0,0,0,0,0,0,0,0,0,0,0,0,2012,post
Jhonny Arteaga,,F,0,0,0,0,0,0,0,0,0,0,0,0,0,0,0,2012,post
Ryan Maduro,,M,0,0,0,0,0,0,0,0,0,0,0,0,0,0,0,2012,post
Tyler Ruthven,,D,0,0,0,0,0,0,0,0,0,0,0,0,0,0,0,2012,post
Caleb Clarke,,F,0,0,0,0,0,0,0,0,0,0,0,0,0,0,0,2012,post
Leone Cruz,,D,0,0,0,0,0,0,0,0,0,0,0,0,0,0,0,2012,post
Terukazu Tanaka,,D,0,0,0,0,0,0,0,0,0,0,0,0,0,0,0,2012,post
Jonny Steele,,M,1,0,4,0,0,0,0,0,0,0,0,0,0,0,0,2012,post
Alex Caskey,,M,1,1,73,0,0,0,0,0,0,0,0,2,3,0,0,2012,post
Josh Suggs,,D,0,0,0,0,0,0,0,0,0,0,0,0,0,0,0,2012,post
Tiago Ulisses,,M,0,0,0,0,0,0,0,0,0,0,0,0,0,0,0,2012,post
Raphael Augusto,,M,1,0,50,0,0,0,0,0,0,0,0,4,0,0,0,2012,post
David Viana,,M,0,0,0,0,0,0,0,0,0,0,0,0,0,0,0,2012,post
Roger Levesque,,M,0,0,0,0,0,0,0,0,0,0,0,0,0,0,0,2012,post
Jonathan Borrajo,,D,0,0,0,0,0,0,0,0,0,0,0,0,0,0,0,2012,post
Austin Berry,,D,1,1,90,0,0,0,0,0,0,0,0,2,0,0,0,2012,post
Warren Creavalle,,M,1,0,2,0,0,0,0,0,0,0,0,0,0,0,0,2012,post
Diogo de Almeida,,D,0,0,0,0,0,0,0,0,0,0,0,0,0,0,0,2012,post
Connor Lade,,D,2,2,179,0,0,0,0,0,0,0,0,5,2,1,0,2012,post
Bryce Alderson,,M,0,0,0,0,0,0,0,0,0,0,0,0,0,0,0,2012,post
Andrew Duran,,D,0,0,0,0,0,0,0,0,0,0,0,0,0,0,0,2012,post
Chris Estridge,,D,0,0,0,0,0,0,0,0,0,0,0,0,0,0,0,2012,post
Rafael Garcia ,,D,0,0,0,0,0,0,0,0,0,0,0,0,0,0,0,2012,post
Sam Garza,,M,0,0,0,0,0,0,0,0,0,0,0,0,0,0,0,2012,post
Bryan Gaul,,D,0,0,0,0,0,0,0,0,0,0,0,0,0,0,0,2012,post
Hunter Jumper,,D,0,0,0,0,0,0,0,0,0,0,0,0,0,0,0,2012,post
Enzo Martinez,,M,0,0,0,0,0,0,0,0,0,0,0,0,0,0,0,2012,post
Colin Rolfe ,,F,0,0,0,0,0,0,0,0,0,0,0,0,0,0,0,2012,post
Andy Rose,,M,2,0,34,0,0,0,0,0,0,0,0,0,1,0,0,2012,post
Lance Rozeboom ,,M,0,0,0,0,0,0,0,0,0,0,0,0,0,0,0,2012,post
Shawn Singh,,D,0,0,0,0,0,0,0,0,0,0,0,0,0,0,0,2012,post
Babayele Sodade,,F,0,0,0,0,0,0,0,0,0,0,0,0,0,0,0,2012,post
Kenney Walker,,M,0,0,0,0,0,0,0,0,0,0,0,0,0,0,0,2012,post
Tony Walls,,D,0,0,0,0,0,0,0,0,0,0,0,0,0,0,0,2012,post
Emiliano Bonfigli,,F,0,0,0,0,0,0,0,0,0,0,0,0,0,0,0,2012,post
Martín Bonjour,,D,1,0,20,0,0,0,0,0,0,0,0,2,0,1,0,2012,post
Rafael Robayo,,M,0,0,0,0,0,0,0,0,0,0,0,0,0,0,0,2012,post
Federico Puppo,,F,0,0,0,0,0,0,0,0,0,0,0,0,0,0,0,2012,post
Cyprian Hedrik,,D,0,0,0,0,0,0,0,0,0,0,0,0,0,0,0,2012,post
Jacob Hustedt,,M,0,0,0,0,0,0,0,0,0,0,0,0,0,0,0,2012,post
Sebastian Velasquez,,M,0,0,0,0,0,0,0,0,0,0,0,0,0,0,0,2012,post
Cordell Cato,,F,0,0,0,0,0,0,0,0,0,0,0,0,0,0,0,2012,post
Jun Marques Davidson,,M,0,0,0,0,0,0,0,0,0,0,0,0,0,0,0,2012,post
Brian Ownby,,M,0,0,0,0,0,0,0,0,0,0,0,0,0,0,0,2012,post
Camilo Sanvezzo,,F,0,0,0,0,0,0,0,0,0,0,0,0,0,0,0,2012,post
Michael Thomas,,M,0,0,0,0,0,0,0,0,0,0,0,0,0,0,0,2012,post
Kyle Nakazawa,,M,0,0,0,0,0,0,0,0,0,0,0,0,0,0,0,2012,post
Leonardo,,D,0,0,0,0,0,0,0,0,0,0,0,0,0,0,0,2012,post
Joey Gjertsen,,M,0,0,0,0,0,0,0,0,0,0,0,0,0,0,0,2012,post
Teal Bunbury,,F,0,0,0,0,0,0,0,0,0,0,0,0,0,0,0,2012,post
Korede Aiyegbusi,,D,0,0,0,0,0,0,0,0,0,0,0,0,0,0,0,2012,post
Kwame Watson-Siriboe,,D,1,1,76,0,0,0,0,0,0,0,0,0,0,0,0,2012,post
Amadou Sanyang,,D,0,0,0,0,0,0,0,0,0,0,0,0,0,0,0,2012,post
Leonardo González,,D,0,0,0,0,0,0,0,0,0,0,0,0,0,0,0,2012,post
Cody Arnoux,,F,0,0,0,0,0,0,0,0,0,0,0,0,0,0,0,2012,post
Brad Ring,,D,0,0,0,0,0,0,0,0,0,0,0,0,0,0,0,2012,post
Jean-Marc Alexandre,,F,0,0,0,0,0,0,0,0,0,0,0,0,0,0,0,2012,post
O'Brian White,,F,0,0,0,0,0,0,0,0,0,0,0,0,0,0,0,2012,post
Lawrence Olum,,D,0,0,0,0,0,0,0,0,0,0,0,0,0,0,0,2012,post
Carlyle Mitchell,,D,0,0,0,0,0,0,0,0,0,0,0,0,0,0,0,2012,post
Yordany Álvarez,,M,1,0,3,0,0,0,0,0,0,0,0,1,0,0,0,2012,post
Nico Muñiz,,M,0,0,0,0,0,0,0,0,0,0,0,0,0,0,0,2012,post
Michael Boxall,,D,0,0,0,0,0,0,0,0,0,0,0,0,0,0,0,2012,post
Orr Barouch,,F,0,0,0,0,0,0,0,0,0,0,0,0,0,0,0,2012,post
Pari Pantazopoulos,,M,0,0,0,0,0,0,0,0,0,0,0,0,0,0,0,2012,post
Je-Vaughn Watson,,D,0,0,0,0,0,0,0,0,0,0,0,0,0,0,0,2012,post
Soony Saad,,F,0,0,0,0,0,0,0,0,0,0,0,0,0,0,0,2012,post
Rafael Baca,,M,2,2,147,0,0,0,0,0,0,0,0,1,0,0,0,2012,post
Alex Dixon,,M,0,0,0,0,0,0,0,0,0,0,0,0,0,0,0,2012,post
Ethan White,,D,0,0,0,0,0,0,0,0,0,0,0,0,0,0,0,2012,post
Victor Pineda,,M,0,0,0,0,0,0,0,0,0,0,0,0,0,0,0,2012,post
Conor Shanosky,,M-D,0,0,0,0,0,0,0,0,0,0,0,0,0,0,0,2012,post
Omar Salgado,,F,0,0,0,0,0,0,0,0,0,0,0,0,0,0,0,2012,post
Jack McBean,,F,0,0,0,0,0,0,0,0,0,0,0,0,0,0,0,2012,post
Konrad Warzycha,,M,0,0,0,0,0,0,0,0,0,0,0,0,0,0,0,2012,post
Kevin Ellis,,D,0,0,0,0,0,0,0,0,0,0,0,0,0,0,0,2012,post
Luis Gil,,M,1,0,5,0,0,0,0,0,0,0,0,0,0,0,0,2012,post
Chris Schuler,,D,0,0,0,0,0,0,0,0,0,0,0,0,0,0,0,2012,post
Steven Kinney,,D,0,0,0,0,0,0,0,0,0,0,0,0,0,0,0,2012,post
Mike Seamon,,M-F,0,0,0,0,0,0,0,0,0,0,0,0,0,0,0,2012,post
Corben Bone,,M,0,0,0,0,0,0,0,0,0,0,0,0,0,0,0,2012,post
Steven Beitashour,,D,2,2,163,0,0,0,0,0,0,0,0,0,4,0,0,2012,post
Birahim Diop,,M,0,0,0,0,0,0,0,0,0,0,0,0,0,0,0,2012,post
Russell Teibert,,M,0,0,0,0,0,0,0,0,0,0,0,0,0,0,0,2012,post
Michael Tetteh,,D,0,0,0,0,0,0,0,0,0,0,0,0,0,0,0,2012,post
Anthony Ampaipitakwong,,M,0,0,0,0,0,0,0,0,0,0,0,0,0,0,0,2012,post
Dan Keat,,M,0,0,0,0,0,0,0,0,0,0,0,0,0,0,0,2012,post
Hector Jimenez,,M,1,1,52,0,0,0,0,0,0,0,0,0,0,0,0,2012,post
Corey Hertzog,,F,0,0,0,0,0,0,0,0,0,0,0,0,0,0,0,2012,post
Long Tan,,F,0,0,0,0,0,0,0,0,0,0,0,0,0,0,0,2012,post
Servando Carrasco,,M,0,0,0,0,0,0,0,0,0,0,0,0,0,0,0,2012,post
Michael Nanchoff,,M,0,0,0,0,0,0,0,0,0,0,0,0,0,0,0,2012,post
Josue Soto,,D-M,0,0,0,0,0,0,0,0,0,0,0,0,0,0,0,2012,post
Tim Cahill,,M,2,2,180,0,0,0,0,0,0,0,0,2,2,0,0,2012,post
Andy O'Brien,,D,1,1,90,0,0,0,0,0,0,0,0,1,1,0,0,2012,post
Cory Gibbs,,D,0,0,0,0,0,0,0,0,0,0,0,0,0,0,0,2012,post
Tressor Moreno,,M,0,0,0,0,0,0,0,0,0,0,0,0,0,0,0,2012,post
Teemu Tainio,,M,2,2,180,0,0,0,0,0,0,0,0,5,1,0,0,2012,post
Davide Chiumiento,,M,0,0,0,0,0,0,0,0,0,0,0,0,0,0,0,2012,post
Ramiro Corrales,,M,1,1,69,0,0,0,0,0,0,0,0,0,1,0,0,2012,post
Lloyd Sam,,M-F,0,0,0,0,0,0,0,0,0,0,0,0,0,0,0,2012,post
Pável Pardo,,M,1,1,60,0,0,0,0,0,0,0,0,0,1,0,0,2012,post
Lee Young-Pyo,,D,1,1,90,0,0,0,0,0,0,0,0,0,0,1,0,2012,post
Josh Wolff,,F,0,0,0,0,0,0,0,0,0,0,0,0,0,0,0,2012,post
Tim Ward,,D,0,0,0,0,0,0,0,0,0,0,0,0,0,0,0,2012,post
Jed Zayner,,D,0,0,0,0,0,0,0,0,0,0,0,0,0,0,0,2012,post
Floyd Franks,,M,0,0,0,0,0,0,0,0,0,0,0,0,0,0,0,2012,post
Daniel Woolard,,D,0,0,0,0,0,0,0,0,0,0,0,0,0,0,0,2012,post
Logan Pause,,M,1,1,45,0,0,0,0,0,0,0,0,0,0,0,0,2012,post
Chad Barrett,,F,0,0,0,0,0,0,0,0,0,0,0,0,0,0,0,2012,post
Etienne Barbara,,F,0,0,0,0,0,0,0,0,0,0,0,0,0,0,0,2012,post
Atiba Harris,,D,0,0,0,0,0,0,0,0,0,0,0,0,0,0,0,2012,post
Khari Stephenson,,M,0,0,0,0,0,0,0,0,0,0,0,0,0,0,0,2012,post
Bobby Convey,,M,1,0,1,0,0,0,0,0,0,0,0,0,0,0,0,2012,post
Jay DeMerit,,D,1,1,70,0,0,0,0,0,0,0,0,1,0,0,0,2012,post
Sercan Güvenisik,,F,0,0,0,0,0,0,0,0,0,0,0,0,0,0,0,2012,post
Alain Rochat,,D,1,1,90,0,0,0,0,0,0,0,0,0,0,0,0,2012,post
Guillermo Franco,,F,0,0,0,0,0,0,0,0,0,0,0,0,0,0,0,2012,post
Andrew Boyens,,D,0,0,0,0,0,0,0,0,0,0,0,0,0,0,0,2012,post
Pat Noonan,,F,0,0,0,0,0,0,0,0,0,0,0,0,0,0,0,2012,post
Michael Videira,,M,0,0,0,0,0,0,0,0,0,0,0,0,0,0,0,2012,post
A.J. DeLaGarza,,D,0,0,0,0,0,0,0,0,0,0,0,0,0,0,0,2012,post
Ellis McLoughlin,,F,0,0,0,0,0,0,0,0,0,0,0,0,0,0,0,2012,post
Victor Palsson,,M,0,0,0,0,0,0,0,0,0,0,0,0,0,0,0,2012,post
Emiliano Dudar,,D,3,1,97,0,0,0,0,0,0,0,0,0,2,0,0,2012,post
Marcus Tracy,,F,0,0,0,0,0,0,0,0,0,0,0,0,0,0,0,2012,post
Brandon Barklage,,D,0,0,0,0,0,0,0,0,0,0,0,0,0,0,0,2012,post
Marco Pappa,,M,0,0,0,0,0,0,0,0,0,0,0,0,0,0,0,2012,post
Neven Markovic,,D,0,0,0,0,0,0,0,0,0,0,0,0,0,0,0,2012,post
Sebastián Grazzini,,M,0,0,0,0,0,0,0,0,0,0,0,0,0,0,0,2012,post
Stephen King,,M,0,0,0,0,0,0,0,0,0,0,0,0,0,0,0,2012,post
Justin Braun,,F,0,0,0,0,0,0,0,0,0,0,0,0,0,0,0,2012,post
Daniel Paladini,,M,1,0,15,0,0,0,0,0,0,0,0,0,0,0,0,2012,post
Shea Salinas,,M,2,0,54,0,0,0,0,0,0,0,0,0,0,0,0,2012,post
Geoff Cameron,,D,0,0,0,0,0,0,0,0,0,0,0,0,0,0,0,2012,post
Chance Myers,,D,2,2,180,0,0,0,0,0,0,0,0,1,2,1,0,2012,post
Bryan Jordan,,D,0,0,0,0,0,0,0,0,0,0,0,0,0,0,0,2012,post
Brandon McDonald,,D,3,3,236,0,0,0,0,0,0,0,0,1,0,0,0,2012,post
Kheli Dube,,F,0,0,0,0,0,0,0,0,0,0,0,0,0,0,0,2012,post
Abdoulie Mansally,,D,1,1,86,0,0,0,0,0,0,0,0,2,1,0,0,2012,post
Tony Beltran,,D,2,2,175,0,0,0,0,0,0,0,0,1,3,0,0,2012,post
Jámison Olave,,D,2,1,104,0,0,0,0,0,0,0,0,2,1,0,0,2012,post
Luke Sassano,,D,0,0,0,0,0,0,0,0,0,0,0,0,0,0,0,2012,post
David Júnior Lopes,,D,0,0,0,0,0,0,0,0,0,0,0,0,0,0,0,2012,post
Christian Sivebaek,,M,0,0,0,0,0,0,0,0,0,0,0,0,0,0,0,2012,post
Adam Johansson,,D,4,4,344,0,0,0,0,0,0,0,0,6,3,0,0,2012,post
Jose Recio,,D,0,0,0,0,0,0,0,0,0,0,0,0,0,0,0,2012,post
Nathan Sturgis,,M,0,0,0,0,0,0,0,0,0,0,0,0,0,0,0,2012,post
Mehdi Ballouchy,,M,0,0,0,0,0,0,0,0,0,0,0,0,0,0,0,2012,post
Jason Hernandez,,D,2,2,180,0,0,0,0,0,0,0,0,1,2,0,0,2012,post
Dane Richards,,M,1,0,10,0,0,0,0,0,0,0,0,0,0,0,0,2012,post
Patrick Ianni,,D-M,0,0,0,0,0,0,0,0,0,0,0,0,0,0,0,2012,post
Mike Chabala,,D,0,0,0,0,0,0,0,0,0,0,0,0,0,0,0,2012,post
Wilman Conde,,D,0,0,0,0,0,0,0,0,0,0,0,0,0,0,0,2012,post
Jan Gunnar Solli,,D,0,0,0,0,0,0,0,0,0,0,0,0,0,0,0,2012,post
Marc Burch,,D,2,2,180,0,0,0,0,0,0,0,0,2,1,0,0,2012,post
Michael Harrington,,D,0,0,0,0,0,0,0,0,0,0,0,0,0,0,0,2012,post
Kurt Morsink,,M,0,0,0,0,0,0,0,0,0,0,0,0,0,0,0,2012,post
Adam Cristman,,F,0,0,0,0,0,0,0,0,0,0,0,0,0,0,0,2012,post
Wells Thompson,,D,0,0,0,0,0,0,0,0,0,0,0,0,0,0,0,2012,post
Paulo Nagamura,,M,0,0,0,0,0,0,0,0,0,0,0,0,0,0,0,2012,post
Jordan Harvey,,D,1,1,90,0,0,0,0,0,0,0,0,0,2,0,0,2012,post
Dan Gargan,,D,0,0,0,0,0,0,0,0,0,0,0,0,0,0,0,2012,post
Stephen Keel,,D,0,0,0,0,0,0,0,0,0,0,0,0,0,0,0,2012,post
Jacob Peterson,,F,1,1,89,0,0,0,0,0,0,0,0,0,2,0,0,2012,post
Chris Wingert,,D,1,1,90,0,0,0,0,0,0,0,0,1,0,0,0,2012,post
Colin Clark,,M,0,0,0,0,0,0,0,0,0,0,0,0,0,0,0,2012,post
Marcelo Saragosa,,M,4,4,265,0,0,1,1,0,0,0,0,6,3,0,0,2012,post
Todd Dunivant,,D,6,6,540,0,0,1,0,0,0,0,0,3,5,0,0,2012,post
Jeff Parke,,D,4,4,360,0,0,1,0,0,0,0,0,8,2,1,0,2012,post
Hamdi Salihi,,F,2,0,34,0,0,1,1,0,0,0,0,1,0,0,0,2012,post
Matt Besler,,D,2,2,180,0,0,1,0,0,0,0,0,2,3,0,0,2012,post
Roy Miller,,D,2,0,46,0,0,1,0,0,0,0,0,0,0,0,0,2012,post
Jermaine Taylor,,D,4,4,325,0,0,1,0,0,0,0,0,1,0,0,0,2012,post
Chris Rolfe,,F,1,1,90,0,0,1,0,0,0,0,0,0,0,0,0,2012,post
Heath Pearce,,D,2,2,180,0,0,1,1,0,0,0,0,2,0,1,0,2012,post
Sébastien Le Toux,,F,1,1,80,0,0,1,0,0,0,0,0,1,1,0,0,2012,post
Gonzalo Segares,,D,1,1,90,0,0,1,0,0,0,0,0,2,2,0,0,2012,post
Bobby Boswell,,D,6,6,540,0,0,1,0,0,0,0,0,6,3,1,0,2012,post
Kyle Beckerman,,M,2,2,180,0,0,1,0,0,0,0,0,0,0,1,0,2012,post
John Thorrington,,M,1,1,90,0,0,1,1,0,0,0,0,0,1,0,0,2012,post
Rafa Márquez,,M,2,2,120,0,0,1,0,0,0,0,0,2,0,1,1,2012,post
Júlio César,,D,1,1,90,0,0,1,0,0,0,0,0,0,1,0,0,2012,post
Jalil Anibaba,,D,1,1,75,0,0,1,0,0,0,0,0,2,2,0,0,2012,post
Gershon Koffie,,M,1,1,90,0,0,1,0,0,0,0,0,2,0,0,0,2012,post
Paulo Jr.,,F,2,1,103,0,0,1,0,0,0,0,0,3,0,0,0,2012,post
Digao,,D,1,0,1,0,0,1,0,0,0,0,0,0,0,0,0,2012,post
Oriol Rosell,,M-D,1,1,90,0,0,1,0,0,0,0,0,1,0,0,0,2012,post
Sam Cronin,,M,2,2,180,0,0,1,0,0,0,0,0,0,2,0,0,2012,post
Dejan Jakovic,,D,4,4,360,0,0,1,0,0,0,0,0,3,4,0,0,2012,post
Steve Zakuani,,M,3,1,99,0,0,1,0,0,0,0,0,0,1,0,0,2012,post
Dom Dwyer,,F,1,0,10,0,0,1,0,0,0,0,0,0,0,0,0,2012,post
David Estrada,,M-F,3,0,51,0,0,1,1,0,0,0,0,0,0,0,0,2012,post
Andy Najar,,D,1,1,71,0,0,1,0,0,0,0,0,2,1,1,1,2012,post
Ike Opara,,D,1,0,78,0,0,1,0,0,0,0,0,1,1,0,0,2012,post
Michael Stephens,,M,4,0,40,0,0,1,0,0,0,0,0,1,1,0,0,2012,post
Marvin Chávez,,M,2,2,149,0,0,2,0,0,0,0,0,3,3,1,0,2012,post
Jhon Kennedy Hurtado,,D,4,4,360,0,0,2,1,0,0,0,0,3,3,1,0,2012,post
Markus Holgersson,,D,2,2,180,0,0,2,1,0,0,0,0,1,1,0,0,2012,post
Peterson Joseph,,M,2,1,103,0,0,2,0,0,0,0,0,1,2,0,0,2012,post
Kenny Miller,,F,1,0,31,0,0,2,0,0,0,0,0,2,0,0,0,2012,post
Dwayne De Rosario,,M,1,0,28,0,0,2,1,0,0,0,0,1,0,0,0,2012,post
Mauro Rosales,,M,2,1,98,0,0,2,0,0,0,0,0,1,2,0,0,2012,post
Sherjill MacDonald,,F,1,1,90,0,0,2,0,0,0,0,0,2,1,0,0,2012,post
Ned Grabavoy,,M,2,2,180,0,0,2,2,0,0,0,0,0,2,0,0,2012,post
Kenny Cooper,,F,2,1,100,0,0,2,1,0,0,0,0,2,3,0,0,2012,post
Cam Weaver,,F,3,0,35,0,0,2,0,0,0,0,0,4,0,0,0,2012,post
Álvaro Fernández,,M,1,1,90,0,0,2,1,0,0,0,0,1,0,0,0,2012,post
Nat Borchers,,D,2,2,180,0,0,2,1,0,0,0,0,0,0,0,0,2012,post
Aurelien Collin,,D,2,2,180,0,0,2,0,0,0,0,0,5,0,0,0,2012,post
Dominic Oduro,,M,1,0,30,0,0,2,1,0,0,0,0,0,2,0,0,2012,post
Corey Ashe,,M,6,6,540,0,0,2,0,0,0,0,0,3,8,1,0,2012,post
Fabian Espindola,,F,2,1,77,0,0,3,1,0,0,0,0,1,3,0,0,2012,post
Roger Espinoza,,M,2,2,167,0,0,3,1,0,0,0,0,4,2,0,0,2012,post
Steven Lenhart,,F,2,2,155,0,0,3,0,0,0,0,0,3,3,1,0,2012,post
Simon Dawkins,,M,2,1,121,0,0,3,0,0,0,0,0,1,1,0,0,2012,post
Giles Barnes,,M,3,0,90,0,0,3,0,0,0,0,0,0,2,0,0,2012,post
Brian Ching,,F,4,0,36,0,0,3,0,0,0,0,0,2,1,0,0,2012,post
Barry Robson,,M,1,1,90,0,0,3,1,0,0,0,0,2,3,0,0,2012,post
Edson Buddle,,F,5,3,261,0,0,3,2,0,0,0,0,6,3,0,0,2012,post
Arne Friedrich,,D,1,1,90,0,0,3,2,0,0,0,0,0,1,0,0,2012,post
Marcelo Sarvas,,M,6,2,278,0,0,3,1,0,0,0,0,9,3,1,0,2012,post
Sammy Ochoa,,F,1,1,57,0,0,3,1,0,0,0,0,0,0,0,0,2012,post
Perry Kitchen,,M,4,4,360,0,0,3,0,0,0,0,0,4,6,0,0,2012,post
Osvaldo Alonso,,M,4,4,360,0,0,4,2,0,0,0,0,6,5,2,1,2012,post
Chris Korb,,D,3,3,270,0,0,4,2,0,0,0,0,2,1,0,0,2012,post
Joel Lindpere,,M,2,2,179,0,0,4,1,0,0,0,0,0,5,0,0,2012,post
Will Johnson,,D,2,2,180,0,0,4,3,0,0,0,0,2,5,0,0,2012,post
Lewis Neal,,M,4,1,234,0,0,5,2,0,0,0,0,1,0,0,0,2012,post
Javier Morales,,M,2,2,177,0,0,5,2,0,0,0,0,3,8,1,0,2012,post
Dax McCarty,,M,2,2,180,0,0,5,2,0,0,0,0,0,3,0,0,2012,post
Macoumba Kandji,,F,5,2,280,0,0,6,3,0,0,0,0,5,5,1,0,2012,post
Chris Pontius,,M,3,3,191,0,0,6,2,0,0,0,0,2,3,0,0,2012,post
Alvaro Saborio,,F,2,2,180,0,0,7,4,0,0,0,0,7,3,0,0,2012,post
Chris Wondolowski,,F,2,2,180,0,0,8,2,0,0,0,0,3,0,0,0,2012,post
CJ Sapong,,F,2,2,170,0,0,8,2,0,0,0,0,1,5,0,0,2012,post
Ricardo Clark,,M,5,5,426,0,0,9,3,0,0,0,0,12,8,0,0,2012,post
Thierry Henry,,F,2,2,180,0,0,10,2,0,0,0,0,2,1,0,0,2012,post
Aurelien Collin,,D,5,5,510,3,1,6,3,2,1,1,0,11,9,2,0,2013,post
Robbie Findley,,F,5,4,377,2,1,9,3,1,1,1,0,5,10,0,0,2013,post
Will Johnson,,D,4,4,360,2,1,11,2,1,1,1,0,3,7,0,0,2013,post
Omar Cummings,,F,5,1,194,2,0,5,2,1,1,0,0,3,4,0,0,2013,post
Chris Schuler,,D,5,5,510,2,0,6,3,2,0,0,0,10,6,1,0,2013,post
Boniek Garcia,,M,5,5,480,2,0,7,5,1,1,0,0,11,11,2,0,2013,post
Eddie Johnson,,F,3,3,270,2,0,8,3,1,1,0,0,5,8,1,0,2013,post
Will Bruin,,F,4,4,278,2,0,8,4,2,0,0,0,6,2,0,0,2013,post
Javier Morales,,M,5,5,490,1,3,3,1,1,0,3,0,6,8,0,0,2013,post
DeAndre Yedlin,,D,2,2,135,1,1,1,1,0,1,0,1,5,2,0,0,2013,post
Kelyn Rowe,,M,2,2,205,1,1,3,1,1,0,0,1,1,2,0,0,2013,post
Brad Davis,,M,5,5,473,1,1,3,1,0,1,0,1,11,10,0,0,2013,post
Tim Cahill,,M,2,2,210,1,1,4,3,0,1,0,1,4,2,0,0,2013,post
Ricardo Clark,,M,4,4,326,1,1,5,2,1,0,1,0,6,8,0,0,2013,post
Brad Evans,,D-M,3,3,270,1,1,8,2,1,0,1,0,4,6,0,0,2013,post
CJ Sapong,,F,5,4,436,1,1,12,4,1,0,0,1,7,15,0,0,2013,post
Andy Dorman,,M,2,2,135,1,0,1,1,1,0,0,0,3,1,0,0,2013,post
Frederic Piquionne,,F,2,1,42,1,0,1,1,0,1,0,0,0,0,0,0,2013,post
Eric Alexander,,M,2,1,127,1,0,2,2,0,1,0,0,1,0,0,0,2013,post
Seth Sinovic,,D,5,5,510,1,0,2,1,1,0,0,0,8,5,1,0,2013,post
Mamadou Danso,,D,4,4,360,1,0,2,1,1,0,0,0,5,1,0,0,2013,post
Darlington Nagbe,,M,4,4,335,1,0,3,2,0,1,0,0,3,15,0,0,2013,post
Dimitry Imbongo,,F,2,2,149,1,0,3,1,0,1,0,0,10,3,1,0,2013,post
Osvaldo Alonso,,M,3,3,264,1,0,3,1,1,0,0,0,6,7,0,0,2013,post
Sean Franklin,,D,2,2,210,1,0,3,1,1,0,0,0,2,2,0,0,2013,post
Bradley Wright-Phillips,,F,2,1,71,1,0,3,2,1,0,0,0,1,0,0,0,2013,post
Ryan Johnson,,F,4,3,230,1,0,4,2,0,1,0,0,6,5,0,0,2013,post
Claudio Bieler,,F,3,0,85,1,0,4,1,1,0,0,0,2,1,0,0,2013,post
Sebastian Velasquez,,M,5,2,242,1,0,5,1,1,0,0,0,2,4,0,0,2013,post
Devon Sandoval,,F,3,2,186,1,0,5,1,1,0,0,0,5,3,0,0,2013,post
Diego Valeri,,M,4,4,265,1,0,7,2,1,0,0,0,5,9,0,0,2013,post
Alvaro Saborio,,F,3,3,319,1,0,7,2,0,1,0,0,8,3,2,0,2013,post
Dom Dwyer,,F,5,3,272,1,0,16,8,1,0,0,0,8,7,0,0,2013,post
Jack Jewsbury,,M,4,4,341,0,2,2,1,0,0,0,2,2,5,0,0,2013,post
Rodney Wallace,,D,4,4,299,0,2,7,2,0,0,2,0,12,1,1,0,2013,post
Graham Zusi,,M,5,5,509,0,2,12,1,0,0,2,0,6,12,0,0,2013,post
Benny Feilhaber,,M,4,4,394,0,2,14,1,0,0,2,0,5,12,1,0,2013,post
Shalrie Joseph,,M,2,1,62,0,1,0,0,0,0,1,0,0,1,0,0,2013,post
Lee Nguyen,,M,2,2,210,0,1,0,0,0,0,1,0,5,3,1,0,2013,post
Chris Wingert,,D,4,4,315,0,1,0,0,0,0,1,0,7,5,1,0,2013,post
Diego Chara,,M,4,4,360,0,1,0,0,0,0,0,1,8,6,1,0,2013,post
Joao Plata,,F,2,0,32,0,1,0,0,0,0,1,0,2,1,0,0,2013,post
Juan Agudelo,,F,2,2,210,0,1,2,1,0,0,1,0,9,7,0,0,2013,post
Dax McCarty,,M,2,2,210,0,1,2,1,0,0,0,1,2,9,0,0,2013,post
Corey Ashe,,M,4,4,390,0,1,2,1,0,0,1,0,1,5,2,0,2013,post
Kofi Sarkodie,,D,5,5,480,0,1,3,0,0,0,0,1,7,5,0,0,2013,post
Kalif Alhassan,,M,4,0,141,0,1,4,2,0,0,0,1,2,7,0,0,2013,post
Cam Weaver,,F,5,1,164,0,1,4,2,0,0,0,1,8,3,0,0,2013,post
Robbie Keane,,F,2,2,210,0,1,5,1,0,0,1,0,1,1,0,0,2013,post
Chance Myers,,D,5,5,510,0,1,7,1,0,0,0,1,3,4,1,0,2013,post
Kyle Beckerman,,M,5,5,510,0,1,9,3,0,0,0,1,8,6,2,0,2013,post
Thierry Henry,,F,2,2,210,0,1,10,2,0,0,0,1,6,2,1,0,2013,post
Clint Dempsey,,M-F,3,3,270,0,1,14,3,0,0,1,0,4,4,1,0,2013,post
Clyde Simms,,M,0,0,0,0,0,0,0,0,0,0,0,0,0,0,0,2013,post
Heath Pearce,,D,0,0,0,0,0,0,0,0,0,0,0,0,0,0,0,2013,post
Brian Ching,,F,0,0,0,0,0,0,0,0,0,0,0,0,0,0,0,2013,post
Davy Arnaud,,M,0,0,0,0,0,0,0,0,0,0,0,0,0,0,0,2013,post
Brian Mullan,,D,0,0,0,0,0,0,0,0,0,0,0,0,0,0,0,2013,post
David Carney,,D-M,2,2,210,0,0,0,0,0,0,0,0,3,0,1,0,2013,post
Mauro Rosales,,M,2,0,59,0,0,0,0,0,0,0,0,2,5,0,0,2013,post
Alessandro Nesta,,D,0,0,0,0,0,0,0,0,0,0,0,0,0,0,0,2013,post
Jamie Smith,,M,0,0,0,0,0,0,0,0,0,0,0,0,0,0,0,2013,post
Laurent Courtois ,,M,1,0,9,0,0,0,0,0,0,0,0,0,0,0,0,2013,post
Matteo Ferrari,,D,1,1,90,0,0,0,0,0,0,0,0,2,0,0,0,2013,post
Andrea Pisanu,,M,1,1,55,0,0,0,0,0,0,0,0,2,1,0,0,2013,post
Pablo Mastroeni,,M,0,0,0,0,0,0,0,0,0,0,0,0,0,0,0,2013,post
Obafemi Martins,,F,1,0,41,0,0,0,0,0,0,0,0,0,1,0,0,2013,post
Jaime Castrillón,,M,0,0,0,0,0,0,0,0,0,0,0,0,0,0,0,2013,post
Ibrahim Sekagya,,D,2,2,210,0,0,0,0,0,0,0,0,1,3,0,0,2013,post
Hassoun Camara,,D,1,1,90,0,0,0,0,0,0,0,0,3,2,0,0,2013,post
Edson Buddle,,F,1,0,17,0,0,0,0,0,0,0,0,0,0,0,0,2013,post
Gabriel Torres,,M-F,1,1,90,0,0,0,0,0,0,0,0,0,2,0,0,2013,post
Patrice Bernier,,M,0,0,0,0,0,0,0,0,0,0,0,0,0,0,0,2013,post
Roy Miller,,D,0,0,0,0,0,0,0,0,0,0,0,0,0,0,0,2013,post
Jermaine Taylor,,D,0,0,0,0,0,0,0,0,0,0,0,0,0,0,0,2013,post
Marvell Wynne,,D,1,0,5,0,0,0,0,0,0,0,0,0,0,0,0,2013,post
Sinisa Ubiparipovic,,F-M,0,0,0,0,0,0,0,0,0,0,0,0,0,0,0,2013,post
Todd Dunivant,,D,2,2,210,0,0,0,0,0,0,0,0,1,3,0,0,2013,post
Kamani Hill,,F,0,0,0,0,0,0,0,0,0,0,0,0,0,0,0,2013,post
Calen Carr,,F,0,0,0,0,0,0,0,0,0,0,0,0,0,0,0,2013,post
Chad Barrett,,F,2,0,47,0,0,0,0,0,0,0,0,1,1,1,0,2013,post
Rauwshan McKenzie,,D,0,0,0,0,0,0,0,0,0,0,0,0,0,0,0,2013,post
Ryan Miller,,D,0,0,0,0,0,0,0,0,0,0,0,0,0,0,0,2013,post
Adrian Lopez,,D,0,0,0,0,0,0,0,0,0,0,0,0,0,0,0,2013,post
Brandon McDonald,,D,0,0,0,0,0,0,0,0,0,0,0,0,0,0,0,2013,post
Abdoulie Mansally,,D,1,0,31,0,0,0,0,0,0,0,0,2,1,0,0,2013,post
Jámison Olave,,D,1,1,65,0,0,0,0,0,0,0,0,1,0,0,1,2013,post
David Horst,,D,0,0,0,0,0,0,0,0,0,0,0,0,0,0,0,2013,post
Chris Tierney,,D-M,0,0,0,0,0,0,0,0,0,0,0,0,0,0,0,2013,post
Federico Bessone,,D,0,0,0,0,0,0,0,0,0,0,0,0,0,0,0,2013,post
Drew Moor,,D,1,1,90,0,0,0,0,0,0,0,0,1,2,0,0,2013,post
Anthony Wallace,,D,0,0,0,0,0,0,0,0,0,0,0,0,0,0,0,2013,post
Patrick Ianni,,D-M,0,0,0,0,0,0,0,0,0,0,0,0,0,0,0,2013,post
Mike Chabala,,D,1,1,90,0,0,0,0,0,0,0,0,1,2,0,0,2013,post
Nick LaBrocca,,M,0,0,0,0,0,0,0,0,0,0,0,0,0,0,0,2013,post
Colin Clark,,M,0,0,0,0,0,0,0,0,0,0,0,0,0,0,0,2013,post
Kosuke Kimura,,D,0,0,0,0,0,0,0,0,0,0,0,0,0,0,0,2013,post
Juan Toja,,M,0,0,0,0,0,0,0,0,0,0,0,0,0,0,0,2013,post
Nathan Sturgis,,M,1,1,85,0,0,0,0,0,0,0,0,0,0,0,0,2013,post
Charlie Davies,,F,0,0,0,0,0,0,0,0,0,0,0,0,0,0,0,2013,post
Fabian Espindola,,F,1,0,57,0,0,0,0,0,0,0,0,1,1,0,0,2013,post
Nelson Rivas,,D,1,1,70,0,0,0,0,0,0,0,0,2,1,1,1,2013,post
Sal Zizzo,,D,0,0,0,0,0,0,0,0,0,0,0,0,0,0,0,2013,post
Brad Ring,,D,0,0,0,0,0,0,0,0,0,0,0,0,0,0,0,2013,post
Kevin Alston,,D,0,0,0,0,0,0,0,0,0,0,0,0,0,0,0,2013,post
A.J. DeLaGarza,,D,2,0,46,0,0,0,0,0,0,0,0,0,0,0,0,2013,post
Ryan Guy,,M,0,0,0,0,0,0,0,0,0,0,0,0,0,0,0,2013,post
Felipe,,M,1,0,28,0,0,0,0,0,0,0,0,0,0,0,0,2013,post
Diego Calderon,,D,0,0,0,0,0,0,0,0,0,0,0,0,0,0,0,2013,post
Brandon Barklage,,D,2,1,127,0,0,0,0,0,0,0,0,4,2,2,0,2013,post
Andres Romero,,M,1,0,34,0,0,0,0,0,0,0,0,1,0,0,1,2013,post
Hernan Bernardello,,M,1,1,90,0,0,0,0,0,0,0,0,1,2,0,0,2013,post
Zach Scott,,D,2,1,64,0,0,0,0,0,0,0,0,1,0,0,0,2013,post
Darrius Barnes,,D,2,2,205,0,0,0,0,0,0,0,0,1,1,1,0,2013,post
Phillip Lund,,M,0,0,0,0,0,0,0,0,0,0,0,0,0,0,0,2013,post
Markus Holgersson,,D,2,2,210,0,0,0,0,0,0,0,0,2,4,0,0,2013,post
Sanna Nyassi,,M,0,0,0,0,0,0,0,0,0,0,0,0,0,0,0,2013,post
Steve Zakuani,,M,0,0,0,0,0,0,0,0,0,0,0,0,0,0,0,2013,post
Peterson Joseph,,M,0,0,0,0,0,0,0,0,0,0,0,0,0,0,0,2013,post
Leonardo,,D,0,0,0,0,0,0,0,0,0,0,0,0,0,0,0,2013,post
Leonardo González,,D,2,2,174,0,0,0,0,0,0,0,0,5,1,0,0,2013,post
Dillon Powers,,M,0,0,0,0,0,0,0,0,0,0,0,0,0,0,0,2013,post
Aaron Maund,,D,0,0,0,0,0,0,0,0,0,0,0,0,0,0,0,2013,post
Brian Ownby,,M,0,0,0,0,0,0,0,0,0,0,0,0,0,0,0,2013,post
Ike Opara,,D,3,0,16,0,0,0,0,0,0,0,0,0,1,0,0,2013,post
Michael Stephens,,M,0,0,0,0,0,0,0,0,0,0,0,0,0,0,0,2013,post
Danny Mwanga,,F,0,0,0,0,0,0,0,0,0,0,0,0,0,0,0,2013,post
Saer Sene,,M,0,0,0,0,0,0,0,0,0,0,0,0,0,0,0,2013,post
Blair Gavin,,M,0,0,0,0,0,0,0,0,0,0,0,0,0,0,0,2013,post
Kwame Watson-Siriboe,,D,0,0,0,0,0,0,0,0,0,0,0,0,0,0,0,2013,post
David Estrada,,M-F,0,0,0,0,0,0,0,0,0,0,0,0,0,0,0,2013,post
Ben Zemanski,,M,2,0,25,0,0,0,0,0,0,0,0,2,1,1,0,2013,post
Rich Balchan,,D,0,0,0,0,0,0,0,0,0,0,0,0,0,0,0,2013,post
Cole Grossman,,M,1,0,16,0,0,0,0,0,0,0,0,0,0,0,0,2013,post
Josh Gardner,,M,0,0,0,0,0,0,0,0,0,0,0,0,0,0,0,2013,post
Hector Jimenez,,M,1,0,29,0,0,0,0,0,0,0,0,1,1,0,0,2013,post
Davy Armstrong,,M,0,0,0,0,0,0,0,0,0,0,0,0,0,0,0,2013,post
A.J. Soares,,D,2,2,210,0,0,0,0,0,0,0,0,1,4,1,0,2013,post
Stephen McCarthy,,D,0,0,0,0,0,0,0,0,0,0,0,0,0,0,0,2013,post
Servando Carrasco,,M,1,0,15,0,0,0,0,0,0,0,0,0,0,0,0,2013,post
Andre Akpan,,F,0,0,0,0,0,0,0,0,0,0,0,0,0,0,0,2013,post
Michael Nanchoff,,M,0,0,0,0,0,0,0,0,0,0,0,0,0,0,0,2013,post
Alex Dixon,,M,0,0,0,0,0,0,0,0,0,0,0,0,0,0,0,2013,post
Bilal Duckett,,D,0,0,0,0,0,0,0,0,0,0,0,0,0,0,0,2013,post
Jeb Brovsky,,D,1,1,90,0,0,0,0,0,0,0,0,1,2,0,0,2013,post
Jack McBean,,F,0,0,0,0,0,0,0,0,0,0,0,0,0,0,0,2013,post
Kevin Ellis,,D,0,0,0,0,0,0,0,0,0,0,0,0,0,0,0,2013,post
Jerry Bengtson,,F,1,0,5,0,0,0,0,0,0,0,0,0,0,0,0,2013,post
Soony Saad,,F,2,0,43,0,0,0,0,0,0,0,0,2,0,0,0,2013,post
Ruben Bover,,M,0,0,0,0,0,0,0,0,0,0,0,0,0,0,0,2013,post
O'Brian Woodbine,,D,0,0,0,0,0,0,0,0,0,0,0,0,0,0,0,2013,post
Maximiliano Rodriguez,,M,0,0,0,0,0,0,0,0,0,0,0,0,0,0,0,2013,post
Yordany Álvarez,,M,1,1,57,0,0,0,0,0,0,0,0,1,1,0,0,2013,post
Connor Lade,,D,0,0,0,0,0,0,0,0,0,0,0,0,0,0,0,2013,post
José Adolfo Valencia,,F,2,0,38,0,0,0,0,0,0,0,0,2,1,1,0,2013,post
Tony Cascio,,M,0,0,0,0,0,0,0,0,0,0,0,0,0,0,0,2013,post
Kenney Walker,,M,0,0,0,0,0,0,0,0,0,0,0,0,0,0,0,2013,post
Andrew Wenger,,D-M,1,1,62,0,0,0,0,0,0,0,0,0,0,0,0,2013,post
Tyler Polak,,D,0,0,0,0,0,0,0,0,0,0,0,0,0,0,0,2013,post
Andrew Jean-Baptiste,,D,0,0,0,0,0,0,0,0,0,0,0,0,0,0,0,2013,post
Brent Richards,,F,0,0,0,0,0,0,0,0,0,0,0,0,0,0,0,2013,post
Rafael Garcia ,,D,1,0,7,0,0,0,0,0,0,0,0,1,0,1,0,2013,post
Bryan Gaul,,D,0,0,0,0,0,0,0,0,0,0,0,0,0,0,0,2013,post
Chandler Hoffman,,F,0,0,0,0,0,0,0,0,0,0,0,0,0,0,0,2013,post
Calum Mallace,,M,0,0,0,0,0,0,0,0,0,0,0,0,0,0,0,2013,post
Enzo Martinez,,M,0,0,0,0,0,0,0,0,0,0,0,0,0,0,0,2013,post
Tommy Meyer,,D,0,0,0,0,0,0,0,0,0,0,0,0,0,0,0,2013,post
Andy Rose,,M,1,0,6,0,0,0,0,0,0,0,0,2,0,0,0,2013,post
Kyle Miller,,M,0,0,0,0,0,0,0,0,0,0,0,0,0,0,0,2013,post
Mechack Jérôme,,D,0,0,0,0,0,0,0,0,0,0,0,0,0,0,0,2013,post
Amando Moreno,,M-F,0,0,0,0,0,0,0,0,0,0,0,0,0,0,0,2013,post
Oscar Sorto,,D,0,0,0,0,0,0,0,0,0,0,0,0,0,0,0,2013,post
Alex Caskey,,M,0,0,0,0,0,0,0,0,0,0,0,0,0,0,0,2013,post
Sebastián Rincón,,F,0,0,0,0,0,0,0,0,0,0,0,0,0,0,0,2013,post
Will Bates,,F,0,0,0,0,0,0,0,0,0,0,0,0,0,0,0,2013,post
John Stertzer,,M,0,0,0,0,0,0,0,0,0,0,0,0,0,0,0,2013,post
Karl Ouimette,,D,0,0,0,0,0,0,0,0,0,0,0,0,0,0,0,2013,post
Shane O'Neill,,D,1,1,90,0,0,0,0,0,0,0,0,2,0,0,0,2013,post
Alexander Lopez,,M,0,0,0,0,0,0,0,0,0,0,0,0,0,0,0,2013,post
Ian Christianson,,M,0,0,0,0,0,0,0,0,0,0,0,0,0,0,0,2013,post
Chris Klute,,D,1,1,90,0,0,0,0,0,0,0,0,3,0,0,0,2013,post
Mikey Lopez,,M,0,0,0,0,0,0,0,0,0,0,0,0,0,0,0,2013,post
Eriq Zavaleta,,D,0,0,0,0,0,0,0,0,0,0,0,0,0,0,0,2013,post
Dylan Remick,,D,0,0,0,0,0,0,0,0,0,0,0,0,0,0,0,2013,post
Dillon Serna,,M,0,0,0,0,0,0,0,0,0,0,0,0,0,0,0,2013,post
Scott Caldwell,,M,2,0,94,0,0,0,0,0,0,0,0,3,0,1,0,2013,post
Michael Bustamante,,M,0,0,0,0,0,0,0,0,0,0,0,0,0,0,0,2013,post
Christian Duke,,M,0,0,0,0,0,0,0,0,0,0,0,0,0,0,0,2013,post
Anthony Arena,,D,0,0,0,0,0,0,0,0,0,0,0,0,0,0,0,2013,post
Brenton Griffiths,,D,0,0,0,0,0,0,0,0,0,0,0,0,0,0,0,2013,post
Gabe Latigue,,M,0,0,0,0,0,0,0,0,0,0,0,0,0,0,0,2013,post
Matt Horth,,F,0,0,0,0,0,0,0,0,0,0,0,0,0,0,0,2013,post
Alvas Powell,,D,0,0,0,0,0,0,0,0,0,0,0,0,0,0,0,2013,post
Wandrille Lefevre,,D,0,0,0,0,0,0,0,0,0,0,0,0,0,0,0,2013,post
Maxim Tissot,,D,0,0,0,0,0,0,0,0,0,0,0,0,0,0,0,2013,post
Zakaria Messoudi,,M,0,0,0,0,0,0,0,0,0,0,0,0,0,0,0,2013,post
Bryan Salazar,,F,0,0,0,0,0,0,0,0,0,0,0,0,0,0,0,2013,post
Carlos Salcedo,,D,0,0,0,0,0,0,0,0,0,0,0,0,0,0,0,2013,post
Marius Obekop,,M,0,0,0,0,0,0,0,0,0,0,0,0,0,0,0,2013,post
Matt Miazga,,D,0,0,0,0,0,0,0,0,0,0,0,0,0,0,0,2013,post
Erik Palmer-Brown,,D,0,0,0,0,0,0,0,0,0,0,0,0,0,0,0,2013,post
Brendan Ruiz,,D,0,0,0,0,0,0,0,0,0,0,0,0,0,0,0,2013,post
Jimmy Medranda ,,D,0,0,0,0,0,0,0,0,0,0,0,0,0,0,0,2013,post
Benji Lopez,,F,0,0,0,0,0,0,0,0,0,0,0,0,0,0,0,2013,post
German Mera,,D,1,1,90,0,0,0,0,0,0,0,0,2,2,1,0,2013,post
Steven Evans,,M,0,0,0,0,0,0,0,0,0,0,0,0,0,0,0,2013,post
Kory Kindle,,D,0,0,0,0,0,0,0,0,0,0,0,0,0,0,0,2013,post
Charlie Rugg,,F,0,0,0,0,0,0,0,0,0,0,0,0,0,0,0,2013,post
Kofi Opare,,D,2,2,195,0,0,0,0,0,0,0,0,2,1,0,0,2013,post
Greg Cochrane,,D,0,0,0,0,0,0,0,0,0,0,0,0,0,0,0,2013,post
Blake Smith,,D,0,0,0,0,0,0,0,0,0,0,0,0,0,0,0,2013,post
Paolo DelPiccolo,,M,0,0,0,0,0,0,0,0,0,0,0,0,0,0,0,2013,post
Andrew Farrell,,D,2,2,210,0,0,0,0,0,0,0,0,1,3,0,0,2013,post
Donnie Smith,,M,0,0,0,0,0,0,0,0,0,0,0,0,0,0,0,2013,post
Dylan Tucker-Gangnes,,D,0,0,0,0,0,0,0,0,0,0,0,0,0,0,0,2013,post
Jason Johnson,,F,1,0,8,0,0,1,0,0,0,0,0,0,0,0,0,2013,post
Warren Creavalle,,M,5,5,394,0,0,1,0,0,0,0,0,4,5,0,0,2013,post
Collen Warner,,M,1,1,62,0,0,1,0,0,0,0,0,1,2,0,0,2013,post
Marcelo Sarvas,,M,2,2,194,0,0,1,0,0,0,0,0,3,5,0,0,2013,post
Hendry Thomas,,M,1,1,90,0,0,1,0,0,0,0,0,3,4,1,0,2013,post
Omar Gonzalez,,D,2,2,210,0,0,1,0,0,0,0,0,2,7,0,0,2013,post
Matt Besler,,D,5,5,510,0,0,1,0,0,0,0,0,7,4,0,0,2013,post
Eric Brunner,,D,5,5,475,0,0,1,0,0,0,0,0,2,5,1,0,2013,post
Ned Grabavoy,,M,4,3,274,0,0,1,0,0,0,0,0,4,4,0,0,2013,post
Marc Burch,,D,3,1,141,0,0,1,0,0,0,0,0,3,1,1,0,2013,post
Jacob Peterson,,F,3,2,155,0,0,1,0,0,0,0,0,1,0,0,0,2013,post
Atiba Harris,,D,1,1,90,0,0,1,0,0,0,0,0,5,1,1,0,2013,post
Khari Stephenson,,M,1,0,31,0,0,1,0,0,0,0,0,1,0,1,0,2013,post
Lovel Palmer,,D,3,1,164,0,0,1,0,0,0,0,0,4,1,1,0,2013,post
Vicente Sanchez,,F,1,0,29,0,0,1,0,0,0,0,0,0,0,0,0,2013,post
Djimi Traore,,D,3,3,270,0,0,1,0,0,0,0,0,2,4,0,0,2013,post
Peguy Luyindula,,F,2,1,88,0,0,1,0,0,0,0,0,3,3,0,0,2013,post
Lloyd Sam,,M-F,2,1,92,0,0,1,0,0,0,0,0,1,2,0,0,2013,post
José Gonçalves,,D,2,2,210,0,0,1,0,0,0,0,0,4,2,0,0,2013,post
Daniele Paponi,,F,1,0,28,0,0,1,1,0,0,0,0,0,0,0,0,2013,post
Michael Harrington,,D,4,4,360,0,0,2,0,0,0,0,0,3,0,0,0,2013,post
Tony Beltran,,D,5,5,510,0,0,2,0,0,0,0,0,7,6,0,0,2013,post
Jhon Kennedy Hurtado,,D,3,3,270,0,0,2,1,0,0,0,0,3,3,0,0,2013,post
Maximiliano Urruti,,F,2,0,84,0,0,2,1,0,0,0,0,0,2,0,0,2013,post
Martin Rivero,,M,1,1,61,0,0,2,1,0,0,0,0,1,2,0,0,2013,post
Jose Villarreal,,M,1,0,15,0,0,2,0,0,0,0,0,1,0,0,0,2013,post
Deshorn Brown,,F,1,1,73,0,0,2,1,0,0,0,0,1,2,0,0,2013,post
Olmes Garcia,,F,2,0,49,0,0,3,1,0,0,0,0,1,1,0,0,2013,post
Jonny Steele,,M,2,2,188,0,0,3,1,0,0,0,0,3,2,1,0,2013,post
Lawrence Olum,,D,2,1,202,0,0,3,0,0,0,0,0,0,1,0,0,2013,post
Diego Fagundez,,M,2,2,210,0,0,3,1,0,0,0,0,1,0,0,0,2013,post
Juninho,,M,2,2,209,0,0,3,1,0,0,0,0,3,1,1,0,2013,post
Adam Moffat,,M,3,3,224,0,0,3,1,0,0,0,0,2,4,0,0,2013,post
Bobby Boswell,,D,5,5,480,0,0,3,1,0,0,0,0,3,5,0,0,2013,post
Pa-Modou Kah,,D,4,4,360,0,0,3,0,0,0,0,0,9,1,2,0,2013,post
Justin Mapp,,M,1,1,90,0,0,3,1,0,0,0,0,1,1,0,0,2013,post
Andrew Driver,,M,5,1,212,0,0,4,0,0,0,0,0,1,1,0,0,2013,post
Teal Bunbury,,F,2,2,153,0,0,4,3,0,0,0,0,2,0,1,0,2013,post
Nat Borchers,,D,5,5,510,0,0,5,2,0,0,0,0,7,3,0,0,2013,post
Marco Di Vaio,,F,1,1,89,0,0,5,2,0,0,0,0,0,0,0,1,2013,post
Gyasi Zardes,,F,2,2,210,0,0,5,0,0,0,0,0,4,2,0,0,2013,post
Oriol Rosell,,M-D,5,5,398,0,0,6,1,0,0,0,0,8,5,0,0,2013,post
Giles Barnes,,M,5,4,341,0,0,6,3,0,0,0,0,6,5,0,0,2013,post
Robbie Rogers,,D,2,2,136,0,0,6,0,0,0,0,0,2,3,0,0,2013,post
Landon Donovan,,M-F,2,2,210,0,0,7,1,0,0,0,0,3,2,0,0,2013,post
Lamar Neagle,,M,2,2,177,0,0,7,1,0,0,0,0,6,3,2,0,2013,post
Paulo Nagamura,,M,4,4,397,0,0,10,1,0,0,0,0,3,5,0,0,2013,post
Luis Gil,,M,5,5,477,0,0,10,4,0,0,0,0,3,5,0,0,2013,post
Charlie Davies,,F,5,5,410,4,1,9,7,2,2,1,0,5,6,0,0,2014,post
Bradley Wright-Phillips,,F,4,4,360,4,1,17,9,4,0,0,1,5,7,2,0,2014,post
Peguy Luyindula,,F,5,4,356,3,2,8,5,1,2,2,0,2,6,0,0,2014,post
Landon Donovan,,M-F,5,5,473,3,2,10,6,3,0,1,1,7,5,2,0,2014,post
Lee Nguyen,,M,5,5,432,2,3,5,4,1,1,2,1,9,10,1,0,2014,post
Robbie Keane,,F,5,5,480,2,3,19,8,2,0,3,0,4,8,1,0,2014,post
Chris Tierney,,D-M,5,5,480,2,2,4,3,0,2,2,0,3,3,0,0,2014,post
Marcelo Sarvas,,M,5,5,459,2,2,4,2,2,0,2,0,17,6,2,0,2014,post
Teal Bunbury,,F,5,5,480,2,2,13,7,1,1,1,1,8,6,0,0,2014,post
Michel Garbini Pereira,,M-D,3,3,266,2,0,5,3,2,0,0,0,5,2,0,0,2014,post
Jermaine Jones,,M,5,5,472,1,2,15,5,0,1,0,2,10,20,2,0,2014,post
José Gonçalves,,D,5,5,469,1,1,2,1,1,0,0,1,2,4,1,0,2014,post
Nick DeLeon,,M,2,2,180,1,1,3,1,1,0,1,0,2,4,0,0,2014,post
Juninho,,M,5,5,453,1,1,5,2,0,1,1,0,7,4,0,0,2014,post
Justin Meram,,M,2,2,175,1,1,8,3,1,0,0,1,4,4,1,1,2014,post
Sean Franklin,,D,2,1,110,1,0,1,1,1,0,0,0,1,3,0,0,2014,post
Osvaldo Alonso,,M,3,3,220,1,0,2,1,0,1,0,0,2,2,0,0,2014,post
Federico Higuain,,F,1,1,90,1,0,3,1,1,0,0,0,2,3,0,0,2014,post
Brad Evans,,D-M,4,4,359,1,0,3,1,1,0,0,0,1,2,0,0,2014,post
Tesho Akindele,,F-M,3,3,270,1,0,3,2,1,0,0,0,4,1,0,0,2014,post
Tony Tchani,,M,2,2,180,1,0,4,2,0,1,0,0,4,2,0,0,2014,post
Tim Cahill,,M,5,2,233,1,0,7,1,0,1,0,0,6,6,1,0,2014,post
Gyasi Zardes,,F,5,5,480,1,0,11,3,1,0,0,0,6,4,0,0,2014,post
Clint Dempsey,,M-F,4,4,359,1,0,18,10,1,0,0,0,4,8,0,0,2014,post
Thierry Henry,,F,5,5,441,0,5,8,2,0,0,3,2,3,3,1,0,2014,post
A.J. DeLaGarza,,D,4,4,361,0,2,1,0,0,0,2,0,4,2,1,0,2014,post
Scott Caldwell,,M,5,5,418,0,2,1,0,0,0,1,1,4,3,1,0,2014,post
Steven Birnbaum,,D,2,2,180,0,1,0,0,0,0,1,0,5,0,0,0,2014,post
Ambroise Oyongo,,D,5,2,218,0,1,0,0,0,0,1,0,8,1,2,0,2014,post
Omar Gonzalez,,D,5,5,480,0,1,1,0,0,0,0,1,6,4,1,0,2014,post
Daigo Kobayashi,,M,3,0,78,0,1,1,0,0,0,1,0,0,1,0,0,2014,post
Taylor Kemp,,D,2,2,160,0,1,2,2,0,0,1,0,5,0,1,0,2014,post
Mauro Diaz,,M,2,2,169,0,1,2,0,0,0,1,0,2,11,1,0,2014,post
Patrick Mullins,,F,3,0,64,0,1,4,3,0,0,0,1,1,1,0,0,2014,post
Robbie Rogers,,D,5,5,435,0,1,5,1,0,0,1,0,4,7,2,0,2014,post
Stefan Ishizaki,,M,4,4,334,0,1,6,2,0,0,1,0,2,4,1,0,2014,post
Fabian Espindola,,F,2,2,180,0,1,9,2,0,0,1,0,3,2,1,1,2014,post
Kelyn Rowe,,M,5,4,352,0,1,9,2,0,0,0,1,7,6,0,0,2014,post
Marco Pappa,,M,4,3,204,0,1,9,3,0,0,0,1,4,2,0,0,2014,post
Lloyd Sam,,M-F,5,5,449,0,1,10,6,0,0,1,0,10,8,1,0,2014,post
Shalrie Joseph,,M,0,0,0,0,0,0,0,0,0,0,0,0,0,0,0,2014,post
Bobby Convey,,M,0,0,0,0,0,0,0,0,0,0,0,0,0,0,0,2014,post
Kenny Cooper,,F,1,0,25,0,0,0,0,0,0,0,0,0,0,0,0,2014,post
Djimi Traore,,D,1,0,1,0,0,0,0,0,0,0,0,0,1,0,0,2014,post
Peter Luccin,,M,0,0,0,0,0,0,0,0,0,0,0,0,0,0,0,2014,post
Emanuel Pogatetz,,D,0,0,0,0,0,0,0,0,0,0,0,0,0,0,0,2014,post
Lewis Neal,,M,1,0,24,0,0,0,0,0,0,0,0,0,0,0,0,2014,post
Onyekachi Apam,,D,0,0,0,0,0,0,0,0,0,0,0,0,0,0,0,2014,post
Rob Friend,,F,0,0,0,0,0,0,0,0,0,0,0,0,0,0,0,2014,post
Chad Barrett,,F,1,0,28,0,0,0,0,0,0,0,0,0,0,0,0,2014,post
Ned Grabavoy,,M,1,1,65,0,0,0,0,0,0,0,0,0,1,0,0,2014,post
Bobby Boswell,,D,2,2,180,0,0,0,0,0,0,0,0,2,1,0,0,2014,post
Tyson Wahl,,D,2,2,124,0,0,0,0,0,0,0,0,1,0,0,0,2014,post
Jair Benítez,,D,0,0,0,0,0,0,0,0,0,0,0,0,0,0,0,2014,post
Gonzalo Pineda,,M,3,3,255,0,0,0,0,0,0,0,0,3,4,0,0,2014,post
Jared Jeffrey,,M,0,0,0,0,0,0,0,0,0,0,0,0,0,0,0,2014,post
George John,,D,0,0,0,0,0,0,0,0,0,0,0,0,0,0,0,2014,post
Kevin Alston,,D,4,2,224,0,0,0,0,0,0,0,0,2,5,0,0,2014,post
Adam Moffat,,M,0,0,0,0,0,0,0,0,0,0,0,0,0,0,0,2014,post
Armando,,M,1,0,1,0,0,0,0,0,0,0,0,0,0,0,0,2014,post
Daniel Paladini,,M,0,0,0,0,0,0,0,0,0,0,0,0,0,0,0,2014,post
Abdoulie Mansally,,D,0,0,0,0,0,0,0,0,0,0,0,0,0,0,0,2014,post
Tony Beltran,,D,2,2,180,0,0,0,0,0,0,0,0,4,3,2,0,2014,post
Nat Borchers,,D,2,2,180,0,0,0,0,0,0,0,0,1,0,0,0,2014,post
Richard Eckersley,,D,5,5,435,0,0,0,0,0,0,0,0,9,3,1,0,2014,post
Damien Perrinelle,,D,0,0,0,0,0,0,0,0,0,0,0,0,0,0,0,2014,post
Roy Miller,,D,3,3,258,0,0,0,0,0,0,0,0,5,1,2,1,2014,post
Nana Attakora,,D,0,0,0,0,0,0,0,0,0,0,0,0,0,0,0,2014,post
Todd Dunivant,,D,0,0,0,0,0,0,0,0,0,0,0,0,0,0,0,2014,post
Jeff Parke,,D,0,0,0,0,0,0,0,0,0,0,0,0,0,0,0,2014,post
Dan Gargan,,D,5,2,254,0,0,0,0,0,0,0,0,4,1,0,0,2014,post
Stephen Keel,,D,0,0,0,0,0,0,0,0,0,0,0,0,0,0,0,2014,post
James Riley,,D,0,0,0,0,0,0,0,0,0,0,0,0,0,0,0,2014,post
Kosuke Kimura,,D,0,0,0,0,0,0,0,0,0,0,0,0,0,0,0,2014,post
Saer Sene,,M,0,0,0,0,0,0,0,0,0,0,0,0,0,0,0,2014,post
Cam Weaver,,F,0,0,0,0,0,0,0,0,0,0,0,0,0,0,0,2014,post
Leonardo González,,D,4,4,360,0,0,0,0,0,0,0,0,7,1,1,0,2014,post
Tony Taylor,,F-M,0,0,0,0,0,0,0,0,0,0,0,0,0,0,0,2014,post
Aaron Maund,,D,0,0,0,0,0,0,0,0,0,0,0,0,0,0,0,2014,post
Geoffrey Castillion,,F,0,0,0,0,0,0,0,0,0,0,0,0,0,0,0,2014,post
Agustin Viana,,M-D,0,0,0,0,0,0,0,0,0,0,0,0,0,0,0,2014,post
Samuel Inkoom,,M,0,0,0,0,0,0,0,0,0,0,0,0,0,0,0,2014,post
Hendry Thomas,,M,0,0,0,0,0,0,0,0,0,0,0,0,0,0,0,2014,post
Zach Scott,,D,4,4,360,0,0,0,0,0,0,0,0,8,4,1,0,2014,post
Darrius Barnes,,D,1,0,8,0,0,0,0,0,0,0,0,1,0,0,0,2014,post
Tristan Bowen,,F,0,0,0,0,0,0,0,0,0,0,0,0,0,0,0,2014,post
Zach Loyd,,D,3,3,270,0,0,0,0,0,0,0,0,0,4,0,0,2014,post
Eric Gehrig,,D,2,1,77,0,0,0,0,0,0,0,0,0,2,0,0,2014,post
Cole Grossman,,M,0,0,0,0,0,0,0,0,0,0,0,0,0,0,0,2014,post
Andre Akpan,,F,0,0,0,0,0,0,0,0,0,0,0,0,0,0,0,2014,post
Chris Schuler,,D,2,2,180,0,0,0,0,0,0,0,0,0,1,0,0,2014,post
Conor Doyle,,F,0,0,0,0,0,0,0,0,0,0,0,0,0,0,0,2014,post
Kyle Porter,,M,0,0,0,0,0,0,0,0,0,0,0,0,0,0,0,2014,post
Rich Balchan,,D,0,0,0,0,0,0,0,0,0,0,0,0,0,0,0,2014,post
Luis Silva,,F,0,0,0,0,0,0,0,0,0,0,0,0,0,0,0,2014,post
Kenney Walker,,M,0,0,0,0,0,0,0,0,0,0,0,0,0,0,0,2014,post
Sebastian Velasquez,,M,0,0,0,0,0,0,0,0,0,0,0,0,0,0,0,2014,post
Rafael Garcia ,,D,0,0,0,0,0,0,0,0,0,0,0,0,0,0,0,2014,post
Kevan George,,M,0,0,0,0,0,0,0,0,0,0,0,0,0,0,0,2014,post
Matt Hedges,,D,3,3,270,0,0,0,0,0,0,0,0,6,5,0,0,2014,post
Chandler Hoffman,,F,0,0,0,0,0,0,0,0,0,0,0,0,0,0,0,2014,post
John Stertzer,,M,0,0,0,0,0,0,0,0,0,0,0,0,0,0,0,2014,post
Brian Span,,M,0,0,0,0,0,0,0,0,0,0,0,0,0,0,0,2014,post
Jose Villarreal,,M,0,0,0,0,0,0,0,0,0,0,0,0,0,0,0,2014,post
Ben Speas,,M-F,1,0,16,0,0,0,0,0,0,0,0,0,0,0,0,2014,post
Alex Caskey,,M,0,0,0,0,0,0,0,0,0,0,0,0,0,0,0,2014,post
Conor Shanosky,,M-D,0,0,0,0,0,0,0,0,0,0,0,0,0,0,0,2014,post
Chris Korb,,D,1,1,90,0,0,0,0,0,0,0,0,0,1,0,0,2014,post
Stephen McCarthy,,D,0,0,0,0,0,0,0,0,0,0,0,0,0,0,0,2014,post
Perry Kitchen,,M,2,2,180,0,0,0,0,0,0,0,0,2,1,0,0,2014,post
Jalil Anibaba,,D,1,0,1,0,0,0,0,0,0,0,0,0,0,0,0,2014,post
Moises Hernandez,,D,2,2,175,0,0,0,0,0,0,0,0,3,1,1,0,2014,post
Jonathan Top,,F,0,0,0,0,0,0,0,0,0,0,0,0,0,0,0,2014,post
Diego Fagundez,,M,0,0,0,0,0,0,0,0,0,0,0,0,0,0,0,2014,post
Jack McBean,,F,0,0,0,0,0,0,0,0,0,0,0,0,0,0,0,2014,post
Jerry Bengtson,,F,0,0,0,0,0,0,0,0,0,0,0,0,0,0,0,2014,post
Ruben Bover,,M,1,0,1,0,0,0,0,0,0,0,0,0,0,0,0,2014,post
Dimitry Imbongo,,F,0,0,0,0,0,0,0,0,0,0,0,0,0,0,0,2014,post
David Texeira,,F,2,0,8,0,0,0,0,0,0,0,0,0,0,0,0,2014,post
Andrés Escobar,,F,3,1,107,0,0,0,0,0,0,0,0,1,3,1,0,2014,post
Connor Lade,,D,2,0,5,0,0,0,0,0,0,0,0,0,0,0,0,2014,post
Justen Glad,,D,0,0,0,0,0,0,0,0,0,0,0,0,0,0,0,2014,post
Coy Craft,,F-M,0,0,0,0,0,0,0,0,0,0,0,0,0,0,0,2014,post
Romain Gall,,M,0,0,0,0,0,0,0,0,0,0,0,0,0,0,0,2014,post
Walter Cabrera,,D,0,0,0,0,0,0,0,0,0,0,0,0,0,0,0,2014,post
Ross Friedman,,D,0,0,0,0,0,0,0,0,0,0,0,0,0,0,0,2014,post
Bradford Jamieson IV,,F,0,0,0,0,0,0,0,0,0,0,0,0,0,0,0,2014,post
Raul Mendiola,,M,0,0,0,0,0,0,0,0,0,0,0,0,0,0,0,2014,post
Nicholas Walker,,D,0,0,0,0,0,0,0,0,0,0,0,0,0,0,0,2014,post
Carlos Salcedo,,D,0,0,0,0,0,0,0,0,0,0,0,0,0,0,0,2014,post
Marius Obekop,,M,0,0,0,0,0,0,0,0,0,0,0,0,0,0,0,2014,post
Matt Wiet,,D,0,0,0,0,0,0,0,0,0,0,0,0,0,0,0,2014,post
Ryan Hollingshead,,M,1,0,1,0,0,0,0,0,0,0,0,0,1,0,0,2014,post
Sean Okoli,,F,0,0,0,0,0,0,0,0,0,0,0,0,0,0,0,2014,post
Jalen Robinson,,D,0,0,0,0,0,0,0,0,0,0,0,0,0,0,0,2014,post
Chris Duvall,,D,0,0,0,0,0,0,0,0,0,0,0,0,0,0,0,2014,post
Collin Martin,,M,0,0,0,0,0,0,0,0,0,0,0,0,0,0,0,2014,post
Matt Walker,,M,0,0,0,0,0,0,0,0,0,0,0,0,0,0,0,2014,post
Danny Garcia,,M-F,0,0,0,0,0,0,0,0,0,0,0,0,0,0,0,2014,post
Sebastian Jaime,,F,1,0,20,0,0,0,0,0,0,0,0,0,0,0,0,2014,post
Oscar Sorto,,D,0,0,0,0,0,0,0,0,0,0,0,0,0,0,0,2014,post
Kellyn Acosta,,M,1,0,14,0,0,0,0,0,0,0,0,0,1,0,0,2014,post
Olmes Garcia,,F,0,0,0,0,0,0,0,0,0,0,0,0,0,0,0,2014,post
Chad Barson,,D,0,0,0,0,0,0,0,0,0,0,0,0,0,0,0,2014,post
DeAndre Yedlin,,D,4,4,360,0,0,0,0,0,0,0,0,4,1,1,0,2014,post
Michael Seaton,,F,0,0,0,0,0,0,0,0,0,0,0,0,0,0,0,2014,post
Ian Christianson,,M,0,0,0,0,0,0,0,0,0,0,0,0,0,0,0,2014,post
Alec Sundly,,M,0,0,0,0,0,0,0,0,0,0,0,0,0,0,0,2014,post
Jossimar Sanchez,,D,0,0,0,0,0,0,0,0,0,0,0,0,0,0,0,2014,post
Michael Bustamante,,M,0,0,0,0,0,0,0,0,0,0,0,0,0,0,0,2014,post
Charlie Rugg,,F,0,0,0,0,0,0,0,0,0,0,0,0,0,0,0,2014,post
Kofi Opare,,D,0,0,0,0,0,0,0,0,0,0,0,0,0,0,0,2014,post
Donnie Smith,,M,0,0,0,0,0,0,0,0,0,0,0,0,0,0,0,2014,post
Devon Sandoval,,F,0,0,0,0,0,0,0,0,0,0,0,0,0,0,0,2014,post
Dylan Remick,,D,0,0,0,0,0,0,0,0,0,0,0,0,0,0,0,2014,post
Damion Lowe,,D,0,0,0,0,0,0,0,0,0,0,0,0,0,0,0,2014,post
Steve Neumann,,M-F,0,0,0,0,0,0,0,0,0,0,0,0,0,0,0,2014,post
Jimmy Ockford,,D,0,0,0,0,0,0,0,0,0,0,0,0,0,0,0,2014,post
Ben Sweat,,D,0,0,0,0,0,0,0,0,0,0,0,0,0,0,0,2014,post
Aaron Long,,D,0,0,0,0,0,0,0,0,0,0,0,0,0,0,0,2014,post
Matt Miazga,,D,0,0,0,0,0,0,0,0,0,0,0,0,0,0,0,2014,post
Kevin Parsemain,,F,0,0,0,0,0,0,0,0,0,0,0,0,0,0,0,2014,post
Benji Lopez,,F,0,0,0,0,0,0,0,0,0,0,0,0,0,0,0,2014,post
Aaron Kovar,,M,0,0,0,0,0,0,0,0,0,0,0,0,0,0,0,2014,post
Fifi Baiden,,M,0,0,0,0,0,0,0,0,0,0,0,0,0,0,0,2014,post
Eric Stevenson,,M,0,0,0,0,0,0,0,0,0,0,0,0,0,0,0,2014,post
Kyle Venter,,D,0,0,0,0,0,0,0,0,0,0,0,0,0,0,0,2014,post
Walker Zimmerman,,D,2,1,95,0,0,1,0,0,0,0,0,2,1,0,0,2014,post
Wil Trapp,,M,2,2,180,0,0,1,0,0,0,0,0,2,2,0,0,2014,post
Adam Bedell,,F,1,0,45,0,0,1,1,0,0,0,0,1,1,0,0,2014,post
A.J. Soares,,D,5,5,480,0,0,1,0,0,0,0,0,7,5,1,0,2014,post
Waylon Francis,,D,2,2,163,0,0,1,0,0,0,0,0,3,0,1,0,2014,post
Tommy Meyer,,D,2,1,143,0,0,1,0,0,0,0,0,1,0,0,0,2014,post
Andy Rose,,M,2,0,25,0,0,1,0,0,0,0,0,0,0,0,0,2014,post
Josh Williams,,D,1,0,34,0,0,1,0,0,0,0,0,0,0,0,0,2014,post
Hector Jimenez,,M,2,2,159,0,0,1,0,0,0,0,0,3,1,0,0,2014,post
David Estrada,,M-F,1,0,17,0,0,1,0,0,0,0,0,1,1,0,0,2014,post
Leonardo,,D,3,3,247,0,0,1,0,0,0,0,0,3,0,0,0,2014,post
Lamar Neagle,,M,3,2,175,0,0,1,1,0,0,0,0,3,2,0,0,2014,post
Andy Dorman,,M,3,0,43,0,0,1,0,0,0,0,0,1,0,0,0,2014,post
Chris Wingert,,D,2,2,180,0,0,1,0,0,0,0,0,2,3,1,0,2014,post
Robbie Findley,,F,1,0,25,0,0,1,0,0,0,0,0,0,0,0,0,2014,post
Blas Pérez,,F,3,3,259,0,0,1,0,0,0,0,0,4,4,0,0,2014,post
Michael Parkhurst,,D,2,2,180,0,0,1,0,0,0,0,0,0,1,0,0,2014,post
Ibrahim Sekagya,,D,5,5,446,0,0,2,1,0,0,0,0,3,4,1,0,2014,post
Chad Marshall,,D,4,4,360,0,0,2,1,0,0,0,0,2,3,0,0,2014,post
Chris Rolfe,,F,2,1,82,0,0,2,0,0,0,0,0,0,2,0,0,2014,post
Luis Gil,,M,2,1,125,0,0,2,0,0,0,0,0,0,0,0,0,2014,post
Bernardo Añor,,M,1,0,17,0,0,2,1,0,0,0,0,1,0,1,0,2014,post
Aaron Schoenfeld ,,F,1,1,90,0,0,2,1,0,0,0,0,4,2,0,0,2014,post
Jairo Arrieta,,F,2,1,85,0,0,2,2,0,0,0,0,1,0,0,0,2014,post
Joao Plata,,F,2,2,180,0,0,2,2,0,0,0,0,4,3,0,0,2014,post
Je-Vaughn Watson,,D,3,3,270,0,0,2,0,0,0,0,0,2,2,1,0,2014,post
Micheal Azira,,M,4,1,148,0,0,3,0,0,0,0,0,2,2,0,0,2014,post
Andrew Farrell,,D,4,4,390,0,0,3,1,0,0,0,0,1,2,1,0,2014,post
Luke Mulholland,,M,2,2,145,0,0,3,0,0,0,0,0,0,3,0,0,2014,post
Victor Ulloa,,M,3,3,256,0,0,3,1,0,0,0,0,6,4,0,0,2014,post
Alvaro Saborio,,F,2,2,180,0,0,3,2,0,0,0,0,3,3,1,0,2014,post
Eddie Johnson,,F,2,1,120,0,0,3,0,0,0,0,0,3,3,0,0,2014,post
Jámison Olave,,D,5,5,450,0,0,3,1,0,0,0,0,6,8,0,0,2014,post
Baggio Husidic,,M,4,1,135,0,0,3,0,0,0,0,0,3,1,0,0,2014,post
Chris Pontius,,M,2,2,147,0,0,3,1,0,0,0,0,1,5,0,0,2014,post
Javier Morales,,M,2,2,160,0,0,4,2,0,0,0,0,5,7,0,0,2014,post
Davy Arnaud,,M,2,2,150,0,0,4,1,0,0,0,0,3,5,0,0,2014,post
Kyle Beckerman,,M,2,2,180,0,0,4,1,0,0,0,0,2,2,0,0,2014,post
Ethan Finlay,,M,2,2,151,0,0,4,2,0,0,0,0,3,2,0,1,2014,post
Alan Gordon,,F,5,0,66,0,0,5,0,0,0,0,0,5,3,1,0,2014,post
Dax McCarty,,M,5,5,450,0,0,5,1,0,0,0,0,8,12,2,0,2014,post
Eric Alexander,,M,5,5,385,0,0,5,1,0,0,0,0,3,5,1,0,2014,post
Fabian Castillo,,M-F,3,3,270,0,0,6,1,0,0,0,0,4,6,0,0,2014,post
Obafemi Martins,,F,4,4,360,0,0,8,3,0,0,0,0,5,11,0,0,2014,post
Kei Kamara,,F,5,5,480,4,0,18,11,4,0,0,0,2,4,0,0,2015,post
Patrice Bernier,,M,3,3,224,2,1,5,4,2,0,1,0,3,3,0,0,2015,post
Rodney Wallace,,D,5,5,447,2,1,10,4,1,1,0,1,13,4,2,0,2015,post
Fanendo Adi,,F,6,6,525,2,1,10,6,0,2,0,1,16,7,0,0,2015,post
Clint Dempsey,,M-F,3,3,300,2,0,7,4,2,0,0,0,2,5,0,0,2015,post
Diego Valeri,,M,5,5,474,1,4,11,7,0,1,1,3,11,12,3,0,2015,post
Dairon Asprilla,,M-F,6,3,330,1,3,7,3,1,0,2,1,6,4,1,0,2015,post
Federico Higuain,,F,5,5,480,1,2,7,2,0,1,2,0,5,5,0,0,2015,post
Gyasi Zardes,,F,1,1,90,1,1,2,2,0,1,0,1,1,1,0,0,2015,post
Andreas Ivanschitz,,M,3,3,297,1,1,4,4,1,0,1,0,7,3,1,0,2015,post
Blas Pérez,,F,3,0,94,1,1,7,2,1,0,1,0,4,2,1,0,2015,post
Lucas Melano,,F,6,4,305,1,1,9,3,0,1,0,1,3,2,1,0,2015,post
Ignacio Piatti,,M,3,3,300,1,1,16,5,1,0,1,0,4,7,0,0,2015,post
Chris Pontius,,M,1,1,54,1,0,1,1,1,0,0,0,0,0,0,0,2015,post
Kevin Ellis,,D,1,1,120,1,0,1,1,0,1,0,0,2,1,1,0,2015,post
Diego Chara,,M,4,4,360,1,0,1,1,0,1,0,0,9,7,2,0,2015,post
Walker Zimmerman,,D,2,1,126,1,0,2,1,1,0,0,0,2,2,0,0,2015,post
Anatole Abang,,F,2,0,22,1,0,2,1,1,0,0,0,0,0,0,0,2015,post
Dilly Duka,,M,3,2,178,1,0,2,1,0,1,0,0,0,2,0,0,2015,post
Juan Agudelo,,F,1,1,70,1,0,3,1,0,1,0,0,2,3,0,0,2015,post
Krisztian Nemeth,,F,1,1,110,1,0,3,2,0,1,0,0,2,0,1,0,2015,post
Chad Marshall,,D,3,3,300,1,0,3,1,0,1,0,0,0,3,0,0,2015,post
Liam Ridgewell,,D,5,5,451,1,0,3,3,1,0,0,0,8,9,1,0,2015,post
Johan Venegas,,M,2,0,52,1,0,3,2,1,0,0,0,1,1,0,0,2015,post
Ryan Hollingshead,,M,4,4,386,1,0,4,1,1,0,0,0,3,6,0,0,2015,post
Maximiliano Urruti,,F,5,0,45,1,0,4,3,1,0,0,0,2,1,0,0,2015,post
Dax McCarty,,M,4,4,360,1,0,4,2,0,1,0,0,4,6,0,0,2015,post
Erik Friberg,,M,3,3,251,1,0,4,1,1,0,0,0,5,3,1,0,2015,post
Sebastian Lletget,,M,1,1,76,1,0,4,1,0,1,0,0,0,0,0,0,2015,post
Nat Borchers,,D,6,6,570,1,0,5,3,1,0,0,0,3,1,0,0,2015,post
Nelson Valdez,,F,3,2,179,1,0,5,2,1,0,0,0,6,3,0,0,2015,post
David Texeira,,F,4,4,277,1,0,5,3,0,1,0,0,7,2,0,0,2015,post
Tesho Akindele,,F-M,4,0,95,1,0,6,3,1,0,0,0,1,0,0,0,2015,post
Chris Rolfe,,F,3,3,245,1,0,7,3,1,0,0,0,7,3,1,0,2015,post
Justin Meram,,M,5,5,420,1,0,7,4,1,0,0,0,7,6,0,0,2015,post
Ethan Finlay,,M,5,5,419,1,0,8,3,1,0,0,0,1,5,0,0,2015,post
Didier Drogba,,F,3,3,300,1,0,11,8,1,0,0,0,3,13,1,0,2015,post
Bradley Wright-Phillips,,F,4,4,360,1,0,12,6,1,0,0,0,3,7,1,0,2015,post
Fabian Castillo,,M-F,4,4,390,1,0,12,5,0,1,0,0,9,10,0,0,2015,post
Mauro Diaz,,M,4,4,390,0,4,10,2,0,0,2,2,4,17,1,0,2015,post
Je-Vaughn Watson,,D,4,4,390,0,2,0,0,0,0,1,1,3,4,0,0,2015,post
Darlington Nagbe,,M,6,6,570,0,2,9,1,0,0,1,1,3,19,0,0,2015,post
Fabian Espindola,,F,3,3,270,0,2,10,3,0,0,2,0,2,8,1,0,2015,post
Graham Zusi,,M,1,1,120,0,1,0,0,0,0,0,1,1,4,0,0,2015,post
Kevin Alston,,D,1,1,90,0,1,0,0,0,0,0,1,1,0,0,0,2015,post
Juninho,,M,1,1,90,0,1,0,0,0,0,0,1,0,0,0,0,2015,post
Victor Cabrera,,D,3,3,300,0,1,0,0,0,0,0,1,2,0,1,0,2015,post
Amadou Dia,,D,1,1,120,0,1,0,0,0,0,0,1,2,1,1,0,2015,post
Lloyd Sam,,M-F,4,4,356,0,1,1,0,0,0,1,0,4,2,0,0,2015,post
Cedrick Mabwati,,M,4,0,98,0,1,2,1,0,0,1,0,3,3,0,0,2015,post
Laurent Ciman,,D,3,3,300,0,1,2,0,0,0,0,1,3,0,0,0,2015,post
Marco Pappa,,M,2,1,94,0,1,2,0,0,0,0,1,5,1,1,0,2015,post
Giovani dos Santos,,M,1,1,90,0,1,3,1,0,0,0,1,0,3,0,0,2015,post
Nick DeLeon,,M,3,3,270,0,1,3,0,0,0,1,0,1,2,0,0,2015,post
Gonzalo Verón,,M-F,4,0,68,0,1,3,1,0,0,1,0,3,1,0,0,2015,post
Waylon Francis,,D,5,5,480,0,1,4,0,0,0,1,0,4,3,0,0,2015,post
Marco Donadel,,M,3,3,300,0,1,5,3,0,0,1,0,3,1,1,0,2015,post
Sacha Kljestan,,M,4,4,360,0,1,12,4,0,0,0,1,10,9,1,0,2015,post
Ahmed Kantari,,D,1,1,45,0,0,0,0,0,0,0,0,3,0,0,0,2015,post
Anthony Wallace,,D,0,0,0,0,0,0,0,0,0,0,0,0,0,0,0,2015,post
Robbie Findley,,F,1,1,72,0,0,0,0,0,0,0,0,0,0,0,0,2015,post
Damien Perrinelle,,D,1,1,51,0,0,0,0,0,0,0,0,1,1,0,0,2015,post
Jorge Villafaña,,F,6,6,547,0,0,0,0,0,0,0,0,9,9,1,0,2015,post
Bakary Soumare,,D,0,0,0,0,0,0,0,0,0,0,0,0,0,0,0,2015,post
Chad Barrett,,F,2,0,50,0,0,0,0,0,0,0,0,1,0,0,0,2015,post
Brad Evans,,D-M,1,1,90,0,0,0,0,0,0,0,0,0,0,0,0,2015,post
Dan Gargan,,D,0,0,0,0,0,0,0,0,0,0,0,0,0,0,0,2015,post
Hérculez Gómez,,F,1,0,18,0,0,0,0,0,0,0,0,0,1,0,0,2015,post
Stephen Keel,,D,0,0,0,0,0,0,0,0,0,0,0,0,0,0,0,2015,post
Jacob Peterson,,F,1,0,10,0,0,0,0,0,0,0,0,0,0,0,0,2015,post
Marcel de Jong,,D-M,0,0,0,0,0,0,0,0,0,0,0,0,0,0,0,2015,post
Pa-Modou Kah,,D,0,0,0,0,0,0,0,0,0,0,0,0,0,0,0,2015,post
Will Johnson,,D,1,0,1,0,0,0,0,0,0,0,0,0,0,0,0,2015,post
Hassoun Camara,,D,1,0,55,0,0,0,0,0,0,0,0,1,1,1,0,2015,post
Michael Parkhurst,,D,5,5,480,0,0,0,0,0,0,0,0,1,1,0,0,2015,post
Andy Dorman,,M,0,0,0,0,0,0,0,0,0,0,0,0,0,0,0,2015,post
Todd Dunivant,,D,0,0,0,0,0,0,0,0,0,0,0,0,0,0,0,2015,post
Jozy Altidore,,F,1,1,90,0,0,0,0,0,0,0,0,2,1,0,0,2015,post
Dane Richards,,M,0,0,0,0,0,0,0,0,0,0,0,0,0,0,0,2015,post
Paulo Nagamura,,M,1,1,120,0,0,0,0,0,0,0,0,5,2,0,0,2015,post
Mika Vayrynen,,M,0,0,0,0,0,0,0,0,0,0,0,0,0,0,0,2015,post
Emanuel Pogatetz,,D,0,0,0,0,0,0,0,0,0,0,0,0,0,0,0,2015,post
Benoit Cheyrou,,M,1,1,90,0,0,0,0,0,0,0,0,0,1,0,0,2015,post
Damien Perquis,,D,0,0,0,0,0,0,0,0,0,0,0,0,0,0,0,2015,post
Justin Mapp,,M,0,0,0,0,0,0,0,0,0,0,0,0,0,0,0,2015,post
Edson Buddle,,F,0,0,0,0,0,0,0,0,0,0,0,0,0,0,0,2015,post
Luke Moore,,F,0,0,0,0,0,0,0,0,0,0,0,0,0,0,0,2015,post
Eddie Johnson,,F,0,0,0,0,0,0,0,0,0,0,0,0,0,0,0,2015,post
Davy Arnaud,,M,0,0,0,0,0,0,0,0,0,0,0,0,0,0,0,2015,post
Kenny Cooper,,F,0,0,0,0,0,0,0,0,0,0,0,0,0,0,0,2015,post
Gonzalo Pineda,,M,0,0,0,0,0,0,0,0,0,0,0,0,0,0,0,2015,post
Mauro Rosales,,M,2,0,91,0,0,0,0,0,0,0,0,1,1,0,0,2015,post
José Gonçalves,,D,1,1,90,0,0,0,0,0,0,0,0,1,1,0,0,2015,post
Roman Torres,,D,0,0,0,0,0,0,0,0,0,0,0,0,0,0,0,2015,post
Roy Miller,,D,0,0,0,0,0,0,0,0,0,0,0,0,0,0,0,2015,post
Atiba Harris,,D,0,0,0,0,0,0,0,0,0,0,0,0,0,0,0,2015,post
Facundo Coria,,M,0,0,0,0,0,0,0,0,0,0,0,0,0,0,0,2015,post
Jared Jeffrey,,M,0,0,0,0,0,0,0,0,0,0,0,0,0,0,0,2015,post
Andres Romero,,M,0,0,0,0,0,0,0,0,0,0,0,0,0,0,0,2015,post
Chris Tierney,,D-M,1,1,90,0,0,0,0,0,0,0,0,0,1,0,0,2015,post
Rolando Escobar,,M,0,0,0,0,0,0,0,0,0,0,0,0,0,0,0,2015,post
Charlie Davies,,F,1,0,20,0,0,0,0,0,0,0,0,1,0,0,0,2015,post
Chance Myers,,D,0,0,0,0,0,0,0,0,0,0,0,0,0,0,0,2015,post
Roger Espinoza,,M,0,0,0,0,0,0,0,0,0,0,0,0,0,0,0,2015,post
Zach Scott,,D,3,2,264,0,0,0,0,0,0,0,0,1,3,0,0,2015,post
Darrius Barnes,,D,0,0,0,0,0,0,0,0,0,0,0,0,0,0,0,2015,post
Omar Gonzalez,,D,1,1,90,0,0,0,0,0,0,0,0,1,0,1,0,2015,post
Jeremy Hall,,D-M,0,0,0,0,0,0,0,0,0,0,0,0,0,0,0,2015,post
Osvaldo Alonso,,M,0,0,0,0,0,0,0,0,0,0,0,0,0,0,0,2015,post
Soni Mustivar,,M,1,1,120,0,0,0,0,0,0,0,0,2,3,0,0,2015,post
Baggio Husidic,,M,1,0,14,0,0,0,0,0,0,0,0,1,0,1,0,2015,post
Matt Besler,,D,1,1,120,0,0,0,0,0,0,0,0,0,1,0,0,2015,post
Amobi Okugo,,D-M,0,0,0,0,0,0,0,0,0,0,0,0,0,0,0,2015,post
Ike Opara,,D,0,0,0,0,0,0,0,0,0,0,0,0,0,0,0,2015,post
Daigo Kobayashi,,M,1,0,3,0,0,0,0,0,0,0,0,0,0,0,0,2015,post
Kristinn Steindorsson,,M,0,0,0,0,0,0,0,0,0,0,0,0,0,0,0,2015,post
Lamar Neagle,,M,0,0,0,0,0,0,0,0,0,0,0,0,0,0,0,2015,post
Leonardo González,,D,1,1,36,0,0,0,0,0,0,0,0,0,0,0,0,2015,post
Teal Bunbury,,F,1,0,39,0,0,0,0,0,0,0,0,0,1,0,0,2015,post
Seth Sinovic,,D,0,0,0,0,0,0,0,0,0,0,0,0,0,0,0,2015,post
Steven Beitashour,,D,2,2,172,0,0,0,0,0,0,0,0,1,2,1,0,2015,post
Zach Loyd,,D,3,3,264,0,0,0,0,0,0,0,0,0,3,0,0,2015,post
Ben Zemanski,,M,0,0,0,0,0,0,0,0,0,0,0,0,0,0,0,2015,post
Eric Alexander,,M,0,0,0,0,0,0,0,0,0,0,0,0,0,0,0,2015,post
Leonardo,,D,1,1,90,0,0,0,0,0,0,0,0,3,0,0,0,2015,post
Collen Warner,,M,0,0,0,0,0,0,0,0,0,0,0,0,0,0,0,2015,post
Michael Nanchoff,,M,0,0,0,0,0,0,0,0,0,0,0,0,0,0,0,2015,post
Moises Hernandez,,D,0,0,0,0,0,0,0,0,0,0,0,0,0,0,0,2015,post
Jalil Anibaba,,D,0,0,0,0,0,0,0,0,0,0,0,0,0,0,0,2015,post
Chris Korb,,D,0,0,0,0,0,0,0,0,0,0,0,0,0,0,0,2015,post
Michael Farfan,,M,0,0,0,0,0,0,0,0,0,0,0,0,0,0,0,2015,post
Josh Williams,,D,1,1,90,0,0,0,0,0,0,0,0,0,1,0,0,2015,post
Hector Jimenez,,M,0,0,0,0,0,0,0,0,0,0,0,0,0,0,0,2015,post
Russell Teibert,,M,1,1,90,0,0,0,0,0,0,0,0,2,0,0,0,2015,post
Ezequiel Cirigliano,,M,1,1,90,0,0,0,0,0,0,0,0,2,0,0,0,2015,post
Matias Laba,,M,2,2,180,0,0,0,0,0,0,0,0,4,1,0,0,2015,post
Conor Doyle,,F,1,0,25,0,0,0,0,0,0,0,0,1,0,0,0,2015,post
Nicolas Mezquida,,F-M,0,0,0,0,0,0,0,0,0,0,0,0,0,0,0,2015,post
Tyler Rudy,,M,0,0,0,0,0,0,0,0,0,0,0,0,0,0,0,2015,post
Connor Hallisey,,F,0,0,0,0,0,0,0,0,0,0,0,0,0,0,0,2015,post
Sean Davis,,M,0,0,0,0,0,0,0,0,0,0,0,0,0,0,0,2015,post
Christian Dean,,D,0,0,0,0,0,0,0,0,0,0,0,0,0,0,0,2015,post
Leo Stolz,,M,0,0,0,0,0,0,0,0,0,0,0,0,0,0,0,2015,post
Manolo Sanchez,,M,0,0,0,0,0,0,0,0,0,0,0,0,0,0,0,2015,post
Sean Okoli,,F,0,0,0,0,0,0,0,0,0,0,0,0,0,0,0,2015,post
Jalen Robinson,,D,0,0,0,0,0,0,0,0,0,0,0,0,0,0,0,2015,post
Chris Duvall,,D,0,0,0,0,0,0,0,0,0,0,0,0,0,0,0,2015,post
Collin Martin,,M,0,0,0,0,0,0,0,0,0,0,0,0,0,0,0,2015,post
Nick Hagglund,,D,0,0,0,0,0,0,0,0,0,0,0,0,0,0,0,2015,post
Chris Klute,,D,2,0,14,0,0,0,0,0,0,0,0,0,0,0,0,2015,post
Mikey Lopez,,M,0,0,0,0,0,0,0,0,0,0,0,0,0,0,0,2015,post
Danny Garcia,,M-F,0,0,0,0,0,0,0,0,0,0,0,0,0,0,0,2015,post
Andy Craven,,F,0,0,0,0,0,0,0,0,0,0,0,0,0,0,0,2015,post
Charlie Rugg,,F,0,0,0,0,0,0,0,0,0,0,0,0,0,0,0,2015,post
Kofi Opare,,D,2,2,171,0,0,0,0,0,0,0,0,3,2,0,0,2015,post
Andrew Farrell,,D,1,1,90,0,0,0,0,0,0,0,0,2,2,1,0,2015,post
Donnie Smith,,M,0,0,0,0,0,0,0,0,0,0,0,0,0,0,0,2015,post
Eriq Zavaleta,,D,1,0,45,0,0,0,0,0,0,0,0,0,0,0,0,2015,post
Dylan Remick,,D,0,0,0,0,0,0,0,0,0,0,0,0,0,0,0,2015,post
Diego Rodriguez,,D,0,0,0,0,0,0,0,0,0,0,0,0,0,0,0,2015,post
Oscar Sorto,,D,0,0,0,0,0,0,0,0,0,0,0,0,0,0,0,2015,post
Andres Correa,,D,0,0,0,0,0,0,0,0,0,0,0,0,0,0,0,2015,post
Chad Barson,,D,0,0,0,0,0,0,0,0,0,0,0,0,0,0,0,2015,post
Michael Seaton,,F,0,0,0,0,0,0,0,0,0,0,0,0,0,0,0,2015,post
Jordi Quintilla,,M,0,0,0,0,0,0,0,0,0,0,0,0,0,0,0,2015,post
Connor Lade,,D,0,0,0,0,0,0,0,0,0,0,0,0,0,0,0,2015,post
Rafael Garcia ,,D,0,0,0,0,0,0,0,0,0,0,0,0,0,0,0,2015,post
Kevan George,,M,2,0,9,0,0,0,0,0,0,0,0,0,0,0,0,2015,post
Matt Hedges,,D,4,4,390,0,0,0,0,0,0,0,0,6,1,0,0,2015,post
Thomas,,M,0,0,0,0,0,0,0,0,0,0,0,0,0,0,0,2015,post
Jordan Smith,,D,0,0,0,0,0,0,0,0,0,0,0,0,0,0,0,2015,post
Ashtone Morgan,,D,0,0,0,0,0,0,0,0,0,0,0,0,0,0,0,2015,post
Bernardo Añor,,M,0,0,0,0,0,0,0,0,0,0,0,0,0,0,0,2015,post
Diego Fagundez,,M,1,1,51,0,0,0,0,0,0,0,0,1,0,0,0,2015,post
Jose Villarreal,,M,0,0,0,0,0,0,0,0,0,0,0,0,0,0,0,2015,post
Caleb Clarke,,F,0,0,0,0,0,0,0,0,0,0,0,0,0,0,0,2015,post
Jay Chapman,,M,0,0,0,0,0,0,0,0,0,0,0,0,0,0,0,2015,post
Jordan Hamilton,,F,0,0,0,0,0,0,0,0,0,0,0,0,0,0,0,2015,post
Ben Speas,,M-F,0,0,0,0,0,0,0,0,0,0,0,0,0,0,0,2015,post
Mohammed Saeid,,M,2,0,16,0,0,0,0,0,0,0,0,0,1,0,0,2015,post
Marky Delgado,,M,1,0,20,0,0,0,0,0,0,0,0,1,1,1,0,2015,post
Jairo Arrieta,,F,1,0,22,0,0,0,0,0,0,0,0,3,0,0,0,2015,post
Darren Mattocks,,F,2,0,29,0,0,0,0,0,0,0,0,1,0,0,0,2015,post
Tommy Meyer,,D,0,0,0,0,0,0,0,0,0,0,0,0,0,0,0,2015,post
Kenney Walker,,M,0,0,0,0,0,0,0,0,0,0,0,0,0,0,0,2015,post
Aaron Schoenfeld ,,F,0,0,0,0,0,0,0,0,0,0,0,0,0,0,0,2015,post
London Woodberry,,D,0,0,0,0,0,0,0,0,0,0,0,0,0,0,0,2015,post
Karl Ouimette,,D,0,0,0,0,0,0,0,0,0,0,0,0,0,0,0,2015,post
Mark Bloom,,D,0,0,0,0,0,0,0,0,0,0,0,0,0,0,0,2015,post
George Fochive,,M,1,0,35,0,0,0,0,0,0,0,0,4,0,1,0,2015,post
Daniel Lovitz,,D,0,0,0,0,0,0,0,0,0,0,0,0,0,0,0,2015,post
Bradford Jamieson IV,,F,0,0,0,0,0,0,0,0,0,0,0,0,0,0,0,2015,post
Raul Mendiola,,M,0,0,0,0,0,0,0,0,0,0,0,0,0,0,0,2015,post
Jeremy Gagnon-Lapare,,M,0,0,0,0,0,0,0,0,0,0,0,0,0,0,0,2015,post
Aaron Kovar,,M,0,0,0,0,0,0,0,0,0,0,0,0,0,0,0,2015,post
Darwin Jones,,F,0,0,0,0,0,0,0,0,0,0,0,0,0,0,0,2015,post
Taylor Peay,,D,0,0,0,0,0,0,0,0,0,0,0,0,0,0,0,2015,post
Cristian Roldan,,M,3,0,60,0,0,0,0,0,0,0,0,0,1,0,0,2015,post
Andy Thoma,,D,0,0,0,0,0,0,0,0,0,0,0,0,0,0,0,2015,post
Marco Bustos,,M,0,0,0,0,0,0,0,0,0,0,0,0,0,0,0,2015,post
Kianz Froese,,M,0,0,0,0,0,0,0,0,0,0,0,0,0,0,0,2015,post
Alex Zendejas,,M,0,0,0,0,0,0,0,0,0,0,0,0,0,0,0,2015,post
Andre Lewis,,M,0,0,0,0,0,0,0,0,0,0,0,0,0,0,0,2015,post
Wandrille Lefevre,,D,0,0,0,0,0,0,0,0,0,0,0,0,0,0,0,2015,post
Maxim Tissot,,D,0,0,0,0,0,0,0,0,0,0,0,0,0,0,0,2015,post
Jonathan Osorio,,M,1,1,70,0,0,0,0,0,0,0,0,0,1,0,0,2015,post
Marius Obekop,,M,0,0,0,0,0,0,0,0,0,0,0,0,0,0,0,2015,post
Micheal Azira,,M,1,0,1,0,0,0,0,0,0,0,0,0,0,0,0,2015,post
Timi Mulgrew,,F,0,0,0,0,0,0,0,0,0,0,0,0,0,0,0,2015,post
Shawn McLaws,,M,0,0,0,0,0,0,0,0,0,0,0,0,0,0,0,2015,post
Damion Lowe,,D,0,0,0,0,0,0,0,0,0,0,0,0,0,0,0,2015,post
Steve Neumann,,M-F,0,0,0,0,0,0,0,0,0,0,0,0,0,0,0,2015,post
Jimmy Ockford,,D,0,0,0,0,0,0,0,0,0,0,0,0,0,0,0,2015,post
Erik Hurtado,,F,0,0,0,0,0,0,0,0,0,0,0,0,0,0,0,2015,post
Scott Caldwell,,M,1,1,87,0,0,0,0,0,0,0,0,2,1,0,0,2015,post
Eric Miller,,D,0,0,0,0,0,0,0,0,0,0,0,0,0,0,0,2015,post
Erik Palmer-Brown,,D,0,0,0,0,0,0,0,0,0,0,0,0,0,0,0,2015,post
Manny Aparicio,,M,0,0,0,0,0,0,0,0,0,0,0,0,0,0,0,2015,post
Jimmy Medranda ,,D,0,0,0,0,0,0,0,0,0,0,0,0,0,0,0,2015,post
Sam Adekugbe,,D,0,0,0,0,0,0,0,0,0,0,0,0,0,0,0,2015,post
Deybi Flores,,M,0,0,0,0,0,0,0,0,0,0,0,0,0,0,0,2015,post
Clément Simonin,,D,0,0,0,0,0,0,0,0,0,0,0,0,0,0,0,2015,post
Zachary Herivaux,,M,0,0,0,0,0,0,0,0,0,0,0,0,0,0,0,2015,post
Dave Romney,,D,0,0,0,0,0,0,0,0,0,0,0,0,0,0,0,2015,post
Luke Mishu,,D,0,0,0,0,0,0,0,0,0,0,0,0,0,0,0,2015,post
Anthony Manning,,D,0,0,0,0,0,0,0,0,0,0,0,0,0,0,0,2015,post
Ignacio Maganto,,M,0,0,0,0,0,0,0,0,0,0,0,0,0,0,0,2015,post
Oniel Fisher,,D,2,2,178,0,0,0,0,0,0,0,0,1,2,0,0,2015,post
Sergio Campbell,,D,0,0,0,0,0,0,0,0,0,0,0,0,0,0,0,2015,post
Saad Abdul-Salaam,,D,1,1,120,0,0,0,0,0,0,0,0,2,2,1,0,2015,post
Cameron Porter,,F,0,0,0,0,0,0,0,0,0,0,0,0,0,0,0,2015,post
Ethen Sampson,,D,0,0,0,0,0,0,0,0,0,0,0,0,0,0,0,2015,post
Jeanderson,,D,0,0,0,0,0,0,0,0,0,0,0,0,0,0,0,2015,post
Anthony Jackson-Hamel,,F,0,0,0,0,0,0,0,0,0,0,0,0,0,0,0,2015,post
Romario Williams,,F,0,0,0,0,0,0,0,0,0,0,0,0,0,0,0,2015,post
Coy Craft,,F-M,0,0,0,0,0,0,0,0,0,0,0,0,0,0,0,2015,post
Romain Gall,,M,0,0,0,0,0,0,0,0,0,0,0,0,0,0,0,2015,post
Kendall Waston,,D,2,2,180,0,0,0,0,0,0,0,0,3,2,0,0,2015,post
Chris Mannella,,M,0,0,0,0,0,0,0,0,0,0,0,0,0,0,0,2015,post
Victor Mansaray,,F,0,0,0,0,0,0,0,0,0,0,0,0,0,0,0,2015,post
Ben Swanson,,M,0,0,0,0,0,0,0,0,0,0,0,0,0,0,0,2015,post
Otis Earle,,D,0,0,0,0,0,0,0,0,0,0,0,0,0,0,0,2015,post
Nick Besler,,M,0,0,0,0,0,0,0,0,0,0,0,0,0,0,0,2015,post
Miguel Aguilar,,M,2,0,15,0,0,0,0,0,0,0,0,0,1,0,0,2015,post
Ben McKendry,,M,0,0,0,0,0,0,0,0,0,0,0,0,0,0,0,2015,post
Tim Parker,,D,2,2,180,0,0,1,0,0,0,0,0,1,2,0,0,2015,post
Taylor Kemp,,D,3,3,270,0,0,1,0,0,0,0,0,2,1,0,0,2015,post
Donny Toia,,D,3,3,300,0,0,1,0,0,0,0,0,5,2,0,0,2015,post
Kyle Bekker,,M,1,0,13,0,0,1,0,0,0,0,0,0,0,0,0,2015,post
Steven Birnbaum,,D,3,3,270,0,0,1,0,0,0,0,0,7,3,0,0,2015,post
Jackson Goncalves,,M,1,1,90,0,0,1,0,0,0,0,0,1,2,0,0,2015,post
Victor Ulloa,,M,4,4,319,0,0,1,1,0,0,0,0,5,3,0,0,2015,post
Tony Tchani,,M,5,5,408,0,0,1,0,0,0,0,0,5,7,0,0,2015,post
Justin Morrow,,D,1,1,90,0,0,1,0,0,0,0,0,1,0,0,0,2015,post
A.J. DeLaGarza,,D,1,1,83,0,0,1,0,0,0,0,0,2,1,0,0,2015,post
Michel Garbini Pereira,,M-D,1,0,4,0,0,1,0,0,0,0,0,0,0,0,0,2015,post
Markus Halsti,,M-D,3,3,270,0,0,1,0,0,0,0,0,5,3,1,0,2015,post
Pedro Morales,,M,2,1,103,0,0,1,0,0,0,0,0,1,3,0,0,2015,post
Norberto Paparatto,,D,3,1,142,0,0,1,1,0,0,0,0,1,1,0,0,2015,post
Michael Bradley,,M,1,1,90,0,0,1,0,0,0,0,0,1,0,0,0,2015,post
Lee Nguyen,,M,1,1,90,0,0,1,0,0,0,0,0,1,2,0,0,2015,post
Benny Feilhaber,,M,1,1,120,0,0,1,0,0,0,0,0,2,3,0,0,2015,post
Nigel Reo-Coker,,M,3,2,184,0,0,1,1,0,0,0,0,1,0,1,0,2015,post
Robbie Keane,,F,1,1,90,0,0,1,1,0,0,0,0,0,0,0,0,2015,post
Tyrone Mears,,D,3,3,300,0,0,1,0,0,0,0,0,4,1,0,0,2015,post
Jordan Harvey,,D,2,2,180,0,0,1,0,0,0,0,0,0,0,0,0,2015,post
Bobby Boswell,,D,2,2,180,0,0,1,1,0,0,0,0,2,1,1,0,2015,post
Jack Jewsbury,,M,6,3,328,0,0,1,0,0,0,0,0,2,1,0,0,2015,post
Tyson Wahl,,D,3,1,96,0,0,1,0,0,0,0,0,1,0,1,0,2015,post
Ronald Zubar,,D,4,3,309,0,0,1,0,0,0,0,0,3,0,1,0,2015,post
Robbie Rogers,,D,1,1,90,0,0,1,0,0,0,0,0,0,3,0,0,2015,post
Dominic Oduro,,M,2,1,67,0,0,1,1,0,0,0,0,0,1,0,0,2015,post
Alan Gordon,,F,1,0,7,0,0,1,0,0,0,0,0,1,1,0,0,2015,post
Steven Gerrard,,M,1,1,90,0,0,2,0,0,0,0,0,1,0,0,0,2015,post
Robert Earnshaw,,F,1,0,8,0,0,2,1,0,0,0,0,1,0,1,0,2015,post
Shaun Wright-Phillips,,M,2,0,23,0,0,2,0,0,0,0,0,1,2,0,0,2015,post
Sean Franklin,,D,2,2,174,0,0,2,1,0,0,0,0,2,3,0,0,2015,post
Gaston Sauro,,D,4,4,390,0,0,2,1,0,0,0,0,8,0,3,0,2015,post
Perry Kitchen,,M,3,3,270,0,0,2,0,0,0,0,0,6,7,1,0,2015,post
Kellyn Acosta,,M,3,3,300,0,0,2,1,0,0,0,0,5,4,2,0,2015,post
Calum Mallace,,M,3,1,162,0,0,2,0,0,0,0,0,0,0,0,0,2015,post
Andy Rose,,M,3,3,300,0,0,2,1,0,0,0,0,4,2,0,0,2015,post
Cristian Techera,,M,2,2,180,0,0,2,0,0,0,0,0,1,5,0,0,2015,post
Ambroise Oyongo,,D,3,3,265,0,0,2,1,0,0,0,0,4,2,1,0,2015,post
Alvas Powell,,D,6,6,570,0,0,2,0,0,0,0,0,8,4,1,0,2015,post
Kemar Lawrence,,D,4,4,342,0,0,3,0,0,0,0,0,2,4,0,0,2015,post
Kelyn Rowe,,M,1,1,90,0,0,3,2,0,0,0,0,3,0,0,0,2015,post
Wil Trapp,,M,5,5,480,0,0,3,1,0,0,0,0,6,8,0,0,2015,post
Gershon Koffie,,M,2,2,126,0,0,3,1,0,0,0,0,4,2,1,0,2015,post
Jack McInerney,,F,2,0,64,0,0,3,1,0,0,0,0,0,0,0,0,2015,post
Sal Zizzo,,D,4,4,360,0,0,3,1,0,0,0,0,3,1,1,0,2015,post
Dom Dwyer,,F,1,1,120,0,0,4,0,0,0,0,0,6,5,1,0,2015,post
Harrison Afful,,D,5,5,466,0,0,4,1,0,0,0,0,8,4,2,0,2015,post
Sebastian Giovinco,,F,1,1,90,0,0,5,2,0,0,0,0,0,3,0,0,2015,post
Obafemi Martins,,F,3,3,300,0,0,5,3,0,0,0,0,3,8,0,0,2015,post
Jermaine Jones,,M,1,1,89,0,0,5,1,0,0,0,0,2,2,1,1,2015,post
Alvaro Saborio,,F,3,2,194,0,0,5,0,0,0,0,0,11,3,1,0,2015,post
Kekuta Manneh,,F,2,2,103,0,0,5,2,0,0,0,0,1,3,0,0,2015,post
Matt Miazga,,D,4,4,360,0,0,6,1,0,0,0,0,3,4,1,0,2015,post
Octavio Rivero,,F,2,2,178,0,0,7,1,0,0,0,0,5,3,1,0,2015,post
Michael Barrios,,M,4,4,385,0,0,9,3,0,0,0,0,4,5,0,0,2015,post
Mike Grella,,M,4,4,277,0,0,9,5,0,0,0,0,3,5,0,0,2015,post
Felipe,,M,4,4,352,0,0,11,1,0,0,0,0,3,11,1,0,2015,post
Jozy Altidore,,F,6,6,581,5,4,16,11,3,2,2,2,17,15,1,0,2016,post
Sebastian Giovinco,,F,6,6,557,4,4,37,12,1,3,2,2,10,27,0,0,2016,post
Matteo Mancosu,,F,5,5,404,4,2,9,5,2,2,0,2,6,1,0,0,2016,post
Ignacio Piatti,,M,5,5,474,4,2,10,5,0,4,1,1,8,12,0,0,2016,post
Nicolás Lodeiro,,M,6,6,570,4,0,13,6,3,1,0,0,4,20,0,0,2016,post
Dominic Oduro,,M,5,5,464,2,3,7,5,1,1,1,2,1,8,0,0,2016,post
Jordan Morris,,F,6,6,501,2,1,8,4,1,1,1,0,3,4,0,0,2016,post
Nelson Valdez,,F,6,5,376,2,1,9,6,2,0,0,1,2,10,0,0,2016,post
Tosaint Ricketts,,F,6,0,134,2,1,11,6,2,0,0,1,1,1,0,0,2016,post
Emmanuel Boateng,,M,2,2,146,2,0,4,2,2,0,0,0,3,3,0,0,2016,post
Jonathan Osorio,,M,6,5,405,2,0,6,4,1,1,0,0,6,4,0,0,2016,post
Nick Hagglund,,D,6,6,600,1,2,5,2,1,0,1,1,5,1,0,0,2016,post
Alan Gordon,,F,3,3,203,1,2,5,1,1,0,2,0,4,2,0,0,2016,post
Giovani dos Santos,,M,3,3,292,1,1,3,1,1,0,1,0,3,7,0,0,2016,post
Ambroise Oyongo,,D,5,5,480,1,1,3,1,1,0,0,1,12,4,0,0,2016,post
Armando Cooper,,M,6,6,430,1,1,8,2,1,0,1,0,13,17,1,0,2016,post
Alejandro Bedoya,,M,1,1,90,1,0,1,1,0,1,0,0,2,0,1,0,2016,post
Lamar Neagle,,M,1,0,30,1,0,2,1,1,0,0,0,0,1,0,0,2016,post
Joao Plata,,F,1,1,90,1,0,2,1,0,1,0,0,0,1,0,0,2016,post
Michael Bradley,,M,6,6,600,1,0,2,1,0,1,0,0,6,6,2,0,2016,post
Taylor Kemp,,D,1,1,90,1,0,2,1,1,0,0,0,0,0,0,0,2016,post
Tesho Akindele,,F-M,2,1,114,1,0,3,1,1,0,0,0,3,3,0,0,2016,post
Benoit Cheyrou,,M,3,0,80,1,0,3,2,1,0,0,0,1,1,0,0,2016,post
Laurent Ciman,,D,5,5,480,1,0,4,1,0,1,0,0,7,3,2,0,2016,post
Bradley Wright-Phillips,,F,2,2,180,1,0,5,1,1,0,0,0,2,5,0,0,2016,post
Kevin Doyle,,F,4,4,370,1,0,6,1,0,1,0,0,7,4,1,0,2016,post
Maximiliano Urruti,,F,2,2,170,1,0,6,3,1,0,0,0,4,2,0,0,2016,post
Shkelzen Gashi,,M-F,4,4,298,1,0,9,1,1,0,0,0,7,1,1,0,2016,post
Joevin Jones,,D-M,6,6,563,0,3,1,0,0,0,3,0,5,7,1,0,2016,post
Steven Beitashour,,D,6,6,574,0,2,0,0,0,0,1,1,5,10,0,0,2016,post
Atiba Harris,,D,2,2,180,0,2,1,1,0,0,2,0,5,0,1,0,2016,post
Marco Donadel,,M,5,5,468,0,2,1,0,0,0,1,1,10,5,0,0,2016,post
Patrice Bernier,,M,5,5,415,0,2,2,0,0,0,2,0,4,2,0,0,2016,post
Landon Donovan,,M-F,3,3,222,0,1,0,0,0,0,1,0,2,3,0,0,2016,post
Ilsinho,,M,1,0,31,0,1,0,0,0,0,0,1,1,0,0,0,2016,post
Patrick Nyarko,,F-M,1,1,90,0,1,0,0,0,0,1,0,1,3,0,0,2016,post
Richie Marquez,,D,1,1,90,0,1,0,0,0,0,0,1,0,0,0,0,2016,post
Justin Morrow,,D,6,6,600,0,1,1,1,0,0,1,0,3,3,0,0,2016,post
Tyrone Mears,,D,6,6,570,0,1,1,0,0,0,0,1,5,5,0,0,2016,post
Mauro Rosales,,M,2,1,91,0,1,1,0,0,0,1,0,1,4,0,0,2016,post
Will Johnson,,D,6,1,211,0,1,2,0,0,0,0,1,2,5,0,0,2016,post
Daniel Royer,,M,1,0,37,0,1,2,0,0,0,1,0,1,0,0,0,2016,post
Eriq Zavaleta,,D,6,6,600,0,1,2,0,0,0,0,1,9,0,0,0,2016,post
Michael Barrios,,M,2,2,164,0,1,3,1,0,0,1,0,1,2,0,0,2016,post
Damien Perrinelle,,D,2,2,180,0,1,3,1,0,0,1,0,1,0,0,0,2016,post
Sam Cronin,,M,3,3,300,0,1,3,0,0,0,1,0,7,2,2,0,2016,post
Didier Drogba,,F,3,0,76,0,1,3,1,0,0,0,1,0,3,0,0,2016,post
Jelle Van Damme,,D,3,3,300,0,1,4,0,0,0,1,0,2,6,1,0,2016,post
Jermaine Jones,,M,4,3,308,0,1,7,2,0,0,0,1,8,11,1,0,2016,post
Johan Venegas,,M,5,0,108,0,1,7,2,0,0,0,1,2,2,1,0,2016,post
Justen Glad,,D,1,1,90,0,0,0,0,0,0,0,0,1,0,0,0,2016,post
Anthony Jackson-Hamel,,F,0,0,0,0,0,0,0,0,0,0,0,0,0,0,0,2016,post
Romario Williams,,F,0,0,0,0,0,0,0,0,0,0,0,0,0,0,0,2016,post
Victor Cabrera,,D,5,5,480,0,0,0,0,0,0,0,0,11,3,0,0,2016,post
Coy Craft,,F-M,0,0,0,0,0,0,0,0,0,0,0,0,0,0,0,2016,post
Getterson,,F,0,0,0,0,0,0,0,0,0,0,0,0,0,0,0,2016,post
Omar Holness,,M,0,0,0,0,0,0,0,0,0,0,0,0,0,0,0,2016,post
Chris Mannella,,M,0,0,0,0,0,0,0,0,0,0,0,0,0,0,0,2016,post
Justin Bilyeu,,D,0,0,0,0,0,0,0,0,0,0,0,0,0,0,0,2016,post
Victor Mansaray,,F,0,0,0,0,0,0,0,0,0,0,0,0,0,0,0,2016,post
Khiry Shelton,,F,2,0,57,0,0,0,0,0,0,0,0,0,1,0,0,2016,post
Tyler Adams,,M,0,0,0,0,0,0,0,0,0,0,0,0,0,0,0,2016,post
Auston Trusty,,D,0,0,0,0,0,0,0,0,0,0,0,0,0,0,0,2016,post
Josh Yaro,,D,0,0,0,0,0,0,0,0,0,0,0,0,0,0,0,2016,post
Miguel Aguilar,,M,0,0,0,0,0,0,0,0,0,0,0,0,0,0,0,2016,post
Luke Mishu,,D,0,0,0,0,0,0,0,0,0,0,0,0,0,0,0,2016,post
Alhaji Kamara,,F,0,0,0,0,0,0,0,0,0,0,0,0,0,0,0,2016,post
Daniel Lovitz,,D,0,0,0,0,0,0,0,0,0,0,0,0,0,0,0,2016,post
Bradford Jamieson IV,,F,0,0,0,0,0,0,0,0,0,0,0,0,0,0,0,2016,post
Raul Mendiola,,M,0,0,0,0,0,0,0,0,0,0,0,0,0,0,0,2016,post
Jimmy Medranda ,,D,1,0,1,0,0,0,0,0,0,0,0,0,0,0,0,2016,post
Lucas Ontivero,,M,0,0,0,0,0,0,0,0,0,0,0,0,0,0,0,2016,post
Gideon Baah,,D,0,0,0,0,0,0,0,0,0,0,0,0,0,0,0,2016,post
Darwin Jones,,F,0,0,0,0,0,0,0,0,0,0,0,0,0,0,0,2016,post
Jeremy Gagnon-Lapare,,M,0,0,0,0,0,0,0,0,0,0,0,0,0,0,0,2016,post
Aaron Kovar,,M,0,0,0,0,0,0,0,0,0,0,0,0,0,0,0,2016,post
Oniel Fisher,,D,3,0,68,0,0,0,0,0,0,0,0,1,1,0,0,2016,post
Saad Abdul-Salaam,,D,1,1,90,0,0,0,0,0,0,0,0,3,0,0,0,2016,post
Cameron Porter,,F,0,0,0,0,0,0,0,0,0,0,0,0,0,0,0,2016,post
Fabian Herbers,,F,1,1,59,0,0,0,0,0,0,0,0,1,0,0,0,2016,post
Cole Missimo,,M,0,0,0,0,0,0,0,0,0,0,0,0,0,0,0,2016,post
Shannon Gomez,,D,0,0,0,0,0,0,0,0,0,0,0,0,0,0,0,2016,post
Molham Babouli,,F,0,0,0,0,0,0,0,0,0,0,0,0,0,0,0,2016,post
Paxton Pomykal,,M,0,0,0,0,0,0,0,0,0,0,0,0,0,0,0,2016,post
Pedro Baez,,F,0,0,0,0,0,0,0,0,0,0,0,0,0,0,0,2016,post
David Choiniere,,M,0,0,0,0,0,0,0,0,0,0,0,0,0,0,0,2016,post
Derrick Jones,,M,0,0,0,0,0,0,0,0,0,0,0,0,0,0,0,2016,post
Joseph Greenspan,,D,0,0,0,0,0,0,0,0,0,0,0,0,0,0,0,2016,post
Anatole Abang,,F,0,0,0,0,0,0,0,0,0,0,0,0,0,0,0,2016,post
Eric Ayuk,,M,0,0,0,0,0,0,0,0,0,0,0,0,0,0,0,2016,post
Amadou Dia,,D,0,0,0,0,0,0,0,0,0,0,0,0,0,0,0,2016,post
Clément Simonin,,D,0,0,0,0,0,0,0,0,0,0,0,0,0,0,0,2016,post
Ariel Lassiter,,F,0,0,0,0,0,0,0,0,0,0,0,0,0,0,0,2016,post
Oalex Anderson,,F,0,0,0,0,0,0,0,0,0,0,0,0,0,0,0,2016,post
Chris Durkin,,M,0,0,0,0,0,0,0,0,0,0,0,0,0,0,0,2016,post
Dave Romney,,D,0,0,0,0,0,0,0,0,0,0,0,0,0,0,0,2016,post
Emmanuel Appiah,,M,0,0,0,0,0,0,0,0,0,0,0,0,0,0,0,2016,post
Colin Bonner,,F,0,0,0,0,0,0,0,0,0,0,0,0,0,0,0,2016,post
Timo Pitter,,M-F,0,0,0,0,0,0,0,0,0,0,0,0,0,0,0,2016,post
Derrick Etienne Jr.,,M,0,0,0,0,0,0,0,0,0,0,0,0,0,0,0,2016,post
Alex Muyl,,M,2,2,135,0,0,0,0,0,0,0,0,4,3,0,0,2016,post
Danilo Acosta,,D,0,0,0,0,0,0,0,0,0,0,0,0,0,0,0,2016,post
Tony Alfaro,,D,0,0,0,0,0,0,0,0,0,0,0,0,0,0,0,2016,post
Taylor Washington,,D,0,0,0,0,0,0,0,0,0,0,0,0,0,0,0,2016,post
Aaron Guillen,,D,0,0,0,0,0,0,0,0,0,0,0,0,0,0,0,2016,post
Dylan Remick,,D,0,0,0,0,0,0,0,0,0,0,0,0,0,0,0,2016,post
Emery Welshman,,F,0,0,0,0,0,0,0,0,0,0,0,0,0,0,0,2016,post
Dillon Serna,,M,0,0,0,0,0,0,0,0,0,0,0,0,0,0,0,2016,post
Leo Fernandes,,M,0,0,0,0,0,0,0,0,0,0,0,0,0,0,0,2016,post
Collin Martin,,M,0,0,0,0,0,0,0,0,0,0,0,0,0,0,0,2016,post
Fabinho,,D,1,1,90,0,0,0,0,0,0,0,0,1,1,0,0,2016,post
Jefferson Mena,,D,0,0,0,0,0,0,0,0,0,0,0,0,0,0,0,2016,post
Benji Joya,,M,0,0,0,0,0,0,0,0,0,0,0,0,0,0,0,2016,post
Boyd Okwuonu,,D,0,0,0,0,0,0,0,0,0,0,0,0,0,0,0,2016,post
Mikey Lopez,,M,1,1,61,0,0,0,0,0,0,0,0,3,0,1,0,2016,post
Diego Martinez,,D,0,0,0,0,0,0,0,0,0,0,0,0,0,0,0,2016,post
Juan Esteban Ortiz,,M,0,0,0,0,0,0,0,0,0,0,0,0,0,0,0,2016,post
Dennis Castillo,,D,0,0,0,0,0,0,0,0,0,0,0,0,0,0,0,2016,post
Tsubasa Endoh,,M,0,0,0,0,0,0,0,0,0,0,0,0,0,0,0,2016,post
Kyle Bekker,,M,0,0,0,0,0,0,0,0,0,0,0,0,0,0,0,2016,post
Carlos Gruezo,,M,2,2,180,0,0,0,0,0,0,0,0,6,0,0,0,2016,post
Oscar Sorto,,D,0,0,0,0,0,0,0,0,0,0,0,0,0,0,0,2016,post
Gyasi Zardes,,F,0,0,0,0,0,0,0,0,0,0,0,0,0,0,0,2016,post
Wandrille Lefevre,,D,1,0,6,0,0,0,0,0,0,0,0,0,0,0,0,2016,post
Kofi Opare,,D,0,0,0,0,0,0,0,0,0,0,0,0,0,0,0,2016,post
Devon Sandoval,,F,0,0,0,0,0,0,0,0,0,0,0,0,0,0,0,2016,post
Ken Tribbett,,D,1,1,90,0,0,0,0,0,0,0,0,2,0,1,0,2016,post
Walter Restrepo,,M,0,0,0,0,0,0,0,0,0,0,0,0,0,0,0,2016,post
Ricardo Velazco,,F,0,0,0,0,0,0,0,0,0,0,0,0,0,0,0,2016,post
Aaron Long,,D,0,0,0,0,0,0,0,0,0,0,0,0,0,0,0,2016,post
Connor Brandt,,M-D,0,0,0,0,0,0,0,0,0,0,0,0,0,0,0,2016,post
Eric Miller,,D,4,4,390,0,0,0,0,0,0,0,0,2,3,0,0,2016,post
Michael Salazar,,F,0,0,0,0,0,0,0,0,0,0,0,0,0,0,0,2016,post
Caleb Calvert,,F,0,0,0,0,0,0,0,0,0,0,0,0,0,0,0,2016,post
Daniel Steres ,,D,3,3,300,0,0,0,0,0,0,0,0,2,2,0,0,2016,post
Jose Villarreal,,M,0,0,0,0,0,0,0,0,0,0,0,0,0,0,0,2016,post
Jay Chapman,,M,0,0,0,0,0,0,0,0,0,0,0,0,0,0,0,2016,post
Jordan Hamilton,,F,0,0,0,0,0,0,0,0,0,0,0,0,0,0,0,2016,post
Marky Delgado,,M,1,0,2,0,0,0,0,0,0,0,0,0,0,0,0,2016,post
Rafael Garcia ,,D,0,0,0,0,0,0,0,0,0,0,0,0,0,0,0,2016,post
Raymon Gaddis,,D,0,0,0,0,0,0,0,0,0,0,0,0,0,0,0,2016,post
Anderson Conceicao,,D,0,0,0,0,0,0,0,0,0,0,0,0,0,0,0,2016,post
Diego Rubio,,F,0,0,0,0,0,0,0,0,0,0,0,0,0,0,0,2016,post
Ever Alvarado,,D,0,0,0,0,0,0,0,0,0,0,0,0,0,0,0,2016,post
Lawrence Olum,,D,0,0,0,0,0,0,0,0,0,0,0,0,0,0,0,2016,post
Connor Lade,,D,0,0,0,0,0,0,0,0,0,0,0,0,0,0,0,2016,post
Warren Creavalle,,M,1,1,90,0,0,0,0,0,0,0,0,0,3,0,0,2016,post
Sean Davis,,M,0,0,0,0,0,0,0,0,0,0,0,0,0,0,0,2016,post
Phanuel Kavita,,D,0,0,0,0,0,0,0,0,0,0,0,0,0,0,0,2016,post
Kyle Fisher,,D,0,0,0,0,0,0,0,0,0,0,0,0,0,0,0,2016,post
Jared Watts,,D-M,4,4,390,0,0,0,0,0,0,0,0,3,3,1,0,2016,post
Jalen Robinson,,D,0,0,0,0,0,0,0,0,0,0,0,0,0,0,0,2016,post
John Stertzer,,M,0,0,0,0,0,0,0,0,0,0,0,0,0,0,0,2016,post
Karl Ouimette,,D,0,0,0,0,0,0,0,0,0,0,0,0,0,0,0,2016,post
Mark Bloom,,D,2,0,26,0,0,0,0,0,0,0,0,1,1,0,0,2016,post
Brandon Allen,,F,0,0,0,0,0,0,0,0,0,0,0,0,0,0,0,2016,post
Keegan Rosenberry,,D,1,1,84,0,0,0,0,0,0,0,0,0,0,0,0,2016,post
Connor Hallisey,,F,0,0,0,0,0,0,0,0,0,0,0,0,0,0,0,2016,post
Sean St. Ledger,,D,0,0,0,0,0,0,0,0,0,0,0,0,0,0,0,2016,post
Clint Dempsey,,M-F,0,0,0,0,0,0,0,0,0,0,0,0,0,0,0,2016,post
Brian Carroll,,M,0,0,0,0,0,0,0,0,0,0,0,0,0,0,0,2016,post
Chris Rolfe,,F,0,0,0,0,0,0,0,0,0,0,0,0,0,0,0,2016,post
Alvaro Saborio,,F,0,0,0,0,0,0,0,0,0,0,0,0,0,0,0,2016,post
Justin Mapp,,M,0,0,0,0,0,0,0,0,0,0,0,0,0,0,0,2016,post
Brad Davis,,M,0,0,0,0,0,0,0,0,0,0,0,0,0,0,0,2016,post
Ashley Cole,,D,3,3,300,0,0,0,0,0,0,0,0,2,2,1,0,2016,post
Andrea Pirlo,,M,1,1,74,0,0,0,0,0,0,0,0,1,2,0,0,2016,post
Shaun Wright-Phillips,,M,0,0,0,0,0,0,0,0,0,0,0,0,0,0,0,2016,post
Steven Gerrard,,M,1,0,44,0,0,0,0,0,0,0,0,1,1,0,0,2016,post
Ronald Zubar,,D,0,0,0,0,0,0,0,0,0,0,0,0,0,0,0,2016,post
Brad Evans,,D-M,5,0,61,0,0,0,0,0,0,0,0,0,1,0,0,2016,post
Marc Burch,,D,4,4,390,0,0,0,0,0,0,0,0,4,1,2,0,2016,post
Bobby Boswell,,D,1,1,90,0,0,0,0,0,0,0,0,0,0,0,0,2016,post
Maurice Edu,,M,0,0,0,0,0,0,0,0,0,0,0,0,0,0,0,2016,post
Jeff Larentowicz,,M,3,0,86,0,0,0,0,0,0,0,0,0,2,0,0,2016,post
Sunday Stephen,,M,1,1,90,0,0,0,0,0,0,0,0,4,0,1,0,2016,post
Charlie Davies,,F,1,0,6,0,0,0,0,0,0,0,0,0,0,0,0,2016,post
Jason Hernandez,,D,0,0,0,0,0,0,0,0,0,0,0,0,0,0,0,2016,post
Nathan Sturgis,,M,0,0,0,0,0,0,0,0,0,0,0,0,0,0,0,2016,post
Bobby Burling,,D,0,0,0,0,0,0,0,0,0,0,0,0,0,0,0,2016,post
Mehdi Ballouchy,,M,0,0,0,0,0,0,0,0,0,0,0,0,0,0,0,2016,post
Hérculez Gómez,,F,2,0,66,0,0,0,0,0,0,0,0,2,1,0,0,2016,post
Jacob Peterson,,F,1,0,1,0,0,0,0,0,0,0,0,0,0,0,0,2016,post
A.J. DeLaGarza,,D,0,0,0,0,0,0,0,0,0,0,0,0,0,0,0,2016,post
Mix Diskerud,,M,0,0,0,0,0,0,0,0,0,0,0,0,0,0,0,2016,post
Zach Scott,,D,3,2,182,0,0,0,0,0,0,0,0,1,0,0,0,2016,post
Chance Myers,,D,0,0,0,0,0,0,0,0,0,0,0,0,0,0,0,2016,post
Mauro Diaz,,M,0,0,0,0,0,0,0,0,0,0,0,0,0,0,0,2016,post
Mike Grella,,M,2,1,104,0,0,0,0,0,0,0,0,1,1,0,0,2016,post
Matt Besler,,D,1,1,90,0,0,0,0,0,0,0,0,0,1,0,0,2016,post
Sean Franklin,,D,0,0,0,0,0,0,0,0,0,0,0,0,0,0,0,2016,post
Tony Beltran,,D,0,0,0,0,0,0,0,0,0,0,0,0,0,0,0,2016,post
Jámison Olave,,D,0,0,0,0,0,0,0,0,0,0,0,0,0,0,0,2016,post
Álvaro Fernández,,M,3,1,179,0,0,0,0,0,0,0,0,2,5,0,0,2016,post
Jared Jeffrey,,M,1,1,45,0,0,0,0,0,0,0,0,0,0,0,0,2016,post
Andres Romero,,M,0,0,0,0,0,0,0,0,0,0,0,0,0,0,0,2016,post
Aurelien Collin,,D,2,2,180,0,0,0,0,0,0,0,0,0,4,0,0,2016,post
Javier Morales,,M,1,1,68,0,0,0,0,0,0,0,0,4,1,0,0,2016,post
Demar Phillips,,D,1,1,90,0,0,0,0,0,0,0,0,3,1,1,0,2016,post
Norberto Paparatto,,D,0,0,0,0,0,0,0,0,0,0,0,0,0,0,0,2016,post
Juan Manuel Martínez,,M-F,1,1,58,0,0,0,0,0,0,0,0,1,5,0,0,2016,post
Nuno Andre Coelho,,D,0,0,0,0,0,0,0,0,0,0,0,0,0,0,0,2016,post
Soni Mustivar,,M,1,1,90,0,0,0,0,0,0,0,0,0,0,0,0,2016,post
Roland Alberg,,M,1,0,20,0,0,0,0,0,0,0,0,0,1,0,0,2016,post
Conor Doyle,,F,0,0,0,0,0,0,0,0,0,0,0,0,0,0,0,2016,post
Zach Pfeffer,,M,0,0,0,0,0,0,0,0,0,0,0,0,0,0,0,2016,post
Josh Williams,,D,0,0,0,0,0,0,0,0,0,0,0,0,0,0,0,2016,post
Chris Korb,,D,0,0,0,0,0,0,0,0,0,0,0,0,0,0,0,2016,post
Michael Farfan,,M,0,0,0,0,0,0,0,0,0,0,0,0,0,0,0,2016,post
Ethan White,,D,0,0,0,0,0,0,0,0,0,0,0,0,0,0,0,2016,post
Ashtone Morgan,,D,0,0,0,0,0,0,0,0,0,0,0,0,0,0,0,2016,post
Donny Toia,,D,1,0,9,0,0,0,0,0,0,0,0,1,0,0,0,2016,post
Moises Hernandez,,D,0,0,0,0,0,0,0,0,0,0,0,0,0,0,0,2016,post
Jack McBean,,F,0,0,0,0,0,0,0,0,0,0,0,0,0,0,0,2016,post
Zach Loyd,,D,0,0,0,0,0,0,0,0,0,0,0,0,0,0,0,2016,post
Aaron Maund,,D,0,0,0,0,0,0,0,0,0,0,0,0,0,0,0,2016,post
Ike Opara,,D,0,0,0,0,0,0,0,0,0,0,0,0,0,0,0,2016,post
Kennedy Igboananike,,F,0,0,0,0,0,0,0,0,0,0,0,0,0,0,0,2016,post
Leonardo,,D,0,0,0,0,0,0,0,0,0,0,0,0,0,0,0,2016,post
Marcelo Sarvas,,M,1,0,45,0,0,0,0,0,0,0,0,0,0,0,0,2016,post
Kevin Kratz,,M,0,0,0,0,0,0,0,0,0,0,0,0,0,0,0,2016,post
Aubrey David,,D,0,0,0,0,0,0,0,0,0,0,0,0,0,0,0,2016,post
Mekeil Williams,,D,0,0,0,0,0,0,0,0,0,0,0,0,0,0,0,2016,post
Omer Damari,,F,1,0,7,0,0,1,1,0,0,0,0,1,0,0,1,2016,post
Seth Sinovic,,D,1,1,89,0,0,1,1,0,0,0,0,3,1,1,0,2016,post
Kevin Ellis,,D,1,1,90,0,0,1,1,0,0,0,0,1,1,0,0,2016,post
CJ Sapong,,F,1,1,70,0,0,1,1,0,0,0,0,2,2,1,0,2016,post
Victor Ulloa,,M,1,1,66,0,0,1,0,0,0,0,0,0,0,0,0,2016,post
Tony Taylor,,F-M,2,0,38,0,0,1,0,0,0,0,0,1,1,0,0,2016,post
Marco Pappa,,M,2,0,25,0,0,1,0,0,0,0,0,1,0,0,0,2016,post
Dom Dwyer,,F,1,1,90,0,0,1,0,0,0,0,0,2,4,0,0,2016,post
Chris Wingert,,D,1,1,74,0,0,1,1,0,0,0,0,1,0,1,0,2016,post
Yura Movsisyan,,F,1,0,32,0,0,1,1,0,0,0,0,0,0,0,0,2016,post
Robbie Rogers,,D,3,3,300,0,0,1,0,0,0,0,0,4,8,0,0,2016,post
Lloyd Sam,,M-F,1,1,60,0,0,1,0,0,0,0,0,1,3,0,0,2016,post
Andoni Iraola,,D,2,2,180,0,0,1,0,0,0,0,0,2,2,0,0,2016,post
Chris Duvall,,D,2,2,180,0,0,1,0,0,0,0,0,2,5,0,0,2016,post
Gonzalo Verón,,M-F,2,1,107,0,0,1,0,0,0,0,0,1,3,0,0,2016,post
Steven Mendoza,,F,1,1,86,0,0,1,0,0,0,0,0,3,2,0,0,2016,post
Carlos Lizarazo,,M-F,1,0,16,0,0,1,1,0,0,0,0,0,0,0,0,2016,post
Federico Bravo,,M,2,1,106,0,0,1,0,0,0,0,0,2,2,1,0,2016,post
Olmes Garcia,,F,1,1,90,0,0,1,1,0,0,0,0,3,2,0,0,2016,post
Walker Zimmerman,,D,2,2,135,0,0,1,0,0,0,0,0,2,0,0,0,2016,post
Jack Harrison,,F,2,2,180,0,0,1,0,0,0,0,0,1,2,1,0,2016,post
Axel Sjöberg,,D,4,4,390,0,0,1,1,0,0,0,0,5,0,0,0,2016,post
Cristian Roldan,,M,6,6,570,0,0,1,0,0,0,0,0,7,13,1,0,2016,post
Micheal Azira,,M,3,2,175,0,0,1,0,0,0,0,0,2,0,0,0,2016,post
Kemar Lawrence,,D,1,1,89,0,0,1,0,0,0,0,0,0,0,0,0,2016,post
Thomas McNamara,,M,1,1,56,0,0,1,0,0,0,0,0,1,1,0,0,2016,post
Harry Shipp,,M,2,0,18,0,0,1,0,0,0,0,0,0,0,0,0,2016,post
Luciano Acosta,,M-F,1,1,65,0,0,1,0,0,0,0,0,1,1,0,0,2016,post
Luke Mulholland,,M,1,0,22,0,0,2,0,0,0,0,0,1,0,0,0,2016,post
Matt Hedges,,D,2,2,180,0,0,2,0,0,0,0,0,1,0,0,0,2016,post
Calum Mallace,,M,3,0,65,0,0,2,1,0,0,0,0,1,1,0,0,2016,post
Nick DeLeon,,M,1,1,90,0,0,2,0,0,0,0,0,0,0,0,0,2016,post
Julian Buescher,,M,1,0,25,0,0,2,0,0,0,0,0,1,0,0,0,2016,post
Patrick Mullins,,F,1,1,90,0,0,2,0,0,0,0,0,2,2,0,0,2016,post
Frederic Brillant,,D,2,2,180,0,0,2,1,0,0,0,0,2,1,0,0,2016,post
Tranquillo Barnetta,,M,1,1,90,0,0,2,1,0,0,0,0,5,2,0,0,2016,post
Chad Marshall,,D,6,6,570,0,0,2,0,0,0,0,0,4,3,1,0,2016,post
Benny Feilhaber,,M,1,1,90,0,0,2,2,0,0,0,0,5,0,1,0,2016,post
Carlos Ruiz,,F,2,0,38,0,0,2,0,0,0,0,0,1,0,0,0,2016,post
Robbie Keane,,F,3,0,105,0,0,2,1,0,0,0,0,1,3,0,0,2016,post
Hassoun Camara,,D,5,5,471,0,0,2,1,0,0,0,0,11,6,2,0,2016,post
Mike Magee,,M,3,1,110,0,0,2,1,0,0,0,0,1,1,0,0,2016,post
Paulo Nagamura,,M,1,1,89,0,0,2,2,0,0,0,0,0,2,0,0,2016,post
Drew Moor,,D,6,6,600,0,0,2,2,0,0,0,0,5,1,0,0,2016,post
Sal Zizzo,,D,2,1,91,0,0,2,1,0,0,0,0,0,1,0,0,2016,post
Baggio Husidic,,M,3,3,292,0,0,2,1,0,0,0,0,4,5,2,0,2016,post
Maxime Chanot,,D,2,2,180,0,0,2,0,0,0,0,0,5,0,1,0,2016,post
Roger Espinoza,,M,1,1,90,0,0,2,1,0,0,0,0,3,3,1,0,2016,post
Chris Schuler,,D,1,1,90,0,0,2,0,0,0,0,0,0,1,0,0,2016,post
Dillon Powers,,M,3,2,172,0,0,3,0,0,0,0,0,1,3,0,0,2016,post
Graham Zusi,,M,1,1,90,0,0,3,0,0,0,0,0,1,0,0,0,2016,post
Felipe,,M,2,2,149,0,0,3,0,0,0,0,0,3,3,2,0,2016,post
Erik Friberg,,M,5,5,381,0,0,3,2,0,0,0,0,5,2,0,0,2016,post
Dax McCarty,,M,2,2,180,0,0,3,0,0,0,0,0,3,4,1,0,2016,post
Kyle Beckerman,,M,1,1,90,0,0,3,1,0,0,0,0,1,1,0,0,2016,post
Andreas Ivanschitz,,M,3,1,110,0,0,3,0,0,0,0,0,2,0,0,0,2016,post
Steven Birnbaum,,D,1,1,90,0,0,3,2,0,0,0,0,1,1,0,0,2016,post
Kellyn Acosta,,M,2,2,180,0,0,3,0,0,0,0,0,2,1,0,0,2016,post
Rob Vincent,,M-F,1,1,90,0,0,3,0,0,0,0,0,1,1,0,0,2016,post
Marlon Hairston,,M,4,0,146,0,0,3,0,0,0,0,0,0,3,0,0,2016,post
Ronald Matarrita,,D,2,2,180,0,0,3,0,0,0,0,0,3,1,0,0,2016,post
Ryan Hollingshead,,M,2,1,106,0,0,4,1,0,0,0,0,0,0,0,0,2016,post
RJ Allen,,D,2,2,135,0,0,4,2,0,0,0,0,3,1,0,0,2016,post
David Villa,,F,2,2,168,0,0,4,3,0,0,0,0,2,3,0,0,2016,post
Frank Lampard,,M,2,1,119,0,0,4,1,0,0,0,0,1,1,1,0,2016,post
Sacha Kljestan,,M,2,2,180,0,0,4,3,0,0,0,0,2,7,1,0,2016,post
Hernan Bernardello,,M,5,5,382,0,0,4,1,0,0,0,0,10,6,0,0,2016,post
Chris Pontius,,M,1,1,90,0,0,4,0,0,0,0,0,2,0,0,0,2016,post
Sebastian Lletget,,M,3,3,300,0,0,4,1,0,0,0,0,7,4,0,0,2016,post
Sébastien Le Toux,,F,3,3,269,0,0,5,3,0,0,0,0,4,0,0,0,2016,post
Roman Torres,,D,4,4,390,0,0,6,0,0,0,0,0,8,1,1,0,2016,post
Osvaldo Alonso,,M,6,6,543,0,0,6,1,0,0,0,0,12,15,1,0,2016,post
Maynor Figueroa,,D,2,2,180,0,0,8,1,0,0,0,0,4,1,1,0,2016,post
Dominique Badji,,F,4,3,277,0,0,8,4,0,0,0,0,7,6,1,0,2016,post
Clint Dempsey,,M-F,4,4,284,3,0,16,5,3,0,0,0,1,4,0,0,2017,post
Will Bruin,,F,5,5,448,2,2,6,4,1,1,2,0,4,1,0,0,2017,post
Daniel Royer,,M,3,3,263,2,1,6,2,1,1,0,1,2,2,0,0,2017,post
Bradley Wright-Phillips,,F,3,3,257,2,1,6,3,0,2,0,1,4,6,1,0,2017,post
Victor Vazquez,,M,5,5,425,2,1,8,5,1,1,1,0,5,6,1,0,2017,post
Nicolas Mezquida,,F-M,2,0,23,2,0,2,2,2,0,0,0,0,0,0,0,2017,post
Jozy Altidore,,F,4,4,285,2,0,6,4,2,0,0,0,7,6,1,1,2017,post
David Villa,,F,2,2,180,2,0,15,4,1,1,0,0,1,2,0,0,2017,post
Victor Rodriguez,,M,4,2,229,1,2,4,2,1,0,2,0,3,2,0,0,2017,post
Cristian Techera,,M,3,2,153,1,1,2,1,1,0,1,0,2,5,1,0,2017,post
Sacha Kljestan,,M,3,3,225,1,1,3,2,0,1,0,1,1,4,1,1,2017,post
Kendall Waston,,D,3,3,270,1,1,4,1,1,0,1,0,1,1,1,0,2017,post
Ola Kamara,,F,5,5,466,1,1,9,2,1,0,1,0,7,5,0,0,2017,post
Justin Meram,,M,5,5,398,1,1,9,2,1,0,1,0,3,4,0,0,2017,post
Sebastian Giovinco,,F,4,4,360,1,1,13,6,0,1,1,0,6,19,2,0,2017,post
Andraz Struna,,D,2,1,98,1,0,1,1,1,0,0,0,1,0,0,0,2017,post
Dylan Remick,,D,3,2,211,1,0,1,1,0,1,0,0,1,1,0,0,2017,post
Artur,,M,3,3,299,1,0,2,1,1,0,0,0,7,2,2,0,2017,post
Gustav Svensson,,M,5,3,326,1,0,2,1,0,1,0,0,5,0,0,0,2017,post
Gonzalo Verón,,M-F,3,1,120,1,0,4,2,0,1,0,0,2,1,1,0,2017,post
Dairon Asprilla,,M-F,2,2,180,1,0,7,2,1,0,0,0,6,1,0,0,2017,post
Harrison Afful,,D,5,5,479,1,0,7,3,1,0,0,0,2,5,0,0,2017,post
Fredy Montero,,F,3,3,270,1,0,8,2,1,0,0,0,7,3,1,0,2017,post
Alberth Elis,,F,4,4,390,1,0,9,2,1,0,0,0,12,9,2,0,2017,post
Mauro Manotas,,F,4,3,273,1,0,10,2,0,1,0,0,3,2,0,0,2017,post
Brek Shea,,D,3,1,113,0,2,1,0,0,0,2,0,1,1,0,0,2017,post
Harry Shipp,,M,3,2,163,0,2,2,0,0,0,2,0,1,1,0,0,2017,post
Joevin Jones,,D-M,5,5,394,0,2,5,2,0,0,1,1,0,6,1,0,2017,post
Nicolás Lodeiro,,M,5,5,450,0,2,6,2,0,0,1,1,6,18,1,0,2017,post
Federico Higuain,,F,5,5,478,0,2,14,5,0,0,2,0,4,5,0,0,2017,post
Jalil Anibaba,,D,4,3,287,0,1,0,0,0,0,0,1,5,0,0,1,2017,post
Tim Parker,,D,3,3,270,0,1,0,0,0,0,1,0,1,0,0,0,2017,post
Tyler Adams,,M,3,3,270,0,1,1,0,0,0,0,1,7,2,0,0,2017,post
Vytas,,D,2,2,171,0,1,1,1,0,0,1,0,3,3,0,0,2017,post
Damien Perrinelle,,D,3,3,262,0,1,2,1,0,0,0,1,4,5,1,0,2017,post
Eric Alexander,,M,5,4,327,0,1,2,0,0,0,0,1,5,2,1,0,2017,post
Sean Davis,,M,3,2,179,0,1,2,1,0,0,0,1,3,3,0,0,2017,post
Christian Bolaños,,M,3,3,256,0,1,3,1,0,0,1,0,3,4,0,0,2017,post
Vicente Sanchez,,F,3,1,125,0,1,3,1,0,0,1,0,0,4,0,0,2017,post
Rodney Wallace,,D,2,2,145,0,1,4,1,0,0,1,0,2,2,1,0,2017,post
Diego Valeri,,M,2,2,180,0,1,5,2,0,0,1,0,0,4,0,0,2017,post
Tomas Martinez,,M,5,5,419,0,1,9,3,0,0,0,1,10,6,1,1,2017,post
Alvas Powell,,D,2,2,180,0,0,0,0,0,0,0,0,1,4,1,0,2017,post
Erik Hurtado,,F,0,0,0,0,0,0,0,0,0,0,0,0,0,0,0,2017,post
Zach Mathers,,M,0,0,0,0,0,0,0,0,0,0,0,0,0,0,0,2017,post
Andrew Wenger,,D-M,0,0,0,0,0,0,0,0,0,0,0,0,0,0,0,2017,post
Eriq Zavaleta,,D,4,3,221,0,0,0,0,0,0,0,0,0,0,0,0,2017,post
Charlie Ward,,M,0,0,0,0,0,0,0,0,0,0,0,0,0,0,0,2017,post
Alexander Callens,,D,1,1,52,0,0,0,0,0,0,0,0,1,0,0,1,2017,post
Gideon Baah,,D,0,0,0,0,0,0,0,0,0,0,0,0,0,0,0,2017,post
Harrison Heath,,M,0,0,0,0,0,0,0,0,0,0,0,0,0,0,0,2017,post
Kyle Greig,,F,0,0,0,0,0,0,0,0,0,0,0,0,0,0,0,2017,post
Fatai Alashe,,M,0,0,0,0,0,0,0,0,0,0,0,0,0,0,0,2017,post
Aaron Long,,D,3,3,270,0,0,0,0,0,0,0,0,3,2,0,0,2017,post
Jordy Delem,,M,2,1,95,0,0,0,0,0,0,0,0,1,1,0,0,2017,post
Erik Palmer-Brown,,D,0,0,0,0,0,0,0,0,0,0,0,0,0,0,0,2017,post
Brandon Vincent,,D,1,1,90,0,0,0,0,0,0,0,0,0,0,0,0,2017,post
Aaron Kovar,,M,0,0,0,0,0,0,0,0,0,0,0,0,0,0,0,2017,post
Cordell Cato,,F,0,0,0,0,0,0,0,0,0,0,0,0,0,0,0,2017,post
Kevin Garcia,,D,0,0,0,0,0,0,0,0,0,0,0,0,0,0,0,2017,post
Jack Barmby,,M-D,1,0,9,0,0,0,0,0,0,0,0,0,0,0,0,2017,post
Sergio Camargo,,M,0,0,0,0,0,0,0,0,0,0,0,0,0,0,0,2017,post
Jay Chapman,,M,0,0,0,0,0,0,0,0,0,0,0,0,0,0,0,2017,post
Jordan Hamilton,,F,0,0,0,0,0,0,0,0,0,0,0,0,0,0,0,2017,post
Gbenga Arokoyo,,D,0,0,0,0,0,0,0,0,0,0,0,0,0,0,0,2017,post
John Stertzer,,M,0,0,0,0,0,0,0,0,0,0,0,0,0,0,0,2017,post
Dan Metzger,,M,0,0,0,0,0,0,0,0,0,0,0,0,0,0,0,2017,post
Jorge Corrales,,D,0,0,0,0,0,0,0,0,0,0,0,0,0,0,0,2017,post
Marc Pelosi,,M,0,0,0,0,0,0,0,0,0,0,0,0,0,0,0,2017,post
Mark Bloom,,D,0,0,0,0,0,0,0,0,0,0,0,0,0,0,0,2017,post
James Musa,,D-M,0,0,0,0,0,0,0,0,0,0,0,0,0,0,0,2017,post
Tyler Pasher,,M-D,0,0,0,0,0,0,0,0,0,0,0,0,0,0,0,2017,post
Frederic Brillant,,D,2,2,180,0,0,0,0,0,0,0,0,4,0,0,0,2017,post
Waylon Francis,,D,0,0,0,0,0,0,0,0,0,0,0,0,0,0,0,2017,post
Joe Holland,,M,0,0,0,0,0,0,0,0,0,0,0,0,0,0,0,2017,post
David Accam,,F,1,1,90,0,0,0,0,0,0,0,0,2,3,0,0,2017,post
Cole Seiler,,D,0,0,0,0,0,0,0,0,0,0,0,0,0,0,0,2017,post
Jose Escalante,,M,0,0,0,0,0,0,0,0,0,0,0,0,0,0,0,2017,post
Christian Dean,,D,0,0,0,0,0,0,0,0,0,0,0,0,0,0,0,2017,post
Nick Hagglund,,D,4,0,94,0,0,0,0,0,0,0,0,1,0,0,0,2017,post
Jonathan Campbell,,D,0,0,0,0,0,0,0,0,0,0,0,0,0,0,0,2017,post
Mikey Lopez,,M,0,0,0,0,0,0,0,0,0,0,0,0,0,0,0,2017,post
Kharlton Belmar,,F,0,0,0,0,0,0,0,0,0,0,0,0,0,0,0,2017,post
Mikey Ambrose,,D,1,0,11,0,0,0,0,0,0,0,0,0,0,0,0,2017,post
Tsubasa Endoh,,M,0,0,0,0,0,0,0,0,0,0,0,0,0,0,0,2017,post
Oyvind Alseth,,D,0,0,0,0,0,0,0,0,0,0,0,0,0,0,0,2017,post
Wil Trapp,,M,5,5,480,0,0,0,0,0,0,0,0,3,3,0,0,2017,post
Patrick Doody,,D,0,0,0,0,0,0,0,0,0,0,0,0,0,0,0,2017,post
Ronald Matarrita,,D,2,1,123,0,0,0,0,0,0,0,0,1,1,1,0,2017,post
Cameron Iwasa,,F,0,0,0,0,0,0,0,0,0,0,0,0,0,0,0,2017,post
Ben Swanson,,M,0,0,0,0,0,0,0,0,0,0,0,0,0,0,0,2017,post
Henry Wingo,,M,1,0,1,0,0,0,0,0,0,0,0,0,0,0,0,2017,post
Memo Rodriguez,,M,0,0,0,0,0,0,0,0,0,0,0,0,0,0,0,2017,post
Seyi Adekoya,,F,0,0,0,0,0,0,0,0,0,0,0,0,0,0,0,2017,post
Khiry Shelton,,F,0,0,0,0,0,0,0,0,0,0,0,0,0,0,0,2017,post
Oniel Fisher,,D,0,0,0,0,0,0,0,0,0,0,0,0,0,0,0,2017,post
Saad Abdul-Salaam,,D,1,0,6,0,0,0,0,0,0,0,0,0,0,0,0,2017,post
Cameron Porter,,F,0,0,0,0,0,0,0,0,0,0,0,0,0,0,0,2017,post
Ben McKendry,,M,0,0,0,0,0,0,0,0,0,0,0,0,0,0,0,2017,post
Fidel Escobar,,D,0,0,0,0,0,0,0,0,0,0,0,0,0,0,0,2017,post
Michael Amir Murillo,,D,3,3,244,0,0,0,0,0,0,0,0,9,1,0,0,2017,post
Taylor Hunter,,M,0,0,0,0,0,0,0,0,0,0,0,0,0,0,0,2017,post
Victor Arboleda,,F-M,0,0,0,0,0,0,0,0,0,0,0,0,0,0,0,2017,post
Jonathan Lewis,,F,1,0,1,0,0,0,0,0,0,0,0,0,0,0,0,2017,post
Matheus Silva,,D,0,0,0,0,0,0,0,0,0,0,0,0,0,0,0,2017,post
Tommy Thompson,,D,1,1,62,0,0,0,0,0,0,0,0,0,1,0,0,2017,post
George Malki,,D,0,0,0,0,0,0,0,0,0,0,0,0,0,0,0,2017,post
Collin Fernandez,,M,0,0,0,0,0,0,0,0,0,0,0,0,0,0,0,2017,post
Miguel Camargo,,M,0,0,0,0,0,0,0,0,0,0,0,0,0,0,0,2017,post
Thomas McNamara,,M,0,0,0,0,0,0,0,0,0,0,0,0,0,0,0,2017,post
Sam Adekugbe,,D,0,0,0,0,0,0,0,0,0,0,0,0,0,0,0,2017,post
Ben Spencer,,F,0,0,0,0,0,0,0,0,0,0,0,0,0,0,0,2017,post
Marco Bustos,,M,0,0,0,0,0,0,0,0,0,0,0,0,0,0,0,2017,post
Nick Lima,,D,0,0,0,0,0,0,0,0,0,0,0,0,0,0,0,2017,post
Bill Tuiloma,,D-M,0,0,0,0,0,0,0,0,0,0,0,0,0,0,0,2017,post
Raheem Edwards,,M,1,0,6,0,0,0,0,0,0,0,0,2,0,1,0,2017,post
Brett Levis,,D,0,0,0,0,0,0,0,0,0,0,0,0,0,0,0,2017,post
Amer Didic,,D,0,0,0,0,0,0,0,0,0,0,0,0,0,0,0,2017,post
Alex Crognale,,D,0,0,0,0,0,0,0,0,0,0,0,0,0,0,0,2017,post
Brandon Aubrey,,D,0,0,0,0,0,0,0,0,0,0,0,0,0,0,0,2017,post
Connor Maloney,,D,0,0,0,0,0,0,0,0,0,0,0,0,0,0,0,2017,post
James Sands,,M,0,0,0,0,0,0,0,0,0,0,0,0,0,0,0,2017,post
Christian Lucatero,,M,0,0,0,0,0,0,0,0,0,0,0,0,0,0,0,2017,post
Brandon Vazquez,,F,0,0,0,0,0,0,0,0,0,0,0,0,0,0,0,2017,post
Andrew Carleton,,M,0,0,0,0,0,0,0,0,0,0,0,0,0,0,0,2017,post
Chris Goslin,,M,0,0,0,0,0,0,0,0,0,0,0,0,0,0,0,2017,post
Joey Calistri,,M,0,0,0,0,0,0,0,0,0,0,0,0,0,0,0,2017,post
Drew Conner,,M,0,0,0,0,0,0,0,0,0,0,0,0,0,0,0,2017,post
Derrick Etienne Jr.,,M,1,0,10,0,0,0,0,0,0,0,0,1,0,0,0,2017,post
Alex Muyl,,M,1,0,7,0,0,0,0,0,0,0,0,0,0,0,0,2017,post
Tony Alfaro,,D,0,0,0,0,0,0,0,0,0,0,0,0,0,0,0,2017,post
Marshall Hollingsworth,,M,0,0,0,0,0,0,0,0,0,0,0,0,0,0,0,2017,post
Kip Colvey,,M,0,0,0,0,0,0,0,0,0,0,0,0,0,0,0,2017,post
Shannon Gomez,,D,0,0,0,0,0,0,0,0,0,0,0,0,0,0,0,2017,post
Miles Robinson,,D,0,0,0,0,0,0,0,0,0,0,0,0,0,0,0,2017,post
Rennico Clarke,,D,0,0,0,0,0,0,0,0,0,0,0,0,0,0,0,2017,post
Marco Farfan,,D,0,0,0,0,0,0,0,0,0,0,0,0,0,0,0,2017,post
Vincent Bezecourt,,M,1,0,8,0,0,0,0,0,0,0,0,0,0,0,0,2017,post
Abuchi Obinwa,,M,0,0,0,0,0,0,0,0,0,0,0,0,0,0,0,2017,post
Niko Hansen,,F,1,0,16,0,0,0,0,0,0,0,0,0,0,0,0,2017,post
Lindo Mfeka,,M,0,0,0,0,0,0,0,0,0,0,0,0,0,0,0,2017,post
Jake Nerwinski,,D,3,3,216,0,0,0,0,0,0,0,0,4,2,0,0,2017,post
Colton Storm,,D,0,0,0,0,0,0,0,0,0,0,0,0,0,0,0,2017,post
Daniel Johnson,,M,0,0,0,0,0,0,0,0,0,0,0,0,0,0,0,2017,post
Matej Dekovic,,D,0,0,0,0,0,0,0,0,0,0,0,0,0,0,0,2017,post
Jackson Yueill,,M,1,0,4,0,0,0,0,0,0,0,0,0,0,0,0,2017,post
Sebastian Blanco,,M-F,1,0,35,0,0,0,0,0,0,0,0,1,0,1,0,2017,post
Florian Jungwirth,,D,1,1,90,0,0,0,0,0,0,0,0,2,1,0,0,2017,post
Maxime Chanot,,D,0,0,0,0,0,0,0,0,0,0,0,0,0,0,0,2017,post
Andres Imperiale,,D,0,0,0,0,0,0,0,0,0,0,0,0,0,0,0,2017,post
Soni Mustivar,,M,0,0,0,0,0,0,0,0,0,0,0,0,0,0,0,2017,post
Mike Grella,,M,0,0,0,0,0,0,0,0,0,0,0,0,0,0,0,2017,post
John Goossens,,M,0,0,0,0,0,0,0,0,0,0,0,0,0,0,0,2017,post
Sal Zizzo,,D,0,0,0,0,0,0,0,0,0,0,0,0,0,0,0,2017,post
Aurelien Collin,,D,0,0,0,0,0,0,0,0,0,0,0,0,0,0,0,2017,post
Simon Dawkins,,M,0,0,0,0,0,0,0,0,0,0,0,0,0,0,0,2017,post
Jason Hernandez,,D,0,0,0,0,0,0,0,0,0,0,0,0,0,0,0,2017,post
Shea Salinas,,M,1,1,90,0,0,0,0,0,0,0,0,1,1,0,0,2017,post
Chance Myers,,D,0,0,0,0,0,0,0,0,0,0,0,0,0,0,0,2017,post
Andrew Jacobson,,M,1,0,6,0,0,0,0,0,0,0,0,0,0,0,0,2017,post
Carlos Carmona,,M,1,1,120,0,0,0,0,0,0,0,0,4,4,0,0,2017,post
Ricardo Clark,,M,2,1,99,0,0,0,0,0,0,0,0,6,3,1,0,2017,post
Francois Affolter,,D,0,0,0,0,0,0,0,0,0,0,0,0,0,0,0,2017,post
Kenwyne Jones,,F,0,0,0,0,0,0,0,0,0,0,0,0,0,0,0,2017,post
Mauro Rosales,,M,0,0,0,0,0,0,0,0,0,0,0,0,0,0,0,2017,post
Bastian Schweinsteiger,,M,1,0,25,0,0,0,0,0,0,0,0,0,1,0,0,2017,post
Benoit Cheyrou,,M,1,0,1,0,0,0,0,0,0,0,0,0,0,0,0,2017,post
Andrea Pirlo,,M,1,0,1,0,0,0,0,0,0,0,0,0,0,0,0,2017,post
Tyrone Mears,,D,1,0,15,0,0,0,0,0,0,0,0,0,0,0,0,2017,post
David Edgar,,D,0,0,0,0,0,0,0,0,0,0,0,0,0,0,0,2017,post
Larrys Mabiala,,D,1,1,44,0,0,0,0,0,0,0,0,1,0,1,0,2017,post
Jahmir Hyka,,M,0,0,0,0,0,0,0,0,0,0,0,0,0,0,0,2017,post
Brad Evans,,D-M,0,0,0,0,0,0,0,0,0,0,0,0,0,0,0,2017,post
Bobby Boswell,,D,0,0,0,0,0,0,0,0,0,0,0,0,0,0,0,2017,post
Michael Harrington,,D,0,0,0,0,0,0,0,0,0,0,0,0,0,0,0,2017,post
Jordan Harvey,,D,1,0,54,0,0,0,0,0,0,0,0,0,0,0,0,2017,post
Jacob Peterson,,F,1,0,6,0,0,0,0,0,0,0,0,0,0,0,0,2017,post
Roy Miller,,D,1,0,46,0,0,0,0,0,0,0,0,1,0,0,0,2017,post
Michael Parkhurst,,D,1,0,53,0,0,0,0,0,0,0,0,0,0,0,0,2017,post
Marvell Wynne,,D,0,0,0,0,0,0,0,0,0,0,0,0,0,0,0,2017,post
Matt Besler,,D,1,1,120,0,0,0,0,0,0,0,0,0,0,0,0,2017,post
Muhamed Keita,,F,0,0,0,0,0,0,0,0,0,0,0,0,0,0,0,2017,post
Jukka Raitala,,D,2,1,137,0,0,0,0,0,0,0,0,1,0,0,0,2017,post
A.J. DeLaGarza,,D,0,0,0,0,0,0,0,0,0,0,0,0,0,0,0,2017,post
Quincy Amarikwa,,F,1,0,16,0,0,0,0,0,0,0,0,2,0,0,0,2017,post
Osvaldo Alonso,,M,1,0,16,0,0,0,0,0,0,0,0,0,0,0,0,2017,post
Gaston Sauro,,D,0,0,0,0,0,0,0,0,0,0,0,0,0,0,0,2017,post
Michael de Leeuw,,F,0,0,0,0,0,0,0,0,0,0,0,0,0,0,0,2017,post
Kevin Kratz,,M,0,0,0,0,0,0,0,0,0,0,0,0,0,0,0,2017,post
Boniek Garcia,,M,2,0,52,0,0,0,0,0,0,0,0,1,1,2,0,2017,post
Marco Ureña,,F,1,0,28,0,0,0,0,0,0,0,0,0,0,0,0,2017,post
Leonardo,,D,3,2,189,0,0,0,0,0,0,0,0,0,1,0,0,2017,post
Juninho,,M,1,1,70,0,0,0,0,0,0,0,0,0,1,0,0,2017,post
Seth Sinovic,,D,0,0,0,0,0,0,0,0,0,0,0,0,0,0,0,2017,post
Sheanon Williams,,D-M,0,0,0,0,0,0,0,0,0,0,0,0,0,0,0,2017,post
Dilly Duka,,M,0,0,0,0,0,0,0,0,0,0,0,0,0,0,0,2017,post
Aaron Maund,,D,0,0,0,0,0,0,0,0,0,0,0,0,0,0,0,2017,post
Zach Loyd,,D,0,0,0,0,0,0,0,0,0,0,0,0,0,0,0,2017,post
Ben Zemanski,,M,0,0,0,0,0,0,0,0,0,0,0,0,0,0,0,2017,post
Zarek Valentin,,D,0,0,0,0,0,0,0,0,0,0,0,0,0,0,0,2017,post
Hector Jimenez,,M,4,3,258,0,0,0,0,0,0,0,0,1,1,1,0,2017,post
Fanendo Adi,,F,0,0,0,0,0,0,0,0,0,0,0,0,0,0,0,2017,post
Ethan White,,D,1,1,74,0,0,0,0,0,0,0,0,0,0,0,0,2017,post
Kofi Sarkodie,,D,1,1,74,0,0,0,0,0,0,0,0,0,0,0,0,2017,post
Kevin Ellis,,D,0,0,0,0,0,0,0,0,0,0,0,0,0,0,0,2017,post
Johan Kappelhof,,D,1,1,90,0,0,0,0,0,0,0,0,0,0,0,0,2017,post
Russell Teibert,,M,0,0,0,0,0,0,0,0,0,0,0,0,0,0,0,2017,post
Matias Laba,,M,0,0,0,0,0,0,0,0,0,0,0,0,0,0,0,2017,post
Ashtone Morgan,,D,0,0,0,0,0,0,0,0,0,0,0,0,0,0,0,2017,post
Diego Chara,,M,1,1,45,0,0,0,0,0,0,0,0,1,0,0,0,2017,post
Harold Cummings,,D,0,0,0,0,0,0,0,0,0,0,0,0,0,0,0,2017,post
Adolfo Machado,,D,5,5,480,0,0,0,0,0,0,0,0,5,0,1,0,2017,post
Soony Saad,,F,0,0,0,0,0,0,0,0,0,0,0,0,0,0,0,2017,post
Diego Rubio,,F,1,1,120,0,0,0,0,0,0,0,0,1,1,1,0,2017,post
Bernie Ibini,,M-F,0,0,0,0,0,0,0,0,0,0,0,0,0,0,0,2017,post
Connor Lade,,D,1,0,1,0,0,0,0,0,0,0,0,0,0,0,0,2017,post
Greg Garza,,D,0,0,0,0,0,0,0,0,0,0,0,0,0,0,0,2017,post
RJ Allen,,D,0,0,0,0,0,0,0,0,0,0,0,0,0,0,0,2017,post
Calum Mallace,,M,0,0,0,0,0,0,0,0,0,0,0,0,0,0,0,2017,post
Nouhou Tolo,,D,5,4,339,0,0,0,0,0,0,0,0,4,3,2,0,2017,post
Lalas Abubakar,,D,3,1,89,0,0,0,0,0,0,0,0,2,0,0,0,2017,post
Kwame Awuah,,M,0,0,0,0,0,0,0,0,0,0,0,0,0,0,0,2017,post
Brandt Bronico,,M,0,0,0,0,0,0,0,0,0,0,0,0,0,0,0,2017,post
Andrew Wheeler-Omiunu,,M,0,0,0,0,0,0,0,0,0,0,0,0,0,0,0,2017,post
Arun Basuljevic,,M,0,0,0,0,0,0,0,0,0,0,0,0,0,0,0,2017,post
Cristian Martinez,,M,0,0,0,0,0,0,0,0,0,0,0,0,0,0,0,2017,post
Hassan Ndam,,D,0,0,0,0,0,0,0,0,0,0,0,0,0,0,0,2017,post
Gianluca Busio,,M-F,0,0,0,0,0,0,0,0,0,0,0,0,0,0,0,2017,post
Djordje Mihailovic,,M,1,1,65,0,0,1,0,0,0,0,0,0,1,0,0,2017,post
Darren Mattocks,,F,2,2,103,0,0,1,0,0,0,0,0,0,1,0,0,2017,post
Lawrence Olum,,D,2,2,180,0,0,1,0,0,0,0,0,2,0,0,0,2017,post
Ilie Sanchez,,M,1,1,120,0,0,1,0,0,0,0,0,1,2,1,0,2017,post
Josh Williams,,D,5,5,480,0,0,1,1,0,0,0,0,7,0,1,0,2017,post
Darlington Nagbe,,M,2,2,149,0,0,1,0,0,0,0,0,1,5,0,0,2017,post
Amobi Okugo,,D-M,2,1,100,0,0,1,0,0,0,0,0,2,2,0,0,2017,post
Nicolas Hasler,,D,2,1,107,0,0,1,0,0,0,0,0,0,0,0,0,2017,post
Ike Opara,,D,1,1,120,0,0,1,0,0,0,0,0,2,1,0,0,2017,post
Steven Beitashour,,D,5,5,424,0,0,1,0,0,0,0,0,3,5,0,0,2017,post
David Guzman,,M,1,1,90,0,0,1,0,0,0,0,0,1,2,1,0,2017,post
Lamar Neagle,,M,3,0,24,0,0,1,0,0,0,0,0,0,0,0,0,2017,post
Nosa Igiebor,,M,2,2,152,0,0,1,0,0,0,0,0,4,3,2,0,2017,post
Arturo Alvarez,,M,1,0,20,0,0,1,0,0,0,0,0,0,0,0,0,2017,post
DaMarcus Beasley,,D,4,4,390,0,0,1,0,0,0,0,0,1,8,0,0,2017,post
Liam Ridgewell,,D,2,2,180,0,0,1,0,0,0,0,0,2,6,1,0,2017,post
Chad Marshall,,D,5,5,438,0,0,1,1,0,0,0,0,1,0,0,0,2017,post
Víctor Bernárdez,,D,1,1,90,0,0,1,1,0,0,0,0,0,0,0,0,2017,post
Roger Espinoza,,M,1,1,114,0,0,1,1,0,0,0,0,2,2,1,0,2017,post
Drew Moor,,D,5,5,405,0,0,1,0,0,0,0,0,5,6,0,0,2017,post
Kevin Oliveira,,M,1,0,19,0,0,1,0,0,0,0,0,0,1,0,0,2017,post
Alphonso Davies,,M,1,0,26,0,0,1,0,0,0,0,0,1,0,0,0,2017,post
Kemar Lawrence,,D,3,3,269,0,0,1,1,0,0,0,0,2,1,0,0,2017,post
Joao Meira,,D-M,1,1,70,0,0,1,0,0,0,0,0,2,0,0,0,2017,post
Darwin Ceren,,M,1,1,90,0,0,1,0,0,0,0,0,1,2,1,0,2017,post
Jordan Morris,,F,2,0,33,0,0,1,1,0,0,0,0,0,0,0,0,2017,post
Cristian Roldan,,M,5,5,450,0,0,1,0,0,0,0,0,3,7,1,0,2017,post
Jimmy Medranda ,,D,1,1,120,0,0,1,0,0,0,0,0,1,1,0,0,2017,post
David Arshakyan,,F,1,0,20,0,0,1,0,0,0,0,0,0,1,0,0,2017,post
Ben Sweat,,D,2,2,180,0,0,1,0,0,0,0,0,1,1,0,0,2017,post
Yordy Reyna,,M-F,3,2,186,0,0,1,0,0,0,0,0,1,4,0,0,2017,post
Anton Walkes,,D,1,1,105,0,0,1,0,0,0,0,0,0,0,0,0,2017,post
Sean Okoli,,F,2,0,19,0,0,1,0,0,0,0,0,0,0,0,0,2017,post
Luis Solignac,,F,1,1,90,0,0,1,0,0,0,0,0,0,0,0,0,2017,post
Adam Jahn,,F,3,0,13,0,0,1,0,0,0,0,0,2,1,0,0,2017,post
Jonathan Osorio,,M,5,3,305,0,0,2,2,0,0,0,0,3,5,1,0,2017,post
Yamil Asad,,M,1,1,67,0,0,2,0,0,0,0,0,2,3,0,0,2017,post
Gerso Fernandes,,F,1,1,51,0,0,2,1,0,0,0,0,1,1,0,0,2017,post
Latif Blessing,,F,1,1,100,0,0,2,1,0,0,0,0,4,0,0,0,2017,post
Jeremy Ebobisse,,F,2,0,108,0,0,2,1,0,0,0,0,4,0,0,0,2017,post
Chris Wondolowski,,F,1,1,90,0,0,2,2,0,0,0,0,0,0,0,0,2017,post
Danny Hoesen,,F,1,1,90,0,0,2,0,0,0,0,0,3,1,0,0,2017,post
Maximiliano Moralez,,M,2,2,180,0,0,2,0,0,0,0,0,3,2,0,0,2017,post
Chris McCann,,M-D,1,1,109,0,0,2,1,0,0,0,0,1,0,0,0,2017,post
Philippe Senderos,,D,4,4,359,0,0,2,1,0,0,0,0,2,4,1,0,2017,post
Dax McCarty,,M,1,1,90,0,0,2,2,0,0,0,0,3,2,0,0,2017,post
Michael Bradley,,M,5,5,450,0,0,2,1,0,0,0,0,7,4,2,0,2017,post
Jeff Larentowicz,,M,1,1,120,0,0,2,1,0,0,0,0,2,0,0,0,2017,post
Tosaint Ricketts,,F,1,1,90,0,0,2,0,0,0,0,0,1,0,0,0,2017,post
Jonathan Mensah,,D,5,5,480,0,0,2,0,0,0,0,0,9,4,2,0,2017,post
Nemanja Nikolic,,F,1,1,90,0,0,2,1,0,0,0,0,0,0,0,0,2017,post
Alexander Ring,,M,2,2,180,0,0,2,0,0,0,0,0,3,0,0,0,2017,post
Vako,,M,1,1,86,0,0,2,0,0,0,0,0,1,1,0,0,2017,post
Cristian Lobato,,D,1,0,20,0,0,2,1,0,0,0,0,0,0,0,0,2017,post
Tony Tchani,,M,2,2,174,0,0,2,0,0,0,0,0,4,1,0,0,2017,post
Mohammed Abu,,M,3,2,171,0,0,2,0,0,0,0,0,2,4,1,0,2017,post
Anibal Godoy,,M-D,1,1,90,0,0,2,2,0,0,0,0,3,3,1,0,2017,post
Armando Cooper,,M,4,0,40,0,0,2,0,0,0,0,0,2,1,0,0,2017,post
Leandro Gonzalez Pirez,,D,1,1,120,0,0,2,1,0,0,0,0,2,0,0,0,2017,post
Alex,,M,5,4,305,0,0,3,1,0,0,0,0,6,5,1,0,2017,post
Graham Zusi,,M,1,1,120,0,0,3,1,0,0,0,0,1,2,1,0,2017,post
Roman Torres,,D,4,4,360,0,0,3,0,0,0,0,0,5,1,2,0,2017,post
Matt Polster,,D,1,1,90,0,0,3,0,0,0,0,0,1,1,0,0,2017,post
Marky Delgado,,M,5,4,384,0,0,3,1,0,0,0,0,1,3,0,0,2017,post
Josef Martinez,,F,1,1,114,0,0,3,0,0,0,0,0,0,1,0,0,2017,post
Juan David Cabezas,,M,5,5,480,0,0,3,0,0,0,0,0,5,4,0,0,2017,post
Hector Villalba,,F,1,1,120,0,0,3,1,0,0,0,0,0,2,0,0,2017,post
Aly Ghazal,,M,3,3,270,0,0,3,1,0,0,0,0,9,1,1,0,2017,post
Julian Gressel,,M,1,1,120,0,0,3,2,0,0,0,0,0,0,0,0,2017,post
Daniel Salloi,,F,1,0,69,0,0,4,1,0,0,0,0,0,3,0,0,2017,post
Benny Feilhaber,,M,1,1,101,0,0,4,0,0,0,0,0,2,6,0,0,2017,post
Marcel de Jong,,D-M,3,3,261,0,0,4,1,0,0,0,0,2,0,0,0,2017,post
Felipe,,M,3,3,270,0,0,4,0,0,0,0,0,6,5,1,0,2017,post
Chris Mavinga,,D,5,5,414,0,0,4,1,0,0,0,0,6,4,0,0,2017,post
Justin Morrow,,D,5,5,444,0,0,4,0,0,0,0,0,3,7,0,0,2017,post
Kelvin Leerdam,,D,5,5,450,0,0,5,0,0,0,0,0,6,4,0,0,2017,post
Miguel Almiron ,,M,1,1,120,0,0,5,2,0,0,0,0,1,3,0,0,2017,post
Jack Harrison,,F,2,2,169,0,0,5,1,0,0,0,0,0,0,0,0,2017,post
Yangel Herrera,,M,2,2,180,0,0,5,2,0,0,0,0,3,1,0,0,2017,post
Kekuta Manneh,,F,5,0,126,0,0,7,0,0,0,0,0,0,3,0,0,2017,post
Romell Quioto,,M,4,1,140,0,0,8,3,0,0,0,0,2,2,1,0,2017,post
Erick Torres,,F,4,2,188,0,0,8,3,0,0,0,0,6,4,1,0,2017,post
Pedro Santos,,M,5,5,430,0,0,13,3,0,0,0,0,4,14,1,0,2017,post
Diego Valeri,,M,6,6,561,4,2,14,5,0,4,1,1,4,7,1,0,2018,post
Josef Martinez,,F,5,5,399,4,1,9,8,4,0,1,0,9,9,1,0,2018,post
Damir Kreilach,,M,3,3,270,3,1,9,4,0,3,1,0,4,4,0,0,2018,post
Raul Ruidiaz ,,F,2,2,210,3,0,9,3,2,1,0,0,4,1,1,0,2018,post
Sebastian Blanco,,M-F,6,6,570,3,0,10,6,1,2,0,0,7,14,0,0,2018,post
Daniel Salloi,,F,4,4,328,3,0,11,4,3,0,0,0,3,5,1,0,2018,post
Daniel Royer,,M,4,4,308,2,2,8,3,2,0,2,0,2,2,0,0,2018,post
Franco Escobar,,D,5,5,450,2,1,4,2,2,0,1,0,9,4,1,0,2018,post
Diego Rubio,,F,3,2,168,2,1,6,3,1,1,1,0,5,5,3,0,2018,post
Federico Higuain,,F,3,2,255,2,1,6,3,0,2,1,0,1,1,1,0,2018,post
Maximiliano Moralez,,M,3,3,270,1,2,5,2,1,0,2,0,5,15,2,0,2018,post
Miguel Almiron ,,M,5,5,393,1,2,7,4,1,0,2,0,8,12,0,0,2018,post
Eric Remedi,,M,5,5,450,1,1,2,1,0,1,1,0,6,8,1,0,2018,post
Dairon Asprilla,,M-F,5,1,183,1,1,4,3,0,1,0,1,9,6,1,0,2018,post
Alex Muyl,,M,4,4,329,1,1,5,1,1,0,1,0,5,0,0,0,2018,post
Jeremy Ebobisse,,F,6,6,479,1,1,6,4,1,0,0,1,6,5,0,0,2018,post
Sebastian Saucedo,,F,2,0,48,1,0,2,2,0,1,0,0,0,2,0,0,2018,post
Tim Parker,,D,4,4,360,1,0,2,1,1,0,0,0,4,1,1,0,2018,post
Gerso Fernandes,,F,2,0,32,1,0,3,2,1,0,0,0,1,2,0,0,2018,post
Maxime Chanot,,D,3,3,270,1,0,3,1,0,1,0,0,6,2,2,0,2018,post
Nicolás Lodeiro,,M,2,2,210,1,0,3,1,1,0,0,0,4,7,0,0,2018,post
Ilie Sanchez,,M,4,4,360,1,0,4,2,1,0,0,0,3,2,0,0,2018,post
Albert Rusnak,,M,2,2,179,1,0,5,1,1,0,0,0,2,3,2,0,2018,post
Ismael Tajouri-Shradi,,F,3,3,230,1,0,5,1,1,0,0,0,2,5,0,0,2018,post
Gyasi Zardes,,F,3,3,300,1,0,7,3,1,0,0,0,0,2,0,0,2018,post
Hector Villalba,,F,5,0,91,1,0,8,4,1,0,0,0,5,1,1,0,2018,post
David Villa,,F,3,3,264,1,0,10,2,1,0,0,0,6,1,0,0,2018,post
Felipe Gutiérrez,,M,4,4,360,0,3,9,4,0,0,2,1,9,11,0,0,2018,post
Joao Plata,,F,3,2,198,0,2,5,2,0,0,0,2,3,1,0,0,2018,post
Anton Tinnerholm,,D,3,3,270,0,1,0,0,0,0,1,0,5,4,0,0,2018,post
Cristian Roldan,,M,1,1,31,0,1,0,0,0,0,0,1,0,0,0,0,2018,post
Brooks Lennon,,D,3,3,270,0,1,0,0,0,0,0,1,0,1,0,0,2018,post
Milton Valenzuela,,D,3,3,300,0,1,0,0,0,0,1,0,6,6,1,0,2018,post
Diego Chara,,M,6,6,570,0,1,1,0,0,0,0,1,12,7,3,0,2018,post
Jeff Larentowicz,,M,4,4,360,0,1,2,0,0,0,1,0,6,4,0,0,2018,post
Harrison Afful,,D,3,3,299,0,1,2,0,0,0,0,1,1,1,0,0,2018,post
Jorge Villafaña,,F,6,6,570,0,1,2,0,0,0,0,1,3,7,1,0,2018,post
Ronald Matarrita,,D,2,2,180,0,1,2,0,0,0,1,0,4,0,0,0,2018,post
Tyler Adams,,M,4,4,360,0,1,3,0,0,0,1,0,6,6,0,0,2018,post
Aaron Long,,D,4,4,360,0,1,3,1,0,0,1,0,3,2,0,0,2018,post
Alejandro Romero Gamarra,,M,4,4,360,0,1,4,2,0,0,1,0,1,4,0,0,2018,post
Victor Rodriguez,,M,2,2,195,0,1,6,3,0,0,0,1,3,6,0,0,2018,post
Julian Gressel,,M,5,5,450,0,1,6,1,0,0,1,0,10,3,0,0,2018,post
Johnny Russell,,F,4,4,345,0,1,8,2,0,0,1,0,5,6,0,0,2018,post
Michael Parkhurst,,D,5,5,449,0,0,0,0,0,0,0,0,0,2,0,0,2018,post
Roy Miller,,D,0,0,0,0,0,0,0,0,0,0,0,0,0,0,0,2018,post
Brad Evans,,D-M,0,0,0,0,0,0,0,0,0,0,0,0,0,0,0,2018,post
Clint Dempsey,,M-F,0,0,0,0,0,0,0,0,0,0,0,0,0,0,0,2018,post
Chris McCann,,M-D,2,0,8,0,0,0,0,0,0,0,0,2,0,1,0,2018,post
Chad Marshall,,D,1,1,40,0,0,0,0,0,0,0,0,0,0,0,0,2018,post
Ricardo Clark,,M,0,0,0,0,0,0,0,0,0,0,0,0,0,0,0,2018,post
Sal Zizzo,,D,0,0,0,0,0,0,0,0,0,0,0,0,0,0,0,2018,post
Aurelien Collin,,D,0,0,0,0,0,0,0,0,0,0,0,0,0,0,0,2018,post
Demar Phillips,,D,0,0,0,0,0,0,0,0,0,0,0,0,0,0,0,2018,post
Tony Beltran,,D,0,0,0,0,0,0,0,0,0,0,0,0,0,0,0,2018,post
David Horst,,D,0,0,0,0,0,0,0,0,0,0,0,0,0,0,0,2018,post
Mike Grella,,M,0,0,0,0,0,0,0,0,0,0,0,0,0,0,0,2018,post
Rodney Wallace,,D,0,0,0,0,0,0,0,0,0,0,0,0,0,0,0,2018,post
Shawn Barry,,D,0,0,0,0,0,0,0,0,0,0,0,0,0,0,0,2018,post
Alexander Ring,,M,3,3,270,0,0,0,0,0,0,0,0,3,3,1,0,2018,post
Cristian Lobato,,D,0,0,0,0,0,0,0,0,0,0,0,0,0,0,0,2018,post
Marc Rzatkowski,,M,3,0,46,0,0,0,0,0,0,0,0,1,3,0,0,2018,post
Josh Williams,,D,1,1,90,0,0,0,0,0,0,0,0,1,1,0,0,2018,post
Hector Jimenez,,M,1,0,11,0,0,0,0,0,0,0,0,1,0,0,0,2018,post
Zarek Valentin,,D,6,5,457,0,0,0,0,0,0,0,0,5,4,1,0,2018,post
Samuel Armenteros,,F,0,0,0,0,0,0,0,0,0,0,0,0,0,0,0,2018,post
Sunday Stephen,,M,2,1,98,0,0,0,0,0,0,0,0,5,0,1,0,2018,post
Eloi Amagat,,M,1,0,10,0,0,0,0,0,0,0,0,0,0,0,0,2018,post
Andreu Fontas,,D,0,0,0,0,0,0,0,0,0,0,0,0,0,0,0,2018,post
Lamar Neagle,,M,0,0,0,0,0,0,0,0,0,0,0,0,0,0,0,2018,post
Marcelo Silva,,D,2,2,131,0,0,0,0,0,0,0,0,0,0,0,0,2018,post
Magnus Wolff Eikrem,,M,0,0,0,0,0,0,0,0,0,0,0,0,0,0,0,2018,post
Alexander Callens,,D,3,3,270,0,0,0,0,0,0,0,0,4,3,1,0,2018,post
Ben Sweat,,D,3,3,243,0,0,0,0,0,0,0,0,5,1,1,0,2018,post
Ebenezer Ofori,,M,1,0,27,0,0,0,0,0,0,0,0,0,0,0,0,2018,post
Jordy Delem,,M,0,0,0,0,0,0,0,0,0,0,0,0,0,0,0,2018,post
Jesus Medina,,M,2,1,103,0,0,0,0,0,0,0,0,2,2,0,0,2018,post
Cedric Hountondji,,D,0,0,0,0,0,0,0,0,0,0,0,0,0,0,0,2018,post
Jimmy Medranda ,,D,0,0,0,0,0,0,0,0,0,0,0,0,0,0,0,2018,post
Kharlton Belmar,,F,0,0,0,0,0,0,0,0,0,0,0,0,0,0,0,2018,post
Mikey Ambrose,,D,0,0,0,0,0,0,0,0,0,0,0,0,0,0,0,2018,post
Adam Jahn,,F,0,0,0,0,0,0,0,0,0,0,0,0,0,0,0,2018,post
Sebastien Ibeagha,,D,0,0,0,0,0,0,0,0,0,0,0,0,0,0,0,2018,post
Brad Smith,,D,0,0,0,0,0,0,0,0,0,0,0,0,0,0,0,2018,post
Kim Kee-hee,,D,2,2,210,0,0,0,0,0,0,0,0,1,2,0,0,2018,post
Waylon Francis,,D,1,0,56,0,0,0,0,0,0,0,0,0,0,0,0,2018,post
Jack Barmby,,M-D,0,0,0,0,0,0,0,0,0,0,0,0,0,0,0,2018,post
Oliver Shannon,,M,0,0,0,0,0,0,0,0,0,0,0,0,0,0,0,2018,post
Andres Flores,,M,1,1,83,0,0,0,0,0,0,0,0,1,2,1,0,2018,post
Adam Henley,,D,0,0,0,0,0,0,0,0,0,0,0,0,0,0,0,2018,post
Yohan Croizet,,M,4,1,105,0,0,0,0,0,0,0,0,1,1,0,0,2018,post
Eduardo Sosa,,M,0,0,0,0,0,0,0,0,0,0,0,0,0,1,0,2018,post
Corey Baird,,F,2,1,72,0,0,0,0,0,0,0,0,3,0,1,0,2018,post
Henry Wingo,,M,0,0,0,0,0,0,0,0,0,0,0,0,0,0,0,2018,post
Foster Langsdorf,,F,0,0,0,0,0,0,0,0,0,0,0,0,0,0,0,2018,post
Seyi Adekoya,,F,0,0,0,0,0,0,0,0,0,0,0,0,0,0,0,2018,post
Graham Smith,,D,0,0,0,0,0,0,0,0,0,0,0,0,0,0,0,2018,post
Saad Abdul-Salaam,,D,0,0,0,0,0,0,0,0,0,0,0,0,0,0,0,2018,post
Anatole Abang,,F,0,0,0,0,0,0,0,0,0,0,0,0,0,0,0,2018,post
Ben Mines,,M,0,0,0,0,0,0,0,0,0,0,0,0,0,0,0,2018,post
Fidel Escobar,,D,0,0,0,0,0,0,0,0,0,0,0,0,0,0,0,2018,post
Michael Amir Murillo,,D,4,4,343,0,0,0,0,0,0,0,0,7,2,0,0,2018,post
Modou Jadama,,D,0,0,0,0,0,0,0,0,0,0,0,0,0,0,0,2018,post
Victor Arboleda,,F-M,0,0,0,0,0,0,0,0,0,0,0,0,0,0,0,2018,post
Jonathan Lewis,,F,0,0,0,0,0,0,0,0,0,0,0,0,0,0,0,2018,post
Daniel Bedoya,,M,0,0,0,0,0,0,0,0,0,0,0,0,0,0,0,2018,post
Tommy Redding,,D,0,0,0,0,0,0,0,0,0,0,0,0,0,0,0,2018,post
Julio Cascante,,D,0,0,0,0,0,0,0,0,0,0,0,0,0,0,0,2018,post
Justen Glad,,D,2,0,50,0,0,0,0,0,0,0,0,0,0,0,0,2018,post
Romario Williams,,F,0,0,0,0,0,0,0,0,0,0,0,0,0,0,0,2018,post
Carlos Rivas,,F,0,0,0,0,0,0,0,0,0,0,0,0,0,0,0,2018,post
Thomas McNamara,,M,0,0,0,0,0,0,0,0,0,0,0,0,0,0,0,2018,post
Jose Hernandez,,D,0,0,0,0,0,0,0,0,0,0,0,0,0,0,0,2018,post
Jordan Morris,,F,0,0,0,0,0,0,0,0,0,0,0,0,0,0,0,2018,post
Taylor Peay,,D,0,0,0,0,0,0,0,0,0,0,0,0,0,0,0,2018,post
Cristian Martinez,,M,1,0,8,0,0,0,0,0,0,0,0,0,0,0,0,2018,post
Gordon Wild,,F,0,0,0,0,0,0,0,0,0,0,0,0,0,0,0,2018,post
Colton Storm,,D,0,0,0,0,0,0,0,0,0,0,0,0,0,0,0,2018,post
Hassan Ndam,,D,0,0,0,0,0,0,0,0,0,0,0,0,0,0,0,2018,post
Florian Valot,,M,0,0,0,0,0,0,0,0,0,0,0,0,0,0,0,2018,post
Miles Robinson,,D,2,1,91,0,0,0,0,0,0,0,0,1,0,1,0,2018,post
Marco Farfan,,D,0,0,0,0,0,0,0,0,0,0,0,0,0,0,0,2018,post
Vincent Bezecourt,,M,0,0,0,0,0,0,0,0,0,0,0,0,0,0,0,2018,post
Nouhou Tolo,,D,2,2,210,0,0,0,0,0,0,0,0,5,0,0,0,2018,post
Kyle Duncan,,D,0,0,0,0,0,0,0,0,0,0,0,0,0,0,0,2018,post
Lalas Abubakar,,D,1,0,3,0,0,0,0,0,0,0,0,0,0,0,0,2018,post
Kwame Awuah,,M,0,0,0,0,0,0,0,0,0,0,0,0,0,0,0,2018,post
Andrew Wheeler-Omiunu,,M,0,0,0,0,0,0,0,0,0,0,0,0,0,0,0,2018,post
Danilo Acosta,,D,0,0,0,0,0,0,0,0,0,0,0,0,0,0,0,2018,post
Tony Alfaro,,D,0,0,0,0,0,0,0,0,0,0,0,0,0,0,0,2018,post
Ezequiel Barco,,M,5,0,17,0,0,0,0,0,0,0,0,1,2,0,0,2018,post
Amer Didic,,D,0,0,0,0,0,0,0,0,0,0,0,0,0,0,0,2018,post
Ethan Kutler,,D,0,0,0,0,0,0,0,0,0,0,0,0,0,0,0,2018,post
Alex Crognale,,D,0,0,0,0,0,0,0,0,0,0,0,0,0,0,0,2018,post
Eryk Williamson,,M,0,0,0,0,0,0,0,0,0,0,0,0,0,0,0,2018,post
Jon Gallagher,,F,0,0,0,0,0,0,0,0,0,0,0,0,0,0,0,2018,post
Connor Maloney,,D,0,0,0,0,0,0,0,0,0,0,0,0,0,0,0,2018,post
James Sands,,M,0,0,0,0,0,0,0,0,0,0,0,0,0,0,0,2018,post
Cristhian Paredes,,M,0,0,0,0,0,0,0,0,0,0,0,0,0,0,0,2018,post
Brandon Vazquez,,F,0,0,0,0,0,0,0,0,0,0,0,0,0,0,0,2018,post
Pablo Ruiz,,M,1,0,1,0,0,0,0,0,0,0,0,2,0,0,0,2018,post
Tomas Conechny,,M,0,0,0,0,0,0,0,0,0,0,0,0,0,0,0,2018,post
Andrew Carleton,,M,0,0,0,0,0,0,0,0,0,0,0,0,0,0,0,2018,post
Chris Goslin,,M,0,0,0,0,0,0,0,0,0,0,0,0,0,0,0,2018,post
Jaylin Lindsey,,D,0,0,0,0,0,0,0,0,0,0,0,0,0,0,0,2018,post
Jordan McCrary,,D,1,0,15,0,0,0,0,0,0,0,0,0,0,0,0,2018,post
Derrick Etienne Jr.,,M,4,0,88,0,0,0,0,0,0,0,0,1,1,0,0,2018,post
Lagos Kunga,,F,0,0,0,0,0,0,0,0,0,0,0,0,0,0,0,2018,post
Wan Kuzain Wan Kamal,,M,0,0,0,0,0,0,0,0,0,0,0,0,0,0,0,2018,post
Felix Chenkam,,F,0,0,0,0,0,0,0,0,0,0,0,0,0,0,0,2018,post
Alex Roldan,,M,0,0,0,0,0,0,0,0,0,0,0,0,0,0,0,2018,post
George Bello,,D,0,0,0,0,0,0,0,0,0,0,0,0,0,0,0,2018,post
Gianluca Busio,,M-F,0,0,0,0,0,0,0,0,0,0,0,0,0,0,0,2018,post
Joe Scally,,D,0,0,0,0,0,0,0,0,0,0,0,0,0,0,0,2018,post
Ricky Lopez-Espin,,F,0,0,0,0,0,0,0,0,0,0,0,0,0,0,0,2018,post
Edward Opoku,,F,0,0,0,0,0,0,0,0,0,0,0,0,0,0,0,2018,post
Cristian Casseres Jr.,,M,0,0,0,0,0,0,0,0,0,0,0,0,0,0,0,2018,post
Luis Argudo,,M,2,1,73,0,0,1,1,0,0,0,0,2,0,0,0,2018,post
Handwalla Bwana,,M,1,0,36,0,0,1,0,0,0,0,0,3,0,0,0,2018,post
Valentin Castellanos,,F,2,0,51,0,0,1,1,0,0,0,0,3,2,0,0,2018,post
Aaron Herrera,,D,3,3,270,0,0,1,1,0,0,0,0,4,2,2,0,2018,post
Artur,,M,3,3,300,0,0,1,0,0,0,0,0,4,5,0,0,2018,post
Niko Hansen,,F,1,0,58,0,0,1,0,0,0,0,0,1,0,0,0,2018,post
Bill Tuiloma,,D-M,4,2,282,0,0,1,1,0,0,0,0,3,2,0,0,2018,post
Nick Besler,,M,1,1,90,0,0,1,0,0,0,0,0,3,2,0,0,2018,post
Lawrence Olum,,D,4,0,91,0,0,1,1,0,0,0,0,0,0,0,0,2018,post
Connor Lade,,D,2,2,144,0,0,1,0,0,0,0,0,2,3,0,0,2018,post
Lucas Melano,,F,4,0,86,0,0,1,1,0,0,0,0,4,2,0,0,2018,post
Sean Davis,,M,4,4,322,0,0,1,0,0,0,0,0,5,4,1,0,2018,post
Alvas Powell,,D,3,1,121,0,0,1,0,0,0,0,0,1,3,0,0,2018,post
Wil Trapp,,M,3,3,300,0,0,1,0,0,0,0,0,1,3,0,0,2018,post
Luis Silva,,F,1,1,45,0,0,1,0,0,0,0,0,2,2,0,0,2018,post
Kemar Lawrence,,D,2,2,180,0,0,1,0,0,0,0,0,0,2,0,0,2018,post
Jo Inge Berget,,F,1,0,27,0,0,1,0,0,0,0,0,0,0,0,0,2018,post
Gaston Sauro,,D,2,2,199,0,0,1,0,0,0,0,0,5,0,0,0,2018,post
Kevin Kratz,,M,1,0,1,0,0,1,0,0,0,0,0,0,1,0,0,2018,post
Will Bruin,,F,1,0,40,0,0,1,0,0,0,0,0,0,0,0,0,2018,post
Kelvin Leerdam,,D,2,2,174,0,0,1,0,0,0,0,0,2,1,0,0,2018,post
Roman Torres,,D,2,1,170,0,0,1,1,0,0,0,0,1,1,0,0,2018,post
Nedum Onuoha,,D,3,3,270,0,0,1,0,0,0,0,0,2,4,0,0,2018,post
Larrys Mabiala,,D,4,4,286,0,0,1,1,0,0,0,0,2,1,0,1,2018,post
Krisztian Nemeth,,F,1,0,20,0,0,1,0,0,0,0,0,1,0,0,0,2018,post
Matt Besler,,D,4,4,360,0,0,2,0,0,0,0,0,6,6,1,0,2018,post
Gustav Svensson,,M,2,2,210,0,0,2,0,0,0,0,0,4,1,1,0,2018,post
Roger Espinoza,,M,4,4,360,0,0,2,1,0,0,0,0,5,7,1,0,2018,post
Leandro Gonzalez Pirez,,D,5,5,450,0,0,2,0,0,0,0,0,11,7,1,0,2018,post
Jonathan Mensah,,D,3,3,300,0,0,2,0,0,0,0,0,3,1,0,0,2018,post
Ike Opara,,D,4,4,360,0,0,2,1,0,0,0,0,1,2,0,0,2018,post
Seth Sinovic,,D,3,3,270,0,0,2,1,0,0,0,0,5,4,1,0,2018,post
Luke Mulholland,,M,2,2,179,0,0,2,0,0,0,0,0,2,3,0,0,2018,post
Patrick Mullins,,F,3,1,57,0,0,2,1,0,0,0,0,1,1,0,0,2018,post
Khiry Shelton,,F,3,2,172,0,0,2,1,0,0,0,0,4,0,0,0,2018,post
Harry Shipp,,M,2,1,83,0,0,2,1,0,0,0,0,0,0,0,0,2018,post
Yangel Herrera,,M,3,3,215,0,0,2,2,0,0,0,0,9,6,1,0,2018,post
Brian White,,F,1,0,3,0,0,2,1,0,0,0,0,0,0,0,0,2018,post
Andreas Ivan,,M,2,0,37,0,0,3,1,0,0,0,0,0,0,0,0,2018,post
Andy Polo,,M,5,5,362,0,0,3,0,0,0,0,0,2,3,0,0,2018,post
Kyle Beckerman,,M,3,3,270,0,0,3,0,0,0,0,0,10,3,2,0,2018,post
Graham Zusi,,M,4,4,360,0,0,4,1,0,0,0,0,4,5,0,0,2018,post
Osvaldo Alonso,,M,2,2,210,0,0,4,0,0,0,0,0,3,4,1,0,2018,post
Justin Meram,,M,3,3,233,0,0,4,2,0,0,0,0,4,2,0,0,2018,post
Darlington Nagbe,,M,5,5,449,0,0,4,0,0,0,0,0,3,8,0,0,2018,post
Jefferson Savarino,,F,3,3,259,0,0,4,2,0,0,0,0,5,5,1,0,2018,post
Greg Garza,,D,5,5,442,0,0,4,1,0,0,0,0,2,4,0,0,2018,post
Liam Ridgewell,,D,6,6,570,0,0,5,2,0,0,0,0,5,2,1,0,2018,post
Bradley Wright-Phillips,,F,4,4,360,0,0,6,2,0,0,0,0,1,9,0,0,2018,post
Pedro Santos,,M,3,2,214,0,0,6,2,0,0,0,0,3,4,0,0,2018,post
David Guzman,,M,5,5,397,0,0,7,1,0,0,0,0,10,3,2,0,2018,post
Raul Ruidiaz ,,F,4,4,389,4,4,24,11,2,2,4,0,7,5,1,0,2019,post
Jordan Morris,,F,4,4,347,3,1,6,4,3,0,0,1,2,3,0,0,2019,post
Nicolás Lodeiro,,M,4,4,390,2,5,10,3,1,1,3,2,7,18,1,0,2019,post
Alejandro Pozuelo,,M,4,4,390,2,3,8,7,0,2,1,2,4,6,1,0,2019,post
Nick DeLeon,,M,4,0,136,2,1,4,4,1,1,1,0,1,0,1,0,2019,post
Carlos Vela,,F,2,2,180,2,1,7,4,2,0,1,0,1,5,0,0,2019,post
Jonathan Osorio,,M,4,4,377,2,1,9,6,2,0,1,0,5,4,2,0,2019,post
Julian Gressel,,M,3,3,270,2,1,9,4,2,0,1,0,4,0,1,0,2019,post
Adama Diomande,,F,2,0,68,2,0,6,2,2,0,0,0,0,0,0,0,2019,post
Gustav Svensson,,M,4,4,390,1,3,5,1,1,0,3,0,5,4,0,0,2019,post
Diego Rossi,,F,2,2,180,1,2,5,2,1,0,2,0,0,0,0,0,2019,post
Fafa Picault,,M,2,1,138,1,1,6,4,1,0,1,0,4,2,0,0,2019,post
Zlatan Ibrahimovic,,F,2,2,180,1,1,8,3,0,1,0,1,5,2,1,0,2019,post
Jozy Altidore,,F,1,0,22,1,0,1,1,0,1,0,0,1,0,0,0,2019,post
Rolf Feltscher,,D,1,0,17,1,0,1,1,0,1,0,0,0,0,0,0,2019,post
Matt Hedges,,D,1,1,120,1,0,1,1,0,1,0,0,2,2,0,0,2019,post
Tim Parker,,D,1,1,120,1,0,1,1,0,1,0,0,5,1,1,0,2019,post
Josh Sims,,M,1,1,29,1,0,1,1,0,1,0,0,1,0,0,0,2019,post
Lucas Rodriguez,,M,1,1,120,1,0,1,1,0,1,0,0,4,1,0,0,2019,post
Reggie Cannon,,D,1,1,120,1,0,2,1,0,1,0,0,2,3,1,0,2019,post
Eduard Atuesta,,M,2,2,180,1,0,2,1,1,0,0,0,6,2,0,0,2019,post
Franco Escobar,,D,3,3,270,1,0,2,2,1,0,0,0,1,7,1,0,2019,post
Dairon Asprilla,,M-F,1,1,90,1,0,2,1,0,1,0,0,1,0,0,0,2019,post
Jonathan dos Santos,,M,2,2,180,1,0,3,2,0,1,0,0,1,1,0,0,2019,post
Jan Gregus,,M,1,1,90,1,0,3,1,1,0,0,0,0,0,0,0,2019,post
Kelvin Leerdam,,D,4,4,380,1,0,3,3,1,0,0,0,7,1,1,0,2019,post
Ismael Tajouri-Shradi,,F,1,1,90,1,0,3,2,1,0,0,0,0,2,0,0,2019,post
Cristian Pavon,,M,2,2,180,1,0,3,1,0,1,0,0,2,4,0,0,2019,post
Jack Elliott,,D,2,2,210,1,0,3,1,1,0,0,0,2,0,0,0,2019,post
Richie Laryea,,M,4,0,109,1,0,3,1,1,0,0,0,3,9,0,0,2019,post
Tom Barlow,,F,1,1,84,1,0,4,2,0,1,0,0,0,0,0,0,2019,post
Marco Fabian,,M,2,0,41,1,0,4,2,1,0,0,0,1,2,0,0,2019,post
Marky Delgado,,M,4,4,390,1,0,4,1,1,0,0,0,6,4,1,0,2019,post
Sebastian Lletget,,M,2,2,179,1,0,4,1,0,1,0,0,2,3,0,0,2019,post
Jefferson Savarino,,F,2,2,180,1,0,5,2,1,0,0,0,2,3,1,0,2019,post
Bryan Acosta,,M,1,1,120,1,0,6,1,0,1,0,0,4,1,1,0,2019,post
Damir Kreilach,,M,2,2,153,1,0,6,3,1,0,0,0,4,2,0,0,2019,post
Nicolas Benezet,,F,4,4,273,1,0,8,4,0,1,0,0,5,6,0,0,2019,post
Victor Rodriguez,,M,3,0,110,1,0,8,3,1,0,0,0,0,3,0,0,2019,post
Alejandro Bedoya,,M,2,2,202,1,0,9,1,1,0,0,0,5,0,2,0,2019,post
Josef Martinez,,F,3,3,270,1,0,11,3,1,0,0,0,2,2,1,0,2019,post
Lee Nguyen,,M,2,2,150,0,3,0,0,0,0,3,0,0,2,0,0,2019,post
Alejandro Romero Gamarra,,M,1,1,70,0,2,0,0,0,0,0,2,0,1,0,0,2019,post
Pity Martinez,,M,2,2,169,0,2,2,1,0,0,2,0,1,7,0,0,2019,post
Joevin Jones,,D-M,4,4,313,0,2,2,1,0,0,1,1,1,3,0,0,2019,post
Romain Alessandrini,,M,2,0,49,0,2,4,2,0,0,0,2,3,3,2,0,2019,post
Ezequiel Barco,,M,3,3,251,0,2,7,1,0,0,2,0,0,10,0,0,2019,post
Reto Ziegler,,D,1,1,120,0,1,0,0,0,0,0,1,1,0,0,0,2019,post
Michael Bradley,,M,4,4,390,0,1,1,0,0,0,1,0,6,2,2,0,2019,post
Darwin Quintero,,F,1,0,30,0,1,1,0,0,0,1,0,0,0,0,0,2019,post
Marc Rzatkowski,,M,1,1,120,0,1,1,0,0,0,0,1,0,2,0,0,2019,post
Latif Blessing,,F,2,2,134,0,1,1,0,0,0,1,0,0,2,0,0,2019,post
Eddie Segura,,D,2,2,180,0,1,1,1,0,0,1,0,2,0,0,0,2019,post
Michael Barrios,,M,1,1,120,0,1,2,0,0,0,0,1,3,0,0,0,2019,post
Corey Baird,,F,2,2,150,0,1,2,2,0,0,1,0,4,1,0,0,2019,post
Brad Smith,,D,4,4,306,0,1,2,0,0,0,1,0,1,3,0,0,2019,post
Frederic Brillant,,D,1,1,120,0,1,2,0,0,0,0,1,1,0,0,0,2019,post
Maximiliano Moralez,,M,1,1,90,0,1,2,1,0,0,1,0,1,2,0,0,2019,post
Laurent Ciman,,D,3,3,300,0,1,2,0,0,0,0,1,3,0,1,0,2019,post
Brian Rodriguez,,F,2,2,112,0,1,2,1,0,0,1,0,1,2,0,0,2019,post
Wayne Rooney,,F-M,1,1,105,0,1,3,3,0,0,0,1,0,0,0,0,2019,post
Haris Medunjanin,,M,2,2,210,0,1,3,0,0,0,1,0,3,0,0,0,2019,post
Daniel Royer,,M,1,1,97,0,1,3,1,0,0,0,1,0,1,0,0,2019,post
Sebastian Blanco,,M-F,1,1,90,0,1,4,1,0,0,0,1,2,1,1,0,2019,post
Sergio Santos,,F,2,2,169,0,1,5,1,0,0,1,0,5,4,0,0,2019,post
Cristian Roldan,,M,4,4,390,0,1,5,3,0,0,1,0,5,10,0,0,2019,post
Auro,,D,4,4,337,0,0,0,0,0,0,0,0,3,4,0,0,2019,post
Harry Shipp,,M,0,0,0,0,0,0,0,0,0,0,0,0,0,0,0,2019,post
Bradford Jamieson IV,,F,0,0,0,0,0,0,0,0,0,0,0,0,0,0,0,2019,post
Justin Portillo ,,M,0,0,0,0,0,0,0,0,0,0,0,0,0,0,0,2019,post
Brooks Lennon,,D,0,0,0,0,0,0,0,0,0,0,0,0,0,0,0,2019,post
Andy Polo,,M,1,1,89,0,0,0,0,0,0,0,0,0,0,0,0,2019,post
Kemar Lawrence,,D,1,1,120,0,0,0,0,0,0,0,0,0,3,0,0,2019,post
Brian Fernandez,,F,0,0,0,0,0,0,0,0,0,0,0,0,0,0,0,2019,post
Emanuel Cecchini,,M,0,0,0,0,0,0,0,0,0,0,0,0,0,0,0,2019,post
Luke Mulholland,,M,0,0,0,0,0,0,0,0,0,0,0,0,0,0,0,2019,post
Jesus Medina,,M,0,0,0,0,0,0,0,0,0,0,0,0,0,0,0,2019,post
Emmanuel Boateng,,M,1,0,33,0,0,0,0,0,0,0,0,1,0,0,0,2019,post
Favio Alvarez,,M,1,0,12,0,0,0,0,0,0,0,0,0,0,0,0,2019,post
Alexander Callens,,D,1,1,90,0,0,0,0,0,0,0,0,2,1,0,0,2019,post
Ben Sweat,,D,0,0,0,0,0,0,0,0,0,0,0,0,0,0,0,2019,post
Aaron Long,,D,1,1,120,0,0,0,0,0,0,0,0,0,3,0,0,2019,post
Eric Miller,,D,0,0,0,0,0,0,0,0,0,0,0,0,0,0,0,2019,post
Ebenezer Ofori,,M,0,0,0,0,0,0,0,0,0,0,0,0,0,0,0,2019,post
Walker Zimmerman,,D,2,1,121,0,0,0,0,0,0,0,0,0,0,0,0,2019,post
Andrew Farrell,,D,1,1,90,0,0,0,0,0,0,0,0,0,0,0,0,2019,post
Eriq Zavaleta,,D,0,0,0,0,0,0,0,0,0,0,0,0,0,0,0,2019,post
Alejandro Guido,,M,0,0,0,0,0,0,0,0,0,0,0,0,0,0,0,2019,post
Bressan,,D,1,1,77,0,0,0,0,0,0,0,0,1,0,0,0,2019,post
Anthony Fontana,,M,0,0,0,0,0,0,0,0,0,0,0,0,0,0,0,2019,post
Matthew Real,,D,0,0,0,0,0,0,0,0,0,0,0,0,0,0,0,2019,post
Auston Trusty,,D,0,0,0,0,0,0,0,0,0,0,0,0,0,0,0,2019,post
Foster Langsdorf,,F,0,0,0,0,0,0,0,0,0,0,0,0,0,0,0,2019,post
Chase Gasper,,D,1,1,90,0,0,0,0,0,0,0,0,3,1,0,0,2019,post
Mo Adams,,M,2,0,8,0,0,0,0,0,0,0,0,0,0,0,0,2019,post
John Nelson,,D,0,0,0,0,0,0,0,0,0,0,0,0,0,0,0,2019,post
Dominique Badji,,F,0,0,0,0,0,0,0,0,0,0,0,0,0,0,0,2019,post
Oniel Fisher,,D,0,0,0,0,0,0,0,0,0,0,0,0,0,0,0,2019,post
Saad Abdul-Salaam,,D,0,0,0,0,0,0,0,0,0,0,0,0,0,0,0,2019,post
Omir Fernandez,,M,0,0,0,0,0,0,0,0,0,0,0,0,0,0,0,2019,post
Ben Mines,,M,0,0,0,0,0,0,0,0,0,0,0,0,0,0,0,2019,post
Michael Amir Murillo,,D,0,0,0,0,0,0,0,0,0,0,0,0,0,0,0,2019,post
Erickson Gallardo,,F-M,0,0,0,0,0,0,0,0,0,0,0,0,0,0,0,2019,post
Modou Jadama,,D,0,0,0,0,0,0,0,0,0,0,0,0,0,0,0,2019,post
Joseph Mora,,D,1,1,87,0,0,0,0,0,0,0,0,0,1,0,0,2019,post
Zachary Herivaux,,M,0,0,0,0,0,0,0,0,0,0,0,0,0,0,0,2019,post
Renzo Zambrano,,M,0,0,0,0,0,0,0,0,0,0,0,0,0,0,0,2019,post
Cristian Colman,,F,0,0,0,0,0,0,0,0,0,0,0,0,0,0,0,2019,post
Tomas Hilliard-Arce,,D,0,0,0,0,0,0,0,0,0,0,0,0,0,0,0,2019,post
Eric Remedi,,M,1,0,11,0,0,0,0,0,0,0,0,0,2,0,0,2019,post
Sebastian Saucedo,,F,1,0,10,0,0,0,0,0,0,0,0,1,0,0,0,2019,post
Romario Ibarra,,M,0,0,0,0,0,0,0,0,0,0,0,0,0,0,0,2019,post
Josh Perez,,F,0,0,0,0,0,0,0,0,0,0,0,0,0,0,0,2019,post
Brian Wright,,F,0,0,0,0,0,0,0,0,0,0,0,0,0,0,0,2019,post
Ronald Matarrita,,D,1,1,90,0,0,0,0,0,0,0,0,1,0,0,0,2019,post
Julio Cascante,,D,0,0,0,0,0,0,0,0,0,0,0,0,0,0,0,2019,post
Justen Glad,,D,1,1,90,0,0,0,0,0,0,0,0,1,0,0,0,2019,post
Xavier Arreaga,,D,3,1,132,0,0,0,0,0,0,0,0,0,0,0,0,2019,post
Brent Kallman,,D,0,0,0,0,0,0,0,0,0,0,0,0,0,0,0,2019,post
Marvin Loria,,M,1,0,1,0,0,0,0,0,0,0,0,0,0,0,0,2019,post
Marcus Epps,,M,0,0,0,0,0,0,0,0,0,0,0,0,0,0,0,2019,post
Erik Holt,,D,0,0,0,0,0,0,0,0,0,0,0,0,0,0,0,2019,post
Kyle Duncan,,D,0,0,0,0,0,0,0,0,0,0,0,0,0,0,0,2019,post
Peter-Lee Vassell,,M,0,0,0,0,0,0,0,0,0,0,0,0,0,0,0,2019,post
Douglas Martinez,,F,0,0,0,0,0,0,0,0,0,0,0,0,0,0,0,2019,post
Lagos Kunga,,F,0,0,0,0,0,0,0,0,0,0,0,0,0,0,0,2019,post
Ryan Telfer,,F,0,0,0,0,0,0,0,0,0,0,0,0,0,0,0,2019,post
Julian Dunn,,D,0,0,0,0,0,0,0,0,0,0,0,0,0,0,0,2019,post
Noble Okello,,M,0,0,0,0,0,0,0,0,0,0,0,0,0,0,0,2019,post
Rece Buckmaster,,D,1,1,120,0,0,0,0,0,0,0,0,1,2,0,0,2019,post
Francis Atuahene,,F,0,0,0,0,0,0,0,0,0,0,0,0,0,0,0,2019,post
Donovan Pines,,D,0,0,0,0,0,0,0,0,0,0,0,0,0,0,0,2019,post
Eryk Williamson,,M,0,0,0,0,0,0,0,0,0,0,0,0,0,0,0,2019,post
Chris Odoi-Atsem,,D,0,0,0,0,0,0,0,0,0,0,0,0,0,0,0,2019,post
Jon Gallagher,,F,0,0,0,0,0,0,0,0,0,0,0,0,0,0,0,2019,post
Jeremy Ebobisse,,F,1,1,63,0,0,0,0,0,0,0,0,0,1,0,0,2019,post
Florian Valot,,M,0,0,0,0,0,0,0,0,0,0,0,0,0,0,0,2019,post
Miles Robinson,,D,0,0,0,0,0,0,0,0,0,0,0,0,0,0,0,2019,post
Marco Farfan,,D,0,0,0,0,0,0,0,0,0,0,0,0,0,0,0,2019,post
Vincent Bezecourt,,M,0,0,0,0,0,0,0,0,0,0,0,0,0,0,0,2019,post
Dion Pereira,,M,0,0,0,0,0,0,0,0,0,0,0,0,0,0,0,2019,post
Ethan Zubak,,F,0,0,0,0,0,0,0,0,0,0,0,0,0,0,0,2019,post
Handwalla Bwana,,M,0,0,0,0,0,0,0,0,0,0,0,0,0,0,0,2019,post
Keaton Parks,,M,1,1,60,0,0,0,0,0,0,0,0,1,0,0,0,2019,post
Isaac Angking,,M,0,0,0,0,0,0,0,0,0,0,0,0,0,0,0,2019,post
Efrain Alvarez,,M,0,0,0,0,0,0,0,0,0,0,0,0,0,0,0,2019,post
Nicolas Firmino,,M,0,0,0,0,0,0,0,0,0,0,0,0,0,0,0,2019,post
Bryan Reynolds,,D,0,0,0,0,0,0,0,0,0,0,0,0,0,0,0,2019,post
Luis Arriaga,,F,0,0,0,0,0,0,0,0,0,0,0,0,0,0,0,2019,post
Liam Fraser,,M,0,0,0,0,0,0,0,0,0,0,0,0,0,0,0,2019,post
Jacori Hayes,,M,1,0,31,0,0,0,0,0,0,0,0,0,0,0,0,2019,post
Jean-Christophe Koffi,,M,0,0,0,0,0,0,0,0,0,0,0,0,0,0,0,2019,post
Gordon Wild,,F,0,0,0,0,0,0,0,0,0,0,0,0,0,0,0,2019,post
Cory Burke,,F,0,0,0,0,0,0,0,0,0,0,0,0,0,0,0,2019,post
Luiz Fernando,,M,0,0,0,0,0,0,0,0,0,0,0,0,0,0,0,2019,post
Mark-Anthony Kaye,,M,1,0,46,0,0,0,0,0,0,0,0,2,1,0,0,2019,post
Derrick Jones,,M,0,0,0,0,0,0,0,0,0,0,0,0,0,0,0,2019,post
Nick Besler,,M,0,0,0,0,0,0,0,0,0,0,0,0,0,0,0,2019,post
Brandon Vazquez,,F,0,0,0,0,0,0,0,0,0,0,0,0,0,0,0,2019,post
Tomas Conechny,,M,0,0,0,0,0,0,0,0,0,0,0,0,0,0,0,2019,post
Luis Alberto Caicedo,,M,0,0,0,0,0,0,0,0,0,0,0,0,0,0,0,2019,post
Andrew Carleton,,M,0,0,0,0,0,0,0,0,0,0,0,0,0,0,0,2019,post
Chris Goslin,,M,0,0,0,0,0,0,0,0,0,0,0,0,0,0,0,2019,post
Justin Rennicks,,F,0,0,0,0,0,0,0,0,0,0,0,0,0,0,0,2019,post
Alex Muyl,,M,1,0,91,0,0,0,0,0,0,0,0,1,3,0,0,2019,post
Ulises Segura,,M,1,1,78,0,0,0,0,0,0,0,0,1,0,0,0,2019,post
Chris Durkin,,M,0,0,0,0,0,0,0,0,0,0,0,0,0,0,0,2019,post
Tony Rocha,,M,0,0,0,0,0,0,0,0,0,0,0,0,0,0,0,2019,post
Justin Dhillon,,F,0,0,0,0,0,0,0,0,0,0,0,0,0,0,0,2019,post
Amro Tarek,,D,0,0,0,0,0,0,0,0,0,0,0,0,0,0,0,2019,post
Daniel Bedoya,,M,0,0,0,0,0,0,0,0,0,0,0,0,0,0,0,2019,post
James Sands,,M,0,0,0,0,0,0,0,0,0,0,0,0,0,0,0,2019,post
Ayo Akinola,,F,0,0,0,0,0,0,0,0,0,0,0,0,0,0,0,2019,post
Michael Parkhurst,,D,2,2,171,0,0,0,0,0,0,0,0,1,1,0,0,2019,post
Edgar Castillo,,D,0,0,0,0,0,0,0,0,0,0,0,0,0,0,0,2019,post
Jorge Villafaña,,F,1,1,89,0,0,0,0,0,0,0,0,1,2,0,0,2019,post
Ilsinho,,M,2,0,96,0,0,0,0,0,0,0,0,4,0,1,0,2019,post
Claude Dielna,,D,1,0,1,0,0,0,0,0,0,0,0,0,0,0,0,2019,post
Aurelien Collin,,D,0,0,0,0,0,0,0,0,0,0,0,0,0,0,0,2019,post
Wilfried Moimbe,,D,0,0,0,0,0,0,0,0,0,0,0,0,0,0,0,2019,post
Brek Shea,,D,0,0,0,0,0,0,0,0,0,0,0,0,0,0,0,2019,post
Tony Beltran,,D,0,0,0,0,0,0,0,0,0,0,0,0,0,0,0,2019,post
Michael Mancienne,,D,0,0,0,0,0,0,0,0,0,0,0,0,0,0,0,2019,post
Gary Mackay-Steven,,F,0,0,0,0,0,0,0,0,0,0,0,0,0,0,0,2019,post
Jordan Harvey,,D,2,2,180,0,0,0,0,0,0,0,0,3,2,0,0,2019,post
Nedum Onuoha,,D,2,2,180,0,0,0,0,0,0,0,0,2,1,1,0,2019,post
Larrys Mabiala,,D,1,1,90,0,0,0,0,0,0,0,0,0,1,0,0,2019,post
Felipe,,M,1,1,44,0,0,0,0,0,0,0,0,2,1,0,0,2019,post
Kevin Kratz,,M,0,0,0,0,0,0,0,0,0,0,0,0,0,0,0,2019,post
Antonio Mlinar Delamea,,D,1,1,85,0,0,0,0,0,0,0,0,3,0,1,0,2019,post
Jorgen Skjelvik,,D,0,0,0,0,0,0,0,0,0,0,0,0,0,0,0,2019,post
Rasmus Schuller,,M,0,0,0,0,0,0,0,0,0,0,0,0,0,0,0,2019,post
Leonardo Jara,,D,1,0,15,0,0,0,0,0,0,0,0,1,0,1,0,2019,post
Chris Pontius,,M,0,0,0,0,0,0,0,0,0,0,0,0,0,0,0,2019,post
Quincy Amarikwa,,F,0,0,0,0,0,0,0,0,0,0,0,0,0,0,0,2019,post
Osvaldo Alonso,,M,1,1,90,0,0,0,0,0,0,0,0,2,2,1,0,2019,post
Dejan Jakovic,,D,1,0,16,0,0,0,0,0,0,0,0,0,1,0,0,2019,post
Danilo Silva,,D,0,0,0,0,0,0,0,0,0,0,0,0,0,0,0,2019,post
Eric Alexander,,M,0,0,0,0,0,0,0,0,0,0,0,0,0,0,0,2019,post
Juninho,,M,0,0,0,0,0,0,0,0,0,0,0,0,0,0,0,2019,post
Steven Beitashour,,D,1,1,59,0,0,0,0,0,0,0,0,3,0,0,0,2019,post
Carles Gil,,F,1,1,90,0,0,0,0,0,0,0,0,2,3,0,0,2019,post
Alexander Ring,,M,1,1,90,0,0,0,0,0,0,0,0,1,0,0,0,2019,post
Romain Metanire,,D,1,1,90,0,0,0,0,0,0,0,0,0,1,0,0,2019,post
Edwin Gyasi,,M,0,0,0,0,0,0,0,0,0,0,0,0,0,0,0,2019,post
Justin Meram,,M,1,1,65,0,0,0,0,0,0,0,0,0,0,0,0,2019,post
Jalil Anibaba,,D,0,0,0,0,0,0,0,0,0,0,0,0,0,0,0,2019,post
Zarek Valentin,,D,0,0,0,0,0,0,0,0,0,0,0,0,0,0,0,2019,post
Servando Carrasco,,M,1,0,1,0,0,0,0,0,0,0,0,0,0,0,0,2019,post
Will Bruin,,F,0,0,0,0,0,0,0,0,0,0,0,0,0,0,0,2019,post
Perry Kitchen,,M,2,2,168,0,0,0,0,0,0,0,0,1,0,1,0,2019,post
Joao Plata,,F,2,0,30,0,0,0,0,0,0,0,0,0,2,0,0,2019,post
Moises Hernandez,,D,0,0,0,0,0,0,0,0,0,0,0,0,0,0,0,2019,post
Diego Fagundez,,M,1,0,10,0,0,0,0,0,0,0,0,0,0,0,0,2019,post
Connor Lade,,D,0,0,0,0,0,0,0,0,0,0,0,0,0,0,0,2019,post
RJ Allen,,D,0,0,0,0,0,0,0,0,0,0,0,0,0,0,0,2019,post
Warren Creavalle,,M,1,0,8,0,0,0,0,0,0,0,0,0,0,0,0,2019,post
Wilfried Zahibo,,M,1,1,80,0,0,0,0,0,0,0,0,1,0,1,0,2019,post
Lawrence Olum,,D,0,0,0,0,0,0,0,0,0,0,0,0,0,0,0,2019,post
Kacper Przybylko,,F,0,0,0,0,0,0,0,0,0,0,0,0,0,0,0,2019,post
Rodolfo Zelaya,,F,0,0,0,0,0,0,0,0,0,0,0,0,0,0,0,2019,post
Andres Flores,,M,0,0,0,0,0,0,0,0,0,0,0,0,0,0,0,2019,post
Heber,,F,1,0,30,0,0,0,0,0,0,0,0,0,1,0,0,2019,post
Joe Corona,,M,0,0,0,0,0,0,0,0,0,0,0,0,0,0,0,2019,post
Ashtone Morgan,,D,0,0,0,0,0,0,0,0,0,0,0,0,0,0,0,2019,post
Donny Toia,,D,2,2,180,0,0,0,0,0,0,0,0,1,2,0,0,2019,post
Diego Chara,,M,1,1,90,0,0,0,0,0,0,0,0,1,0,0,0,2019,post
Marquinhos Pedroso,,D,0,0,0,0,0,0,0,0,0,0,0,0,0,0,0,2019,post
Kim Kee-hee,,D,4,4,390,0,0,0,0,0,0,0,0,3,2,0,0,2019,post
Junior Moreno,,M,1,1,120,0,0,0,0,0,0,0,0,2,1,0,0,2019,post
Ryan Hollingshead,,M,1,1,120,0,0,0,0,0,0,0,0,0,1,0,0,2019,post
Sebastien Ibeagha,,D,0,0,0,0,0,0,0,0,0,0,0,0,0,0,0,2019,post
Sean Davis,,M,1,0,50,0,0,0,0,0,0,0,0,0,0,0,0,2019,post
Jalen Robinson,,D,0,0,0,0,0,0,0,0,0,0,0,0,0,0,0,2019,post
Collin Martin,,M,0,0,0,0,0,0,0,0,0,0,0,0,0,0,0,2019,post
Fabinho,,D,0,0,0,0,0,0,0,0,0,0,0,0,0,0,0,2019,post
Jonathan Campbell,,D,0,0,0,0,0,0,0,0,0,0,0,0,0,0,0,2019,post
Mikey Ambrose,,D,1,1,84,0,0,0,0,0,0,0,0,0,3,0,0,2019,post
Jay Chapman,,M,0,0,0,0,0,0,0,0,0,0,0,0,0,0,0,2019,post
Mohamed El-Munir,,D,0,0,0,0,0,0,0,0,0,0,0,0,0,0,0,2019,post
Miguel Ibarra ,,M,0,0,0,0,0,0,0,0,0,0,0,0,0,0,0,2019,post
Kelyn Rowe,,M,1,0,1,0,0,0,0,0,0,0,0,0,0,0,0,2019,post
Mathias Jorgensen,,F,0,0,0,0,0,0,0,0,0,0,0,0,0,0,0,2019,post
Michee Ngalina,,F,0,0,0,0,0,0,0,0,0,0,0,0,0,0,0,2019,post
Emil Cuello,,M,0,0,0,0,0,0,0,0,0,0,0,0,0,0,0,2019,post
Hassani Dotson,,M-D,0,0,0,0,0,0,0,0,0,0,0,0,0,0,0,2019,post
Javi Perez,,M,0,0,0,0,0,0,0,0,0,0,0,0,0,0,0,2019,post
Callum Montgomery,,D,0,0,0,0,0,0,0,0,0,0,0,0,0,0,0,2019,post
Antonio Bustamante,,M,0,0,0,0,0,0,0,0,0,0,0,0,0,0,0,2019,post
Sean Nealis,,D,0,0,0,0,0,0,0,0,0,0,0,0,0,0,0,2019,post
Jacob Shaffelburg,,M-F,0,0,0,0,0,0,0,0,0,0,0,0,0,0,0,2019,post
Olivier Mbaizo,,D,0,0,0,0,0,0,0,0,0,0,0,0,0,0,0,2019,post
Tate Schmitt,,M,0,0,0,0,0,0,0,0,0,0,0,0,0,0,0,2019,post
Alex Roldan,,M,0,0,0,0,0,0,0,0,0,0,0,0,0,0,0,2019,post
Juan Pablo Torres,,M,0,0,0,0,0,0,0,0,0,0,0,0,0,0,0,2019,post
Griffin Dorsey,,M,0,0,0,0,0,0,0,0,0,0,0,0,0,0,0,2019,post
Tajon Buchanan,,F,0,0,0,0,0,0,0,0,0,0,0,0,0,0,0,2019,post
Edwin Cerrillo,,M,1,0,12,0,0,0,0,0,0,0,0,0,0,0,0,2019,post
Thomas Roberts,,M,0,0,0,0,0,0,0,0,0,0,0,0,0,0,0,2019,post
George Bello,,D,0,0,0,0,0,0,0,0,0,0,0,0,0,0,0,2019,post
Julian Vazquez,,F,0,0,0,0,0,0,0,0,0,0,0,0,0,0,0,2019,post
Justin Haak,,M,0,0,0,0,0,0,0,0,0,0,0,0,0,0,0,2019,post
Joe Scally,,D,0,0,0,0,0,0,0,0,0,0,0,0,0,0,0,2019,post
Alfonso Ocampo-Chavez,,F,0,0,0,0,0,0,0,0,0,0,0,0,0,0,0,2019,post
Diedie Traore,,D,0,0,0,0,0,0,0,0,0,0,0,0,0,0,0,2019,post
Griffin Yow,,F,0,0,0,0,0,0,0,0,0,0,0,0,0,0,0,2019,post
Julian Araujo,,D,0,0,0,0,0,0,0,0,0,0,0,0,0,0,0,2019,post
Ricardo Pepi,,F,0,0,0,0,0,0,0,0,0,0,0,0,0,0,0,2019,post
Danny Leyva,,M,0,0,0,0,0,0,0,0,0,0,0,0,0,0,0,2019,post
Brandon Bye,,D,1,1,90,0,0,0,0,0,0,0,0,0,1,0,0,2019,post
Wyatt Omsberg,,D,0,0,0,0,0,0,0,0,0,0,0,0,0,0,0,2019,post
Carter Manley,,D,0,0,0,0,0,0,0,0,0,0,0,0,0,0,0,2019,post
Ema Twumasi,,F,0,0,0,0,0,0,0,0,0,0,0,0,0,0,0,2019,post
Brian White,,F,1,0,23,0,0,0,0,0,0,0,0,1,0,0,0,2019,post
Thomas Chacon,,M,0,0,0,0,0,0,0,0,0,0,0,0,0,0,0,2019,post
Diego Palacios,,D,0,0,0,0,0,0,0,0,0,0,0,0,0,0,0,2019,post
Cristian Casseres Jr.,,M,1,1,120,0,0,1,0,0,0,0,0,2,2,1,0,2019,post
Kai Wagner,,D,2,2,202,0,0,1,1,0,0,0,0,4,0,1,0,2019,post
Luis Silva,,F,1,0,10,0,0,1,1,0,0,0,0,0,0,0,0,2019,post
Raymon Gaddis,,D,2,2,210,0,0,1,0,0,0,0,0,3,0,0,0,2019,post
Daniel Steres ,,D,2,2,180,0,0,1,0,0,0,0,0,0,2,0,0,2019,post
Andrew Wooten,,F,2,1,70,0,0,1,0,0,0,0,0,0,0,0,0,2019,post
Everton Luiz,,M,2,2,173,0,0,1,0,0,0,0,0,5,3,0,1,2019,post
Steven Birnbaum,,D,1,1,120,0,0,1,0,0,0,0,0,2,1,0,0,2019,post
Emerson Hyndman,,M,2,1,82,0,0,1,0,0,0,0,0,1,1,0,0,2019,post
Giancarlo Gonzalez,,D,2,2,163,0,0,1,1,0,0,0,0,1,1,1,0,2019,post
Ethan Finlay,,M,1,1,60,0,0,1,0,0,0,0,0,1,2,0,0,2019,post
Kevin Molino,,M,1,1,90,0,0,1,0,0,0,0,0,1,2,0,0,2019,post
Ike Opara,,D,1,1,90,0,0,1,0,0,0,0,0,0,1,0,0,2019,post
Jorge Moreira,,D,1,1,90,0,0,1,0,0,0,0,0,2,1,0,0,2019,post
Florentin Pogba,,D,3,2,205,0,0,1,0,0,0,0,0,2,2,0,0,2019,post
Chris Mavinga,,D,4,4,377,0,0,1,0,0,0,0,0,3,2,0,0,2019,post
Maxime Chanot,,D,1,1,90,0,0,1,0,0,0,0,0,0,0,0,0,2019,post
Drew Moor,,D,1,0,31,0,0,1,1,0,0,0,0,0,0,0,0,2019,post
Roman Torres,,D,4,3,261,0,0,1,0,0,0,0,0,1,1,0,0,2019,post
Kyle Beckerman,,M,2,2,170,0,0,1,0,0,0,0,0,4,3,1,0,2019,post
Bradley Wright-Phillips,,F,1,0,36,0,0,1,0,0,0,0,0,1,0,0,0,2019,post
Cristhian Paredes,,M,1,1,90,0,0,1,0,0,0,0,0,2,3,0,0,2019,post
Dave Romney,,D,2,2,180,0,0,1,1,0,0,0,0,1,0,0,0,2019,post
Jesus Ferreira,,F,1,1,78,0,0,1,0,0,0,0,0,0,0,0,0,2019,post
Nouhou Tolo,,D,2,0,36,0,0,1,1,0,0,0,0,2,0,1,0,2019,post
Uriel Antuna,,M,2,2,131,0,0,1,0,0,0,0,0,0,4,0,0,2019,post
Tristan Blackmon,,D,2,2,180,0,0,1,0,0,0,0,0,1,1,0,0,2019,post
Mason Toye,,F,1,0,23,0,0,1,0,0,0,0,0,1,0,0,0,2019,post
Aaron Herrera,,D,2,2,180,0,0,1,1,0,0,0,0,5,0,0,0,2019,post
Sam Johnson,,F,2,0,27,0,0,1,0,0,0,0,0,0,0,0,0,2019,post
Russell Canouse,,M,1,1,120,0,0,1,0,0,0,0,0,0,1,0,0,2019,post
Abu Danladi,,F,1,0,13,0,0,1,1,0,0,0,0,0,0,0,0,2019,post
Cristian Penilla,,F,1,1,90,0,0,1,1,0,0,0,0,3,0,0,0,2019,post
Juan Fernando Caicedo,,F,1,0,10,0,0,1,0,0,0,0,0,0,1,0,0,2019,post
Scott Caldwell,,M,1,1,90,0,0,1,0,0,0,0,0,2,0,0,0,2019,post
Jordy Delem,,M,4,0,56,0,0,1,0,0,0,0,0,1,0,0,0,2019,post
Luciano Acosta,,M-F,1,0,42,0,0,1,0,0,0,0,0,3,0,0,0,2019,post
Bill Tuiloma,,D-M,1,1,90,0,0,2,1,0,0,0,0,0,0,0,0,2019,post
Paul Arriola,,M-F,1,1,118,0,0,2,1,0,0,0,0,3,3,1,1,2019,post
Mark McKenzie,,D,2,2,210,0,0,2,0,0,0,0,0,1,2,0,0,2019,post
DeJuan Jones,,D,1,1,90,0,0,2,2,0,0,0,0,0,1,0,0,2019,post
Jeff Larentowicz,,M,3,3,270,0,0,2,0,0,0,0,0,6,3,1,0,2019,post
Diego Polenta,,D,2,2,180,0,0,2,0,0,0,0,0,3,1,1,0,2019,post
Ola Kamara,,F,1,0,76,0,0,2,1,0,0,0,0,0,1,0,0,2019,post
Diego Valeri,,M,1,0,27,0,0,2,1,0,0,0,0,0,0,0,0,2019,post
Anton Tinnerholm,,D,1,1,90,0,0,2,1,0,0,0,0,0,0,0,0,2019,post
Omar Gonzalez,,D,1,1,90,0,0,2,1,0,0,0,0,1,0,0,0,2019,post
Marcelo Silva,,D,1,1,90,0,0,2,0,0,0,0,0,0,0,0,0,2019,post
Zdenek Ondrasek,,F,1,1,89,0,0,2,0,0,0,0,0,2,2,0,0,2019,post
Juan Agudelo,,F,1,0,5,0,0,2,0,0,0,0,0,0,0,0,0,2019,post
Michael Boxall,,D,1,1,90,0,0,2,1,0,0,0,0,1,2,0,0,2019,post
Hector Villalba,,F,2,0,34,0,0,2,1,0,0,0,0,1,0,0,0,2019,post
Angelo Rodriguez,,F,1,1,67,0,0,2,0,0,0,0,0,0,0,0,0,2019,post
Alexandru Mitrita,,F,1,1,90,0,0,2,0,0,0,0,0,2,2,1,0,2019,post
Adrien Perez,,F,1,0,14,0,0,2,0,0,0,0,0,0,0,0,0,2019,post
Brenden Aaronson,,M,2,2,124,0,0,2,1,0,0,0,0,3,2,0,0,2019,post
Patrick Mullins,,F,3,0,55,0,0,3,3,0,0,0,0,3,0,0,0,2019,post
Darlington Nagbe,,M,3,3,270,0,0,3,1,0,0,0,0,3,5,0,0,2019,post
Robin Lod,,M,1,1,77,0,0,3,0,0,0,0,0,2,0,0,0,2019,post
Gustavo Bou,,F,1,1,90,0,0,3,1,0,0,0,0,1,0,0,0,2019,post
Paxton Pomykal,,M,1,0,43,0,0,3,1,0,0,0,0,1,0,0,0,2019,post
Brandon Servania,,M,1,1,108,0,0,3,1,0,0,0,0,4,0,0,0,2019,post
Santiago Mosquera,,M,1,0,42,0,0,3,2,0,0,0,0,1,0,0,0,2019,post
Albert Rusnak,,M,2,2,179,0,0,4,0,0,0,0,0,0,0,0,0,2019,post
Justin Morrow,,D,4,4,378,0,0,4,0,0,0,0,0,1,1,1,0,2019,post
Teal Bunbury,,F,1,1,80,0,0,4,2,0,0,0,0,1,1,0,0,2019,post
Tsubasa Endoh,,M,4,4,245,0,0,4,4,0,0,0,0,4,6,0,0,2019,post
Leandro Gonzalez Pirez,,D,3,3,270,0,0,5,2,0,0,0,0,7,4,1,0,2019,post
Jamiro Monteiro,,M,2,2,210,0,0,6,1,0,0,0,0,2,8,1,0,2019,post
Valentin Castellanos,,F,1,1,90,0,0,7,3,0,0,0,0,3,3,0,0,2019,post
Diego Rossi,LAFC,F,5,5,450,6,2,22,13,6,0,2,0,4,7,0,0,2020,reg
Ayo Akinola,Toronto FC,F,3,3,266,5,0,13,10,2,3,0,0,5,2,0,0,2020,reg
Gyasi Zardes,Columbus Crew SC,F,5,5,402,4,0,8,5,1,3,0,0,0,5,0,0,2020,reg
Chris Mueller,Orlando City SC,F,5,4,351,4,0,12,8,3,1,0,0,1,4,0,0,2020,reg
Alan Pulido,Sporting Kansas City,F,5,5,442,3,4,15,5,2,1,2,2,3,10,1,0,2020,reg
Lucas Zelarayan,Columbus Crew SC,M,5,4,324,3,2,9,4,2,1,0,2,2,8,0,0,2020,reg
Jordan Morris,FC Dallas,F,5,3,336,3,2,10,4,3,0,1,1,2,0,0,0,2020,reg
Saphir Taider,Montreal Impact,F,5,5,450,3,1,5,3,3,0,1,0,5,9,0,0,2020,reg
Kevin Molino,Minnesota United FC,M,4,4,257,3,1,6,3,0,3,0,1,2,14,0,0,2020,reg
Diego Valeri,Portland Timbers,M,5,4,342,3,1,6,3,3,0,0,1,3,0,1,0,2020,reg
Khiry Shelton,Sporting Kansas City,F,5,5,443,3,1,11,8,3,0,1,0,4,3,1,0,2020,reg
Maximiliano Urruti,Montreal Impact,F,5,5,386,3,1,12,5,1,2,1,0,3,4,1,0,2020,reg
Cristian Pavon,LA Galaxy,M,5,5,450,3,1,15,7,1,2,1,0,5,7,0,0,2020,reg
Jonathan Lewis,Colorado Rapids,F,5,0,74,3,0,6,4,1,2,0,0,1,2,1,0,2020,reg
Bradley Wright-Phillips,LAFC,F,3,3,198,3,0,6,6,3,0,0,0,2,4,0,0,2020,reg
Jeremy Ebobisse,Portland Timbers,F,5,2,204,3,0,8,4,1,2,0,0,2,2,0,0,2020,reg
Ethan Finlay,Minnesota United FC,M,5,5,421,2,2,4,3,0,2,0,2,7,5,0,0,2020,reg
Gadi Kinda,Sporting Kansas City,M,5,4,345,2,2,10,3,1,1,2,0,8,9,3,0,2020,reg
Youness Mokhtar,Columbus Crew SC,M,5,3,235,2,1,5,2,0,2,0,1,6,1,1,0,2020,reg
Zdenek Ondrasek,FC Dallas,F,2,2,180,2,1,8,3,2,0,1,0,3,1,1,0,2020,reg
Oswaldo Alanis,San Jose Earthquakes,D,4,4,333,2,1,8,3,1,1,1,0,2,3,0,0,2020,reg
Kei Kamara,Colorado Rapids,F,5,4,377,2,1,12,3,1,1,0,1,5,5,1,0,2020,reg
Ezequiel Barco,Atlanta United FC,M,5,4,367,2,1,13,5,1,1,1,0,1,19,1,0,2020,reg
Luis Amarilla,Minnesota United FC,F,4,3,267,2,1,14,5,0,2,0,1,3,5,2,0,2020,reg
Federico Higuain,DC United,F,3,0,51,2,0,2,2,1,1,0,0,1,1,1,0,2020,reg
Ike Opara,Minnesota United FC,D,2,2,180,2,0,2,2,0,2,0,0,6,2,0,0,2020,reg
Frederic Brillant,DC United,D,5,5,450,2,0,2,2,1,1,0,0,5,2,2,0,2020,reg
Richie Laryea,Toronto FC,M,5,2,299,2,0,3,2,0,2,0,0,2,4,0,0,2020,reg
Emerson Hyndman,Atlanta United FC,M,5,4,322,2,0,4,3,1,1,0,0,4,0,0,0,2020,reg
Chris Wondolowski,San Jose Earthquakes,F,5,0,101,2,0,5,5,0,2,0,0,1,0,1,0,2020,reg
Romell Quioto,Montreal Impact,M,5,4,376,2,0,6,3,2,0,0,0,3,7,1,0,2020,reg
Cristian Dajome,Vancouver Whitecaps,F,5,4,364,2,0,7,4,1,1,0,0,2,7,0,0,2020,reg
Yuya Kubo,FC Cincinnati,F,5,5,415,2,0,8,4,1,1,0,0,9,10,0,0,2020,reg
Rodolfo Pizarro,MIA,M,5,4,392,2,0,8,4,0,2,0,0,3,21,0,0,2020,reg
Damir Kreilach,Real Salt Lake,M,5,5,426,2,0,8,5,2,0,0,0,4,8,0,0,2020,reg
Andres Rios,San Jose Earthquakes,F,5,5,450,2,0,9,2,1,1,0,0,8,18,0,0,2020,reg
Alberth Elis,Houston Dynamo,F,2,2,175,2,0,10,3,0,2,0,0,7,2,1,1,2020,reg
Carlos Vela,LAFC,F,2,2,180,2,0,12,6,2,0,0,0,2,2,0,0,2020,reg
Adam Buksa,New England Revolution,F,5,5,432,2,0,14,7,1,1,0,0,4,9,0,0,2020,reg
Robert Beric,Chicago Fire FC,F,5,5,449,2,0,15,7,1,1,0,0,14,15,0,0,2020,reg
Memo Rodriguez,Houston Dynamo,M,5,5,369,2,0,16,5,0,2,0,0,7,11,1,0,2020,reg
Raul Ruidiaz ,FC Dallas,F,5,5,450,2,0,19,6,2,0,0,0,5,3,1,0,2020,reg
Alejandro Pozuelo,Toronto FC,M,5,5,423,1,5,12,4,0,1,2,3,6,1,0,0,2020,reg
Jan Gregus,Minnesota United FC,M,5,5,450,1,4,9,3,0,1,0,4,8,4,1,0,2020,reg
Sebastian Blanco,Portland Timbers,M-F,5,5,450,1,3,12,3,0,1,1,2,6,7,1,0,2020,reg
Brian Rodriguez,LAFC,F,5,5,450,1,3,19,6,1,0,3,0,6,14,0,0,2020,reg
Ali Adnan,Vancouver Whitecaps,D,5,5,433,1,2,1,1,1,0,0,2,3,9,0,0,2020,reg
Kyle Duncan,New York Red Bulls,D,5,5,450,1,2,5,1,1,0,2,0,13,6,2,0,2020,reg
Brenden Aaronson,Philadelphia Union,M,5,5,417,1,2,6,2,0,1,2,0,4,6,0,0,2020,reg
Florian Valot,New York Red Bulls,M,5,5,359,1,2,7,2,0,1,2,0,4,7,0,0,2020,reg
Nani,Orlando City SC,M,3,3,269,1,2,7,3,1,0,1,1,1,5,0,0,2020,reg
Darwin Quintero,Houston Dynamo,F,4,3,268,1,2,9,3,0,1,0,2,1,4,1,0,2020,reg
Cristian Espinoza,San Jose Earthquakes,M,5,5,424,1,2,15,6,0,1,1,1,5,5,1,0,2020,reg
Gerso Fernandes,Sporting Kansas City,F,5,1,153,1,1,4,2,0,1,0,1,2,4,0,0,2020,reg
Handwalla Bwana,FC Dallas,M,2,1,111,1,1,4,2,0,1,1,0,3,0,0,0,2020,reg
Mauricio Pineda,Chicago Fire FC,D-M,5,5,418,1,1,5,1,1,0,1,0,6,0,1,0,2020,reg
Alejandro Romero Gamarra,New York Red Bulls,M,5,5,333,1,1,5,2,1,0,0,1,0,3,0,0,2020,reg
Yordy Reyna,Vancouver Whitecaps,M-F,4,3,286,1,1,6,2,0,1,0,1,4,9,1,0,2020,reg
Mark-Anthony Kaye,LAFC,M,5,5,367,1,1,6,1,1,0,1,0,3,6,0,0,2020,reg
Sergio Santos,Philadelphia Union,F,4,4,266,1,1,7,2,0,1,0,1,12,2,1,0,2020,reg
Johnny Russell,Sporting Kansas City,F,5,4,297,1,1,7,2,0,1,1,0,4,4,0,0,2020,reg
Nicolás Lodeiro,FC Dallas,M,3,3,270,1,1,7,3,1,0,1,0,1,7,0,0,2020,reg
Alejandro Bedoya,Philadelphia Union,M,5,5,438,1,1,8,2,0,1,1,0,6,3,2,0,2020,reg
Magnus Eriksson,San Jose Earthquakes,F,5,5,450,1,1,10,1,1,0,0,1,4,6,1,0,2020,reg
Daniel Royer,New York Red Bulls,M,5,5,419,1,1,12,3,1,0,1,0,1,11,0,0,2020,reg
Gustavo Bou,New England Revolution,F,5,4,390,1,1,22,8,0,1,0,1,2,7,0,0,2020,reg
Ilsinho,Philadelphia Union,M,5,1,176,1,0,1,1,1,0,0,0,1,2,0,0,2020,reg
Paxton Pomykal,FC Dallas,M,2,0,42,1,0,1,1,1,0,0,0,0,1,0,0,2020,reg
Jake Nerwinski,Vancouver Whitecaps,D,4,4,360,1,0,1,1,1,0,0,0,5,3,0,0,2020,reg
Ricardo Pepi,FC Dallas,F,2,0,15,1,0,2,1,1,0,0,0,1,0,0,0,2020,reg
Jakob Glesnes,Philadelphia Union,D,5,3,294,1,0,2,1,0,1,0,0,4,0,3,0,2020,reg
Jaroslaw Niezgoda,Portland Timbers,F,3,1,89,1,0,2,1,0,1,0,0,0,1,0,0,2020,reg
Russell Canouse,DC United,M,5,5,450,1,0,2,1,1,0,0,0,13,5,2,0,2020,reg
Shea Salinas,San Jose Earthquakes,M,5,0,146,1,0,2,1,0,1,0,0,0,1,0,0,2020,reg
Jonathan Bornstein,Chicago Fire FC,D,4,4,276,1,0,2,2,0,1,0,0,2,3,0,0,2020,reg
Erik Hurtado,Sporting Kansas City,F,3,0,8,1,0,2,1,0,1,0,0,1,0,0,0,2020,reg
Achara,Toronto FC,F,1,1,89,1,0,2,2,1,0,0,0,1,1,0,0,2020,reg
Cristian Casseres Jr.,New York Red Bulls,M,5,5,379,1,0,3,2,0,1,0,0,7,4,1,0,2020,reg
Yamil Asad,DC United,M,5,3,285,1,0,3,1,1,0,0,0,5,7,1,0,2020,reg
Mohamed El-Munir,LAFC,D,4,0,81,1,0,3,1,1,0,0,0,4,2,0,0,2020,reg
Tosaint Ricketts,Vancouver Whitecaps,F,2,1,99,1,0,3,1,0,1,0,0,0,3,0,0,2020,reg
Kai Wagner,Philadelphia Union,D,3,3,270,1,0,3,1,1,0,0,0,2,1,0,0,2020,reg
Younes Namli,Colorado Rapids,M,5,5,388,1,0,4,2,1,0,0,0,6,7,2,0,2020,reg
Tesho Akindele,Orlando City SC,F-M,5,3,303,1,0,4,2,1,0,0,0,2,3,0,0,2020,reg
Teal Bunbury,New England Revolution,F,5,3,222,1,0,4,1,0,1,0,0,2,3,0,0,2020,reg
Mauricio Pereyra,Orlando City SC,M,5,4,359,1,0,4,2,0,1,0,0,6,8,2,0,2020,reg
Drew Moor,Colorado Rapids,D,4,4,360,1,0,4,2,1,0,0,0,4,5,2,0,2020,reg
Jesus Medina,New York City FC,M,5,4,266,1,0,4,2,0,1,0,0,3,0,0,0,2020,reg
Walker Zimmerman,Nashville SC,D,2,2,180,1,0,4,2,1,0,0,0,1,0,0,0,2020,reg
Ismael Tajouri-Shradi,New York City FC,F,4,2,218,1,0,4,1,0,1,0,0,2,3,0,0,2020,reg
Graham Zusi,Sporting Kansas City,M,5,5,450,1,0,5,2,1,0,0,0,6,3,0,0,2020,reg
Juan Agudelo,MIA,F,4,2,219,1,0,5,2,0,1,0,0,8,6,2,1,2020,reg
Allan Cruz,FC Cincinnati,M,3,2,207,1,0,5,2,0,1,0,0,5,2,1,0,2020,reg
Frankie Amaya,FC Cincinnati,M,5,5,439,1,0,5,2,0,1,0,0,15,4,3,0,2020,reg
Eddie Segura,LAFC,D,5,5,450,1,0,6,2,1,0,0,0,4,1,0,0,2020,reg
Albert Rusnak,Real Salt Lake,M,4,4,292,1,0,7,2,1,0,0,0,1,4,0,0,2020,reg
Javier Hernandez,LA Galaxy,F,3,3,270,1,0,7,2,1,0,0,0,1,4,0,0,2020,reg
Roger Espinoza,Sporting Kansas City,M,5,5,418,1,0,8,2,1,0,0,0,4,5,1,0,2020,reg
Jurgen Locadia,FC Cincinnati,F,2,1,116,1,0,8,4,0,1,0,0,1,2,0,0,2020,reg
Robin Lod,Minnesota United FC,M,5,5,422,1,0,10,4,0,1,0,0,12,2,2,0,2020,reg
Mauro Manotas,Houston Dynamo,F,5,5,412,1,0,10,5,1,0,0,0,2,5,0,0,2020,reg
Kacper Przybylko,Philadelphia Union,F,5,5,450,1,0,11,6,1,0,0,0,4,9,0,0,2020,reg
Kellyn Acosta,Colorado Rapids,M,5,5,433,1,0,11,6,0,1,0,0,5,4,2,0,2020,reg
Vako,San Jose Earthquakes,M,5,5,379,1,0,14,8,1,0,0,0,4,4,0,0,2020,reg
Latif Blessing,LAFC,F,5,5,449,0,4,3,1,0,0,4,0,9,11,0,0,2020,reg
Francisco Ginella,LAFC,M,5,2,223,0,3,2,0,0,0,3,0,2,0,0,0,2020,reg
Romain Metanire,Minnesota United FC,D,5,5,450,0,2,1,1,0,0,0,2,5,5,1,0,2020,reg
Nicolas Benezet,Colorado Rapids,F,3,3,200,0,2,2,1,0,0,1,1,2,10,1,0,2020,reg
Luis Martins,Sporting Kansas City,D,5,5,426,0,2,2,1,0,0,1,1,6,2,0,0,2020,reg
Jack Price,Colorado Rapids,M,4,4,343,0,2,2,1,0,0,1,1,6,1,1,1,2020,reg
Djordje Mihailovic,Chicago Fire FC,M,4,2,200,0,2,2,0,0,0,0,2,1,3,0,0,2020,reg
David Milinkovic,Vancouver Whitecaps,M,5,4,328,0,2,4,1,0,0,2,0,0,2,0,0,2020,reg
Keegan Rosenberry,Colorado Rapids,D,4,4,360,0,2,4,1,0,0,1,1,4,4,0,0,2020,reg
Matias Pellegrini,MIA,M,5,4,307,0,2,4,1,0,0,0,2,6,8,0,0,2020,reg
Adrien Regattin,FC Cincinnati,M,5,4,333,0,2,5,2,0,0,0,2,2,4,0,0,2020,reg
Felipe,DC United,M,5,5,450,0,2,8,2,0,0,0,2,7,17,2,0,2020,reg
Cristian Roldan,FC Dallas,M,5,5,450,0,2,8,4,0,0,2,0,1,3,0,0,2020,reg
Lewis Morgan,MIA,M,5,5,428,0,2,9,3,0,0,0,2,2,7,0,0,2020,reg
Pity Martinez,Atlanta United FC,M,5,5,411,0,2,11,4,0,0,2,0,7,19,1,0,2020,reg
Chris Cadden,Columbus Crew SC,D-M,4,1,167,0,1,0,0,0,0,1,0,2,3,0,0,2020,reg
Greg Garza,FC Cincinnati,D,3,3,207,0,1,0,0,0,0,0,1,1,1,1,0,2020,reg
João Paulo,FC Dallas,M,2,2,180,0,1,0,0,0,0,1,0,6,4,2,0,2020,reg
Roberto Puncec,Sporting Kansas City,D,5,5,450,0,1,0,0,0,0,0,1,9,3,0,0,2020,reg
Zarek Valentin,Houston Dynamo,D,5,5,450,0,1,0,0,0,0,1,0,0,0,0,0,2020,reg
Hector Jimenez,Columbus Crew SC,M,3,2,225,0,1,0,0,0,0,0,1,2,2,1,0,2020,reg
Franco Escobar,Atlanta United FC,D,4,4,297,0,1,0,0,0,0,0,1,7,5,3,0,2020,reg
Milton Valenzuela,Columbus Crew SC,D,3,3,180,0,1,0,0,0,0,0,1,3,1,1,0,2020,reg
Ruan,Orlando City SC,D,5,4,377,0,1,0,0,0,0,1,0,4,7,1,0,2020,reg
Reggie Cannon,FC Dallas,D,2,2,180,0,1,0,0,0,0,1,0,2,7,1,0,2020,reg
Gordon Wild,LA Galaxy,F,2,0,29,0,1,0,0,0,0,1,0,1,2,0,0,2020,reg
Tanner Tessmann,FC Dallas,M,2,2,152,0,1,0,0,0,0,1,0,1,1,0,0,2020,reg
Emanuel Maciel,Montreal Impact,M,1,1,73,0,1,0,0,0,0,1,0,0,1,1,0,2020,reg
Ryan Raposo,Vancouver Whitecaps,M,4,1,132,0,1,0,0,0,0,0,1,0,5,0,0,2020,reg
Cole Bassett,Colorado Rapids,M,2,1,62,0,1,1,0,0,0,0,1,0,0,0,0,2020,reg
Raheem Edwards,Minnesota United FC,M,4,0,28,0,1,1,0,0,0,0,1,2,1,0,0,2020,reg
Orji Okwonkwo,Montreal Impact,M,4,1,110,0,1,1,0,0,0,0,1,7,2,0,0,2020,reg
Tommy Thompson,San Jose Earthquakes,D,5,4,301,0,1,1,0,0,0,0,1,2,5,2,0,2020,reg
Andy Polo,Portland Timbers,M,4,2,191,0,1,1,0,0,0,1,0,3,3,0,0,2020,reg
Dom Dwyer,Orlando City SC,F,2,2,124,0,1,1,0,0,0,1,0,7,1,0,0,2020,reg
Larrys Mabiala,Portland Timbers,D,4,4,360,0,1,1,0,0,0,1,0,2,3,1,0,2020,reg
Carlos Fierro,San Jose Earthquakes,M,4,0,68,0,1,1,1,0,0,0,1,1,3,1,0,2020,reg
Steven Birnbaum,DC United,D,5,5,450,0,1,2,0,0,0,0,1,10,3,0,0,2020,reg
Kelvin Leerdam,FC Dallas,D,5,5,421,0,1,2,0,0,0,1,0,4,4,1,0,2020,reg
Thiago Santos,FC Dallas,M,2,2,180,0,1,2,0,0,0,1,0,6,7,0,0,2020,reg
Bill Tuiloma,Portland Timbers,D-M,3,2,192,0,1,2,1,0,0,0,1,2,3,0,0,2020,reg
Joel Waterman,Montreal Impact,D,2,2,180,0,1,2,0,0,0,1,0,1,3,0,0,2020,reg
Eryk Williamson,Portland Timbers,M,4,2,179,0,1,2,1,0,0,1,0,3,3,1,0,2020,reg
Marvin Loria,Portland Timbers,M,3,2,124,0,1,2,1,0,0,0,1,2,2,0,0,2020,reg
Julian Gressel,DC United,M,5,5,378,0,1,3,0,0,0,1,0,5,4,1,0,2020,reg
Andres Perea,Orlando City SC,M,5,1,111,0,1,3,1,0,0,0,1,1,1,0,0,2020,reg
Xavier Arreaga,FC Dallas,D,5,5,423,0,1,3,1,0,0,0,1,4,8,1,0,2020,reg
Brandon Vazquez,FC Cincinnati,F,5,1,140,0,1,3,1,0,0,0,1,6,3,0,0,2020,reg
Bojan Krkic,Montreal Impact,M,4,3,246,0,1,3,1,0,0,1,0,3,2,0,0,2020,reg
Nick DeLeon,Toronto FC,M,3,1,82,0,1,3,1,0,0,0,1,3,1,0,0,2020,reg
Inbeom Hwang,Vancouver Whitecaps,M,5,5,450,0,1,3,0,0,0,1,0,2,6,0,0,2020,reg
Brandon Bye,New England Revolution,D,5,5,450,0,1,4,1,0,0,1,0,5,1,0,0,2020,reg
Diego Rubio,Colorado Rapids,F,5,2,209,0,1,4,1,0,0,0,1,5,9,1,0,2020,reg
Carles Gil,New England Revolution,F,2,2,152,0,1,4,1,0,0,0,1,0,4,0,0,2020,reg
Jamiro Monteiro,Philadelphia Union,M,5,5,441,0,1,4,2,0,0,0,1,11,6,1,0,2020,reg
Derrick Etienne Jr.,Columbus Crew SC,M,4,1,189,0,1,4,0,0,0,1,0,7,7,0,0,2020,reg
Corey Baird,Real Salt Lake,F,5,4,363,0,1,4,0,0,0,1,0,5,7,1,0,2020,reg
Robbie Robinson,MIA,F,2,2,134,0,1,4,0,0,0,0,1,4,4,0,0,2020,reg
Jackson Yueill,San Jose Earthquakes,M,5,5,450,0,1,4,3,0,0,0,1,7,4,2,0,2020,reg
Jose Cifuentes,LAFC,M,4,0,57,0,1,4,1,0,0,1,0,0,1,0,0,2020,reg
Artur,Columbus Crew SC,M,5,4,379,0,1,5,2,0,0,0,1,7,5,1,0,2020,reg
Aaron Herrera,Real Salt Lake,D,5,5,450,0,1,5,1,0,0,1,0,6,2,2,0,2020,reg
Jesus Ferreira,FC Dallas,F,2,2,152,0,1,5,2,0,0,1,0,1,1,0,0,2020,reg
Victor Ulloa,MIA,M,5,5,413,0,1,5,1,0,0,0,1,9,5,1,0,2020,reg
Heber,New York City FC,F,4,4,340,0,1,5,2,0,0,0,1,7,6,1,0,2020,reg
Gaston Gimenez,Chicago Fire FC,M,4,3,297,0,1,5,2,0,0,1,0,8,2,2,0,2020,reg
Joao Moutinho,Orlando City SC,D,5,5,432,0,1,5,0,0,0,1,0,5,1,3,0,2020,reg
Junior Urso,Orlando City SC,M,5,5,352,0,1,6,2,0,0,0,1,5,7,0,0,2020,reg
Pablo Piatti,Toronto FC,M,3,3,206,0,1,6,2,0,0,0,1,2,11,0,0,2020,reg
Pedro Santos,Columbus Crew SC,M,4,4,298,0,1,7,4,0,0,1,0,5,8,2,0,2020,reg
Cristian Penilla,New England Revolution,F,5,4,375,0,1,7,2,0,0,0,1,8,8,0,0,2020,reg
Alvaro Medran,Chicago Fire FC,M,5,5,434,0,1,9,1,0,0,0,1,8,10,1,0,2020,reg
Alexandru Mitrita,New York City FC,F,4,3,263,0,1,9,2,0,0,0,1,2,6,0,0,2020,reg
Luis Diaz,Columbus Crew SC,M,5,3,272,0,1,10,4,0,0,0,1,8,8,2,0,2020,reg
Eduard Atuesta,LAFC,M,5,4,389,0,1,11,1,0,0,1,0,7,5,3,0,2020,reg
Christian Makoun,MIA,D,1,0,11,0,0,0,0,0,0,0,0,0,0,0,0,2020,reg
Derrick Jones,Nashville SC,M,0,0,0,0,0,0,0,0,0,0,0,0,0,0,0,2020,reg
Luiz Fernando,Atlanta United FC,M,0,0,0,0,0,0,0,0,0,0,0,0,0,0,0,2020,reg
Cory Burke,Philadelphia Union,F,0,0,0,0,0,0,0,0,0,0,0,0,0,0,0,2020,reg
Matej Oravec,Philadelphia Union,M,0,0,0,0,0,0,0,0,0,0,0,0,0,0,0,2020,reg
Jon Gallagher,Atlanta United FC,F,1,0,45,0,0,0,0,0,0,0,0,1,4,0,0,2020,reg
Marco Farfan,Portland Timbers,D,1,1,89,0,0,0,0,0,0,0,0,1,0,0,0,2020,reg
Francis Atuahene,FC Dallas,F,0,0,0,0,0,0,0,0,0,0,0,0,0,0,0,2020,reg
Donovan Pines,DC United,D,0,0,0,0,0,0,0,0,0,0,0,0,0,0,0,2020,reg
Amar Sejdic,Montreal Impact,M,2,0,4,0,0,0,0,0,0,0,0,0,0,0,0,2020,reg
Grant Lillard,MIA,D,0,0,0,0,0,0,0,0,0,0,0,0,0,0,0,2020,reg
Jeremiah Gutjahr,Chicago Fire FC,M,0,0,0,0,0,0,0,0,0,0,0,0,0,0,0,2020,reg
Kortne Ford,Colorado Rapids,D,0,0,0,0,0,0,0,0,0,0,0,0,0,0,0,2020,reg
Denso Ulysse,MIA,D,0,0,0,0,0,0,0,0,0,0,0,0,0,0,0,2020,reg
Kamal Miller,Orlando City SC,D,0,0,0,0,0,0,0,0,0,0,0,0,0,0,0,2020,reg
Hassan Ndam,FC Cincinnati,D,0,0,0,0,0,0,0,0,0,0,0,0,0,0,0,2020,reg
Niko Hansen,Houston Dynamo,F,2,1,92,0,0,0,0,0,0,0,0,4,2,0,0,2020,reg
Lalas Abubakar,Colorado Rapids,D,5,5,450,0,0,0,0,0,0,0,0,6,0,1,0,2020,reg
Erik Holt,Real Salt Lake,D,2,1,95,0,0,0,0,0,0,0,0,2,0,1,0,2020,reg
Tah Brian Anunga,Nashville SC,M,0,0,0,0,0,0,0,0,0,0,0,0,0,0,0,2020,reg
Patrick Seagrist,New York Red Bulls,D,2,2,180,0,0,0,0,0,0,0,0,4,0,1,0,2020,reg
Blake Bodily,Portland Timbers,M,0,0,0,0,0,0,0,0,0,0,0,0,0,0,0,2020,reg
David Loera,Orlando City SC,M,0,0,0,0,0,0,0,0,0,0,0,0,0,0,0,2020,reg
Matt LaGrassa,Nashville SC,M,0,0,0,0,0,0,0,0,0,0,0,0,0,0,0,2020,reg
Michael Baldisimo,Vancouver Whitecaps,M,0,0,0,0,0,0,0,0,0,0,0,0,0,0,0,2020,reg
Rodrigo Schlegel,Orlando City SC,D,2,1,91,0,0,0,0,0,0,0,0,2,1,1,0,2020,reg
Jack Maher,Nashville SC,D,0,0,0,0,0,0,0,0,0,0,0,0,0,0,0,2020,reg
Mason Toye,Minnesota United FC,F,1,1,59,0,0,0,0,0,0,0,0,1,2,0,0,2020,reg
Eddie Munjoma,FC Dallas,D,0,0,0,0,0,0,0,0,0,0,0,0,0,0,0,2020,reg
Lagos Kunga,Atlanta United FC,F,0,0,0,0,0,0,0,0,0,0,0,0,0,0,0,2020,reg
Niki Jackson,Colorado Rapids,F,0,0,0,0,0,0,0,0,0,0,0,0,0,0,0,2020,reg
Miguel Nazarit,Nashville SC,D,0,0,0,0,0,0,0,0,0,0,0,0,0,0,0,2020,reg
Wan Kuzain Wan Kamal,Sporting Kansas City,M,0,0,0,0,0,0,0,0,0,0,0,0,0,0,0,2020,reg
Matt Hundley,Colorado Rapids,F,0,0,0,0,0,0,0,0,0,0,0,0,0,0,0,2020,reg
Patrick Metcalfe,Vancouver Whitecaps,M,1,0,1,0,0,0,0,0,0,0,0,1,0,0,0,2020,reg
Julian Dunn,Toronto FC,D,0,0,0,0,0,0,0,0,0,0,0,0,0,0,0,2020,reg
Noble Okello,Toronto FC,M,1,0,22,0,0,0,0,0,0,0,0,1,0,0,0,2020,reg
Luis Argudo,MIA,M,1,0,11,0,0,0,0,0,0,0,0,1,0,0,0,2020,reg
Paul Marie,San Jose Earthquakes,D,2,1,72,0,0,0,0,0,0,0,0,1,0,0,0,2020,reg
Collin Verfuth,New England Revolution,D,0,0,0,0,0,0,0,0,0,0,0,0,0,0,0,2020,reg
JJ Williams,Atlanta United FC,F,1,0,6,0,0,0,0,0,0,0,0,0,0,0,1,2020,reg
Aboubacar Keita,Columbus Crew SC,D,3,2,253,0,0,0,0,0,0,0,0,2,4,0,0,2020,reg
Henry Kessler,New England Revolution,D,5,3,338,0,0,0,0,0,0,0,0,3,2,1,0,2020,reg
Clement Bayiha,Montreal Impact,M,0,0,0,0,0,0,0,0,0,0,0,0,0,0,0,2020,reg
Mathieu Choiniere,Montreal Impact,M,0,0,0,0,0,0,0,0,0,0,0,0,0,0,0,2020,reg
Milan Iloski,Real Salt Lake,F,0,0,0,0,0,0,0,0,0,0,0,0,0,0,0,2020,reg
Jacob Akanyirige,San Jose Earthquakes,D,0,0,0,0,0,0,0,0,0,0,0,0,0,0,0,2020,reg
Gilbert Fuentes,San Jose Earthquakes,M,0,0,0,0,0,0,0,0,0,0,0,0,0,0,0,2020,reg
Andre Reynolds II,Chicago Fire FC,D,0,0,0,0,0,0,0,0,0,0,0,0,0,0,0,2020,reg
Nicholas Slonina,Chicago Fire FC,D,0,0,0,0,0,0,0,0,0,0,0,0,0,0,0,2020,reg
David Norman Jr.,MIA,M,0,0,0,0,0,0,0,0,0,0,0,0,0,0,0,2020,reg
Sam Junqua,Houston Dynamo,D,1,0,9,0,0,0,0,0,0,0,0,0,0,0,0,2020,reg
Rashawn Dally,FC Cincinnati,F,0,0,0,0,0,0,0,0,0,0,0,0,0,0,0,2020,reg
Tate Schmitt,Real Salt Lake,M,1,1,70,0,0,0,0,0,0,0,0,1,1,0,0,2020,reg
Alex Roldan,FC Dallas,M,2,0,28,0,0,0,0,0,0,0,0,2,0,0,0,2020,reg
Georges Mukumbilwa,Vancouver Whitecaps,D-M,0,0,0,0,0,0,0,0,0,0,0,0,0,0,0,2020,reg
Juan Pablo Torres,New York City FC,M,0,0,0,0,0,0,0,0,0,0,0,0,0,0,0,2020,reg
Griffin Dorsey,Toronto FC,M,1,0,4,0,0,0,0,0,0,0,0,0,1,0,0,2020,reg
Jayden Nelson,Toronto FC,F,0,0,0,0,0,0,0,0,0,0,0,0,0,0,0,2020,reg
Damian Rivera,New England Revolution,M,0,0,0,0,0,0,0,0,0,0,0,0,0,0,0,2020,reg
Alfonso Ocampo-Chavez,FC Dallas,F,0,0,0,0,0,0,0,0,0,0,0,0,0,0,0,2020,reg
Diedie Traore,LA Galaxy,D,1,0,13,0,0,0,0,0,0,0,0,0,1,0,0,2020,reg
Braian Galvan,Colorado Rapids,M,1,0,1,0,0,0,0,0,0,0,0,0,0,0,0,2020,reg
Tayvon Gray,New York City FC,D,0,0,0,0,0,0,0,0,0,0,0,0,0,0,0,2020,reg
Griffin Yow,DC United,F,1,0,7,0,0,0,0,0,0,0,0,1,0,0,0,2020,reg
Jack de Vries,Philadelphia Union,M-F,1,0,6,0,0,0,0,0,0,0,0,0,0,0,0,2020,reg
Cole Turner,Philadelphia Union,M,0,0,0,0,0,0,0,0,0,0,0,0,0,0,0,2020,reg
Tyler Freeman,Sporting Kansas City,F,0,0,0,0,0,0,0,0,0,0,0,0,0,0,0,2020,reg
Danny Leyva,FC Dallas,M,2,1,56,0,0,0,0,0,0,0,0,1,0,0,0,2020,reg
Javier Casas,Chicago Fire FC,M,0,0,0,0,0,0,0,0,0,0,0,0,0,0,0,2020,reg
Tyler Wolff,Atlanta United FC,M,0,0,0,0,0,0,0,0,0,0,0,0,0,0,0,2020,reg
Simon Colyn,Vancouver Whitecaps,M,0,0,0,0,0,0,0,0,0,0,0,0,0,0,0,2020,reg
Damiano Pecile,Vancouver Whitecaps,M,0,0,0,0,0,0,0,0,0,0,0,0,0,0,0,2020,reg
Gianfranco Facchineri,Vancouver Whitecaps,D,0,0,0,0,0,0,0,0,0,0,0,0,0,0,0,2020,reg
Alex Monis,Chicago Fire FC,F,0,0,0,0,0,0,0,0,0,0,0,0,0,0,0,2020,reg
Sebastian Anderson,Colorado Rapids,D,0,0,0,0,0,0,0,0,0,0,0,0,0,0,0,2020,reg
Edwin Cerrillo,FC Dallas,M,0,0,0,0,0,0,0,0,0,0,0,0,0,0,0,2020,reg
Thomas Roberts,FC Dallas,M,0,0,0,0,0,0,0,0,0,0,0,0,0,0,0,2020,reg
George Campbell,Atlanta United FC,D,1,0,46,0,0,0,0,0,0,0,0,2,0,0,0,2020,reg
Erik McCue,Houston Dynamo,D,0,0,0,0,0,0,0,0,0,0,0,0,0,0,0,2020,reg
Josh Atencio,FC Dallas,M,1,0,1,0,0,0,0,0,0,0,0,1,0,0,0,2020,reg
Moses Nyeman,DC United,M,0,0,0,0,0,0,0,0,0,0,0,0,0,0,0,2020,reg
Julian Vazquez,Real Salt Lake,F,0,0,0,0,0,0,0,0,0,0,0,0,0,0,0,2020,reg
Karifa Yao,Montreal Impact,D,0,0,0,0,0,0,0,0,0,0,0,0,0,0,0,2020,reg
Justin Haak,New York City FC,M,0,0,0,0,0,0,0,0,0,0,0,0,0,0,0,2020,reg
Joe Scally,New York City FC,D,0,0,0,0,0,0,0,0,0,0,0,0,0,0,0,2020,reg
Jordan Bender,Orlando City SC,M,0,0,0,0,0,0,0,0,0,0,0,0,0,0,0,2020,reg
Aidan Morris,Columbus Crew SC,M,2,0,36,0,0,0,0,0,0,0,0,1,1,0,0,2020,reg
John Tolkin,New York Red Bulls,D,0,0,0,0,0,0,0,0,0,0,0,0,0,0,0,2020,reg
Brandon Servania,FC Dallas,M,0,0,0,0,0,0,0,0,0,0,0,0,0,0,0,2020,reg
Nicolas Firmino,New England Revolution,M,0,0,0,0,0,0,0,0,0,0,0,0,0,0,0,2020,reg
Cameron Duke,Sporting Kansas City,M,0,0,0,0,0,0,0,0,0,0,0,0,0,0,0,2020,reg
Rocco Romeo,Toronto FC,D,0,0,0,0,0,0,0,0,0,0,0,0,0,0,0,2020,reg
Santiago Mosquera,FC Dallas,M,1,0,28,0,0,0,0,0,0,0,0,1,0,0,0,2020,reg
Liam Fraser,Toronto FC,M,2,0,38,0,0,0,0,0,0,0,0,1,0,0,0,2020,reg
Shamit Shome,Montreal Impact,M,4,1,56,0,0,0,0,0,0,0,0,0,1,0,0,2020,reg
Jeremy Kelly,Colorado Rapids,D,1,1,74,0,0,0,0,0,0,0,0,1,2,0,0,2020,reg
Marcos Lopez,San Jose Earthquakes,D,0,0,0,0,0,0,0,0,0,0,0,0,0,0,0,2020,reg
Jacori Hayes,Minnesota United FC,M,0,0,0,0,0,0,0,0,0,0,0,0,0,0,0,2020,reg
Chris Lema,New York Red Bulls,M,0,0,0,0,0,0,0,0,0,0,0,0,0,0,0,2020,reg
Danilo Acosta,LA Galaxy,D,0,0,0,0,0,0,0,0,0,0,0,0,0,0,0,2020,reg
Taylor Washington,Nashville SC,D,0,0,0,0,0,0,0,0,0,0,0,0,0,0,0,2020,reg
Matheus Rossetto,Atlanta United FC,M,2,1,95,0,0,0,0,0,0,0,0,3,1,1,0,2020,reg
Luis Felipe,San Jose Earthquakes,M,0,0,0,0,0,0,0,0,0,0,0,0,0,0,0,2020,reg
Isaac Angking,New England Revolution,M,0,0,0,0,0,0,0,0,0,0,0,0,0,0,0,2020,reg
Zico Bailey,FC Cincinnati,D,0,0,0,0,0,0,0,0,0,0,0,0,0,0,0,2020,reg
Marcelo Palomino,Houston Dynamo,M,0,0,0,0,0,0,0,0,0,0,0,0,0,0,0,2020,reg
Bryan Reynolds,FC Dallas,D,0,0,0,0,0,0,0,0,0,0,0,0,0,0,0,2020,reg
Luis Arriaga,Real Salt Lake,F,0,0,0,0,0,0,0,0,0,0,0,0,0,0,0,2020,reg
George Acosta,MIA,M,0,0,0,0,0,0,0,0,0,0,0,0,0,0,0,2020,reg
Josue Colman,Orlando City SC,M,0,0,0,0,0,0,0,0,0,0,0,0,0,0,0,2020,reg
Jaylin Lindsey,Sporting Kansas City,D,0,0,0,0,0,0,0,0,0,0,0,0,0,0,0,2020,reg
Tomas Conechny,Portland Timbers,M,0,0,0,0,0,0,0,0,0,0,0,0,0,0,0,2020,reg
Luis Alberto Caicedo,New England Revolution,M,0,0,0,0,0,0,0,0,0,0,0,0,0,0,0,2020,reg
Abdul Rwatubyaye,Colorado Rapids,D,0,0,0,0,0,0,0,0,0,0,0,0,0,0,0,2020,reg
Andrew Carleton,Atlanta United FC,M,0,0,0,0,0,0,0,0,0,0,0,0,0,0,0,2020,reg
Tony Rocha,New York City FC,M,0,0,0,0,0,0,0,0,0,0,0,0,0,0,0,2020,reg
Justin Dhillon,FC Dallas,F,1,0,5,0,0,0,0,0,0,0,0,0,0,0,0,2020,reg
Cristian Gutierrez,Vancouver Whitecaps,D,2,0,45,0,0,0,0,0,0,0,0,0,0,0,0,2020,reg
Deklan Wynne,Colorado Rapids,D,0,0,0,0,0,0,0,0,0,0,0,0,0,0,0,2020,reg
Noah Billingsley,Minnesota United FC,D,0,0,0,0,0,0,0,0,0,0,0,0,0,0,0,2020,reg
Pablo Aranguiz,FC Dallas,M,0,0,0,0,0,0,0,0,0,0,0,0,0,0,0,2020,reg
Matias Vera,Houston Dynamo,M,5,5,450,0,0,0,0,0,0,0,0,8,8,2,0,2020,reg
Ben Mines,New York Red Bulls,M,1,0,26,0,0,0,0,0,0,0,0,1,0,0,0,2020,reg
Amadou Dia,Sporting Kansas City,D,2,0,24,0,0,0,0,0,0,0,0,0,1,0,0,2020,reg
Matt Polster,New England Revolution,D,0,0,0,0,0,0,0,0,0,0,0,0,0,0,0,2020,reg
Mo Adams,Atlanta United FC,M,2,2,171,0,0,0,0,0,0,0,0,5,1,0,0,2020,reg
John Nelson,FC Dallas,D,0,0,0,0,0,0,0,0,0,0,0,0,0,0,0,2020,reg
Eric Calvillo,San Jose Earthquakes,M,0,0,0,0,0,0,0,0,0,0,0,0,0,0,0,2020,reg
Kai Koreniuk,LA Galaxy,M,0,0,0,0,0,0,0,0,0,0,0,0,0,0,0,2020,reg
Tanner Dieterich,Nashville SC,M,0,0,0,0,0,0,0,0,0,0,0,0,0,0,0,2020,reg
Janio Bikel,Vancouver Whitecaps,D,1,1,90,0,0,0,0,0,0,0,0,4,6,0,0,2020,reg
Lassi Lappalainen,Montreal Impact,M,2,0,19,0,0,0,0,0,0,0,0,0,0,0,0,2020,reg
Bryan Acosta,FC Dallas,M,0,0,0,0,0,0,0,0,0,0,0,0,0,0,0,2020,reg
Alejandro Fuenmayor,Houston Dynamo,D,0,0,0,0,0,0,0,0,0,0,0,0,0,0,0,2020,reg
Oniel Fisher,DC United,D,4,1,171,0,0,0,0,0,0,0,0,3,3,0,0,2020,reg
Saad Abdul-Salaam,FC Cincinnati,D,3,1,96,0,0,0,0,0,0,0,0,2,1,0,0,2020,reg
Axel Sjöberg,Columbus Crew SC,D,0,0,0,0,0,0,0,0,0,0,0,0,0,0,0,2020,reg
Tim Parker,New York Red Bulls,D,3,2,181,0,0,0,0,0,0,0,0,1,0,1,0,2020,reg
Joey DeZart,Orlando City SC,M,0,0,0,0,0,0,0,0,0,0,0,0,0,0,0,2020,reg
Anthony Fontana,Philadelphia Union,M,4,0,58,0,0,0,0,0,0,0,0,3,2,1,0,2020,reg
Renzo Zambrano,Portland Timbers,M,0,0,0,0,0,0,0,0,0,0,0,0,0,0,0,2020,reg
Jack Skahan,San Jose Earthquakes,M,0,0,0,0,0,0,0,0,0,0,0,0,0,0,0,2020,reg
Auston Trusty,Colorado Rapids,D,1,0,28,0,0,0,0,0,0,0,0,1,1,0,0,2020,reg
Brent Kallman,Minnesota United FC,D,0,0,0,0,0,0,0,0,0,0,0,0,0,0,0,2020,reg
Justen Glad,Real Salt Lake,D,4,4,328,0,0,0,0,0,0,0,0,9,0,3,0,2020,reg
Robinho,Orlando City SC,M,1,0,25,0,0,0,0,0,0,0,0,1,1,0,0,2020,reg
Jose Bizama,Houston Dynamo,D,0,0,0,0,0,0,0,0,0,0,0,0,0,0,0,2020,reg
Victor Cabrera,Houston Dynamo,D,3,1,95,0,0,0,0,0,0,0,0,1,0,0,0,2020,reg
Julio Cascante,Portland Timbers,D,0,0,0,0,0,0,0,0,0,0,0,0,0,0,0,2020,reg
Tommy McCabe,FC Cincinnati,M,0,0,0,0,0,0,0,0,0,0,0,0,0,0,0,2020,reg
Auro,Toronto FC,D,5,5,442,0,0,0,0,0,0,0,0,5,2,1,0,2020,reg
Daniel Lovitz,Nashville SC,D,2,2,180,0,0,0,0,0,0,0,0,4,0,1,0,2020,reg
Harry Shipp,FC Dallas,M,2,0,38,0,0,0,0,0,0,0,0,0,0,0,0,2020,reg
Erik Godoy,Vancouver Whitecaps,D,0,0,0,0,0,0,0,0,0,0,0,0,0,0,0,2020,reg
Waylon Francis,Columbus Crew SC,D,0,0,0,0,0,0,0,0,0,0,0,0,0,0,0,2020,reg
James Musa,Minnesota United FC,D-M,1,0,1,0,0,0,0,0,0,0,0,0,0,0,0,2020,reg
Shane O'Neill,FC Dallas,D,4,2,209,0,0,0,0,0,0,0,0,3,0,0,0,2020,reg
Jerome Kiesewetter,MIA,F,1,0,22,0,0,0,0,0,0,0,0,0,0,0,0,2020,reg
Tom Pettersson,FC Cincinnati,D,3,2,200,0,0,0,0,0,0,0,0,2,1,0,0,2020,reg
Jurgen Damm,Atlanta United FC,M,0,0,0,0,0,0,0,0,0,0,0,0,0,0,0,2020,reg
Andrew Wooten,Philadelphia Union,F,0,0,0,0,0,0,0,0,0,0,0,0,0,0,0,2020,reg
Jordan Hamilton,Columbus Crew SC,F,0,0,0,0,0,0,0,0,0,0,0,0,0,0,0,2020,reg
Patrick Mullins,Toronto FC,F,2,0,12,0,0,0,0,0,0,0,0,0,0,0,0,2020,reg
Jorge Corrales,Montreal Impact,D,4,4,360,0,0,0,0,0,0,0,0,7,7,0,0,2020,reg
Giancarlo Gonzalez,LA Galaxy,D,4,4,360,0,0,0,0,0,0,0,0,5,0,0,0,2020,reg
Oriol Rosell,Orlando City SC,M-D,3,3,245,0,0,0,0,0,0,0,0,7,1,2,0,2020,reg
Warren Creavalle,Philadelphia Union,M,4,2,187,0,0,0,0,0,0,0,0,3,3,1,0,2020,reg
Darren Mattocks,FC Cincinnati,F,0,0,0,0,0,0,0,0,0,0,0,0,0,0,0,2020,reg
Brayan Beckeles,Nashville SC,D,0,0,0,0,0,0,0,0,0,0,0,0,0,0,0,2020,reg
Jimmy McLaughlin,FC Cincinnati,M,0,0,0,0,0,0,0,0,0,0,0,0,0,0,0,2020,reg
Andres Flores,Portland Timbers,M,0,0,0,0,0,0,0,0,0,0,0,0,0,0,0,2020,reg
Diego Chara,Portland Timbers,M,5,5,450,0,0,0,0,0,0,0,0,14,12,3,0,2020,reg
Paul Arriola,DC United,M-F,0,0,0,0,0,0,0,0,0,0,0,0,0,0,0,2020,reg
Emmanuel Boateng,DC United,M,0,0,0,0,0,0,0,0,0,0,0,0,0,0,0,2020,reg
Alvin Jones,Real Salt Lake,D,0,0,0,0,0,0,0,0,0,0,0,0,0,0,0,2020,reg
Ken Tribbett,Nashville SC,D,0,0,0,0,0,0,0,0,0,0,0,0,0,0,0,2020,reg
Christian Ramirez,Houston Dynamo,F,2,0,37,0,0,0,0,0,0,0,0,1,0,0,0,2020,reg
Fatai Alashe,FC Cincinnati,M,3,0,25,0,0,0,0,0,0,0,0,2,1,1,0,2020,reg
Gedion Zelalem,New York City FC,M,1,0,14,0,0,0,0,0,0,0,0,0,0,0,0,2020,reg
Michael Salazar,Houston Dynamo,F,1,0,12,0,0,0,0,0,0,0,0,1,0,1,0,2020,reg
Micheal Azira,Chicago Fire FC,M,1,0,9,0,0,0,0,0,0,0,0,0,0,0,0,2020,reg
Caleb Stanko,FC Cincinnati,M,3,2,205,0,0,0,0,0,0,0,0,7,2,1,0,2020,reg
Eric Miller,Nashville SC,D,2,2,180,0,0,0,0,0,0,0,0,1,0,0,0,2020,reg
Alvas Powell,MIA,D,2,1,101,0,0,0,0,0,0,0,0,2,2,1,0,2020,reg
Josh Sims,New York Red Bulls,M,2,0,45,0,0,0,0,0,0,0,0,0,0,0,0,2020,reg
Luke Mulholland,Real Salt Lake,M,0,0,0,0,0,0,0,0,0,0,0,0,0,0,0,2020,reg
Andrew Farrell,New England Revolution,D,3,3,270,0,0,0,0,0,0,0,0,2,3,0,0,2020,reg
Eriq Zavaleta,Toronto FC,D,1,0,26,0,0,0,0,0,0,0,0,0,0,0,0,2020,reg
Alex De John,Orlando City SC,D,0,0,0,0,0,0,0,0,0,0,0,0,0,0,0,2020,reg
Dairon Asprilla,Portland Timbers,M-F,1,0,21,0,0,0,0,0,0,0,0,1,1,0,0,2020,reg
Alejandro Guido,LAFC,M,0,0,0,0,0,0,0,0,0,0,0,0,0,0,0,2020,reg
Chris Duvall,Portland Timbers,D,4,3,278,0,0,0,0,0,0,0,0,3,2,2,0,2020,reg
Wil Trapp,MIA,M,5,5,382,0,0,0,0,0,0,0,0,10,2,2,0,2020,reg
Nick Hagglund,FC Cincinnati,D,1,0,2,0,0,0,0,0,0,0,0,0,0,0,0,2020,reg
Sebastien Ibeagha,New York City FC,D,1,0,49,0,0,0,0,0,0,0,0,0,0,0,0,2020,reg
Mikey Ambrose,MIA,D,3,2,161,0,0,0,0,0,0,0,0,1,1,0,0,2020,reg
Josh Williams,Columbus Crew SC,D,1,1,90,0,0,0,0,0,0,0,0,0,0,0,0,2020,reg
Darlington Nagbe,Columbus Crew SC,M,5,5,404,0,0,0,0,0,0,0,0,5,7,0,0,2020,reg
Will Bruin,FC Dallas,F,0,0,0,0,0,0,0,0,0,0,0,0,0,0,0,2020,reg
Perry Kitchen,LA Galaxy,M,5,4,405,0,0,0,0,0,0,0,0,10,5,1,0,2020,reg
Fanendo Adi,Columbus Crew SC,F,3,0,48,0,0,0,0,0,0,0,0,0,2,0,0,2020,reg
Jalil Anibaba,Nashville SC,D,0,0,0,0,0,0,0,0,0,0,0,0,0,0,0,2020,reg
Mohammed Abu,DC United,M,0,0,0,0,0,0,0,0,0,0,0,0,0,0,0,2020,reg
Ashtone Morgan,Real Salt Lake,D,0,0,0,0,0,0,0,0,0,0,0,0,0,0,0,2020,reg
Leandro Gonzalez Pirez,MIA,D,0,0,0,0,0,0,0,0,0,0,0,0,0,0,0,2020,reg
Rudy Camacho,Montreal Impact,D,1,1,90,0,0,0,0,0,0,0,0,1,0,0,0,2020,reg
Mathieu Deplagne,FC Cincinnati,D,4,4,360,0,0,0,0,0,0,0,0,5,3,2,0,2020,reg
Botond Barath,Sporting Kansas City,D,0,0,0,0,0,0,0,0,0,0,0,0,0,0,0,2020,reg
Felipe Gutiérrez,Sporting Kansas City,M,0,0,0,0,0,0,0,0,0,0,0,0,0,0,0,2020,reg
Justin Morrow,Toronto FC,D,3,3,225,0,0,0,0,0,0,0,0,1,1,0,0,2020,reg
Seth Sinovic,New England Revolution,D,0,0,0,0,0,0,0,0,0,0,0,0,0,0,0,2020,reg
Andy Najar,LAFC,D,1,0,23,0,0,0,0,0,0,0,0,0,0,0,0,2020,reg
Jonathan dos Santos,LA Galaxy,M,1,1,45,0,0,0,0,0,0,0,0,0,0,0,0,2020,reg
Danny Wilson,Colorado Rapids,D,1,1,61,0,0,0,0,0,0,0,0,1,1,0,1,2020,reg
Danilo Silva,LAFC,D,0,0,0,0,0,0,0,0,0,0,0,0,0,0,0,2020,reg
Andreu Fontas,Sporting Kansas City,D,0,0,0,0,0,0,0,0,0,0,0,0,0,0,0,2020,reg
Jukka Raitala,Montreal Impact,D,2,2,180,0,0,0,0,0,0,0,0,3,1,0,0,2020,reg
Antonio Mlinar Delamea,New England Revolution,D,2,2,180,0,0,0,0,0,0,0,0,0,0,0,0,2020,reg
Jonathan Mensah,Columbus Crew SC,D,5,5,450,0,0,0,0,0,0,0,0,3,2,1,0,2020,reg
Aurelien Collin,Philadelphia Union,D,0,0,0,0,0,0,0,0,0,0,0,0,0,0,0,2020,reg
Jorge Villafaña,Portland Timbers,F,5,4,361,0,0,0,0,0,0,0,0,4,8,1,0,2020,reg
Brek Shea,MIA,D,0,0,0,0,0,0,0,0,0,0,0,0,0,0,0,2020,reg
Florian Jungwirth,San Jose Earthquakes,D,2,1,117,0,0,0,0,0,0,0,0,2,0,1,0,2020,reg
Vito Wormgoor,Columbus Crew SC,D,2,2,107,0,0,0,0,0,0,0,0,2,1,1,0,2020,reg
Maximiliano Moralez,New York City FC,M,4,3,257,0,0,0,0,0,0,0,0,4,8,0,0,2020,reg
A.J. DeLaGarza,MIA,D,0,0,0,0,0,0,0,0,0,0,0,0,0,0,0,2020,reg
Matt Besler,Sporting Kansas City,D,4,4,360,0,0,0,0,0,0,0,0,5,4,0,0,2020,reg
Fernando Meza,Atlanta United FC,D,5,5,398,0,0,0,0,0,0,0,0,7,2,0,0,2020,reg
Emiliano Insua,LA Galaxy,D,5,5,437,0,0,0,0,0,0,0,0,3,5,1,0,2020,reg
Michael Mancienne,New England Revolution,D,3,2,136,0,0,0,0,0,0,0,0,3,0,1,0,2020,reg
Giuseppe Rossi,Real Salt Lake,F,4,0,44,0,0,0,0,0,0,0,0,1,0,0,0,2020,reg
Winston Reid,Sporting Kansas City,D,0,0,0,0,0,0,0,0,0,0,0,0,0,0,0,2020,reg
Jeff Larentowicz,Atlanta United FC,M,5,1,154,0,0,0,0,0,0,0,0,3,0,0,0,2020,reg
Sean Nealis,New York Red Bulls,D,0,0,0,0,0,0,0,0,0,0,0,0,0,0,0,2020,reg
Daryl Dike,Orlando City SC,F,0,0,0,0,0,0,0,0,0,0,0,0,0,0,0,2020,reg
Alistair Johnston,Nashville SC,D,0,0,0,0,0,0,0,0,0,0,0,0,0,0,0,2020,reg
Laurence Wyke,Atlanta United FC,D,2,1,89,0,0,0,0,0,0,0,0,1,0,0,0,2020,reg
Jahkeele Marshall-Rutty,Toronto FC,M,0,0,0,0,0,0,0,0,0,0,0,0,0,0,0,2020,reg
Jonathan Perez,LA Galaxy,M,0,0,0,0,0,0,0,0,0,,,0,0,0,0,2020,reg
Santiago Patiño,Orlando City SC,F,2,0,8,0,0,0,0,0,0,0,0,0,0,0,0,2020,reg
Callum Montgomery,FC Dallas,D,0,0,0,0,0,0,0,0,0,,,0,0,0,0,2020,reg
Pablo Bonilla,Portland Timbers,D,1,1,82,0,0,0,0,0,0,0,0,1,3,0,0,2020,reg
Tony Leone,LAFC,D,0,0,0,0,0,0,0,0,0,0,0,0,0,0,0,2020,reg
Christian Torres,LAFC,F,0,0,0,0,0,0,0,0,0,0,0,0,0,0,0,2020,reg
Miguel Berry,Columbus Crew SC,F,0,0,0,0,0,0,0,0,0,0,0,0,0,0,0,2020,reg
Nkosi Burgess,FC Dallas,D,0,0,0,0,0,0,0,0,0,0,0,0,0,0,0,2020,reg
Luke Haakenson,Nashville SC,M,0,0,0,0,0,0,0,0,0,0,0,0,0,0,0,2020,reg
Tanner Beason,San Jose Earthquakes,D,0,0,0,0,0,0,0,0,0,0,0,0,0,0,0,2020,reg
Zac McGraw,Portland Timbers,D,0,0,0,0,0,0,0,0,0,0,0,0,0,0,0,2020,reg
Ema Twumasi,FC Dallas,F,0,0,0,0,0,0,0,0,0,0,0,0,0,0,0,2020,reg
Siad Haji,San Jose Earthquakes,M,0,0,0,0,0,0,0,0,0,0,0,0,0,0,0,2020,reg
Siad Haji,San Jose Earthquakes,M,0,0,0,0,0,0,0,0,0,0,0,0,0,0,0,2020,reg
Brian Gutierrez,Chicago Fire FC,M,0,0,0,0,0,0,0,0,0,0,0,0,0,0,0,2020,reg
Brian Gutierrez,Chicago Fire FC,M,0,0,0,0,0,0,0,0,0,0,0,0,0,0,0,2020,reg
Steeven Saba,Montreal Impact,M,0,0,0,0,0,0,0,0,0,0,0,0,0,0,0,2020,reg
Steeven Saba,Montreal Impact,M,0,0,0,0,0,0,0,0,0,0,0,0,0,0,0,2020,reg
Adrien Perez,LAFC,F,0,0,0,0,0,0,0,0,0,0,0,0,0,0,0,2020,reg
Adrien Perez,LAFC,F,0,0,0,0,0,0,0,0,0,0,0,0,0,0,0,2020,reg
Carlos Harvey,LA Galaxy,M,1,0,1,0,0,0,0,0,0,0,0,1,0,0,0,2020,reg
Will Vint,Colorado Rapids,M,0,0,0,0,0,0,0,0,0,,,0,0,0,0,2020,reg
Christopher Garcia,Real Salt Lake,F,0,0,0,0,0,0,0,0,0,,,0,0,0,0,2020,reg
Casey Walls,San Jose Earthquakes,D,0,0,0,0,0,0,0,0,0,,,0,0,0,0,2020,reg
Keesean Ferdinand,Montreal Impact,D,0,0,0,0,0,0,0,0,0,,,0,0,0,0,2020,reg
Tomas Giraldo,Montreal Impact,M,0,0,0,0,0,0,0,0,0,,,0,0,0,0,2020,reg
Nicolas Acevedo,New York City FC,M,0,0,0,0,0,0,0,0,0,,,0,0,0,0,2020,reg
Wyatt Omsberg,Chicago Fire FC,D,1,0,15,0,0,0,0,0,0,0,0,0,0,0,0,2020,reg
Ethan Dobbelaere,FC Dallas,M,0,0,0,0,0,0,0,0,0,0,0,0,0,0,0,2020,reg
Jeizon Ramirez,Real Salt Lake,F,2,0,15,0,0,0,0,0,0,0,0,0,0,0,0,2020,reg
Olivier Mbaizo,Philadelphia Union,D,0,0,0,0,0,0,0,0,0,0,0,0,0,0,0,2020,reg
Olivier Mbaizo,Philadelphia Union,D,0,0,0,0,0,0,0,0,0,0,0,0,0,0,0,2020,reg
Kyle Adams,Houston Dynamo,D,0,0,0,0,0,0,0,0,0,0,0,0,0,0,0,2020,reg
Kyle Adams,Houston Dynamo,D,0,0,0,0,0,0,0,0,0,0,0,0,0,0,0,2020,reg
Mathias Jorgensen,New York Red Bulls,F,0,0,0,0,0,0,0,0,0,0,0,0,0,0,0,2020,reg
Mathias Jorgensen,New York Red Bulls,F,0,0,0,0,0,0,0,0,0,0,0,0,0,0,0,2020,reg
Michee Ngalina,Philadelphia Union,F,0,0,0,0,0,0,0,0,0,0,0,0,0,0,0,2020,reg
Michee Ngalina,Philadelphia Union,F,0,0,0,0,0,0,0,0,0,0,0,0,0,0,0,2020,reg
Ranko Veselinovic,Vancouver Whitecaps,D,3,3,270,0,0,1,0,0,0,0,0,3,4,0,0,2020,reg
Benji Michel,Orlando City SC,F,5,2,178,0,0,1,1,0,0,0,0,0,3,0,0,2020,reg
Thomas Chacon,Minnesota United FC,M,1,0,45,0,0,1,1,0,0,0,0,2,1,1,0,2020,reg
Diego Palacios,LAFC,D,4,4,296,0,0,1,0,0,0,0,0,0,4,1,0,2020,reg
Cameron Dunbar,LA Galaxy,F,1,1,67,0,0,1,0,0,0,0,0,1,2,0,0,2020,reg
Alan Winn,Nashville SC,F,1,0,25,0,0,1,0,0,0,0,0,1,0,0,0,2020,reg
Ignacio Aliseda,Chicago Fire FC,M,2,1,60,0,0,1,0,0,0,0,0,1,0,0,0,2020,reg
Miguel Angel Navarro,Chicago Fire FC,D,4,1,174,0,0,1,0,0,0,0,0,1,2,0,0,2020,reg
Jacob Shaffelburg,Toronto FC,M-F,3,1,94,0,0,1,0,0,0,0,0,1,3,0,0,2020,reg
Jordan Harvey,LAFC,D,2,1,92,0,0,1,0,0,0,0,0,2,1,1,0,2020,reg
Dax McCarty,Nashville SC,M,2,2,180,0,0,1,0,0,0,0,0,3,2,0,0,2020,reg
Laurent Ciman,Toronto FC,D,3,0,65,0,0,1,1,0,0,0,0,3,0,0,0,2020,reg
Reto Ziegler,FC Dallas,D,2,2,180,0,0,1,0,0,0,0,0,2,1,1,0,2020,reg
Rod Fanni,Montreal Impact,D,5,4,405,0,0,1,0,0,0,0,0,1,1,0,0,2020,reg
Lee Nguyen,MIA,M,4,0,77,0,0,1,1,0,0,0,0,1,1,0,0,2020,reg
Haris Medunjanin,FC Cincinnati,M,5,5,423,0,0,1,0,0,0,0,0,4,1,0,0,2020,reg
Fredy Montero,Vancouver Whitecaps,F,2,0,20,0,0,1,0,0,0,0,0,0,1,0,0,2020,reg
Guram Kashia,San Jose Earthquakes,D,5,5,424,0,0,1,0,0,0,0,0,8,2,1,0,2020,reg
Edgar Castillo,Atlanta United FC,D,1,0,49,0,0,1,1,0,0,0,0,0,0,0,0,2020,reg
Victor Wanyama,Montreal Impact,M,3,3,270,0,0,1,1,0,0,0,0,5,4,0,0,2020,reg
Gustav Svensson,FC Dallas,M,4,4,338,0,0,1,0,0,0,0,0,5,3,0,0,2020,reg
Aljaz Struna,Houston Dynamo,D,5,5,448,0,0,1,0,0,0,0,0,5,1,2,0,2020,reg
Chris Mavinga,Toronto FC,D,5,5,420,0,0,1,0,0,0,0,0,5,4,0,0,2020,reg
Dejan Jakovic,LAFC,D,4,4,310,0,0,1,0,0,0,0,0,3,3,1,0,2020,reg
Collen Warner,Colorado Rapids,M,1,1,55,0,0,1,0,0,0,0,0,3,0,0,0,2020,reg
Gudmundur Thórarinsson,New York City FC,D,2,1,46,0,0,1,1,0,0,0,0,1,0,0,0,2020,reg
Jorge Moreira,Portland Timbers,D,1,1,89,0,0,1,0,0,0,0,0,0,1,0,0,2020,reg
Robin Jansson,Orlando City SC,D,5,5,450,0,0,1,1,0,0,0,0,1,6,1,0,2020,reg
Johan Kappelhof,Chicago Fire FC,D,2,2,180,0,0,1,0,0,0,0,0,2,0,1,0,2020,reg
Donny Toia,Real Salt Lake,D,5,5,450,0,0,1,0,0,0,0,0,5,4,0,0,2020,reg
Dario Zuparic,Portland Timbers,D,4,4,345,0,0,1,1,0,0,0,0,6,2,1,1,2020,reg
Russell Teibert,Vancouver Whitecaps,M,5,5,450,0,0,1,1,0,0,0,0,4,2,0,0,2020,reg
Junior Moreno,DC United,M,4,4,307,0,0,1,1,0,0,0,0,6,2,3,1,2020,reg
Bressan,FC Dallas,D,1,0,25,0,0,1,1,0,0,0,0,0,0,0,0,2020,reg
Scott Caldwell,New England Revolution,M,4,4,257,0,0,1,0,0,0,0,0,5,1,1,0,2020,reg
Adam Jahn,Atlanta United FC,F,5,3,208,0,0,1,1,0,0,0,0,3,1,0,0,2020,reg
Jonathan Osorio,Toronto FC,M,2,2,180,0,0,1,0,0,0,0,0,0,5,0,0,2020,reg
Maikel Chang,Real Salt Lake,M,2,0,37,0,0,1,0,0,0,0,0,0,0,0,0,2020,reg
Ben Sweat,MIA,D,5,4,379,0,0,1,1,0,0,0,0,3,3,1,0,2020,reg
Aaron Long,New York Red Bulls,D,3,3,270,0,0,1,1,0,0,0,0,1,1,0,0,2020,reg
Alexander Callens,New York City FC,D,5,5,450,0,0,1,0,0,0,0,0,7,7,0,0,2020,reg
Jimmy Medranda ,Nashville SC,D,1,0,8,0,0,1,1,0,0,0,0,0,0,0,0,2020,reg
Francisco Calvo ,Chicago Fire FC,D,5,5,435,0,0,1,0,0,0,0,0,3,0,0,0,2020,reg
CJ Sapong,Chicago Fire FC,F,3,2,192,0,0,1,0,0,0,0,0,3,7,0,0,2020,reg
Andy Rose,Vancouver Whitecaps,M,1,1,90,0,0,1,0,0,0,0,0,0,0,0,0,2020,reg
Matt Hedges,FC Dallas,D,2,2,180,0,0,1,1,0,0,0,0,1,1,0,0,2020,reg
Wilfried Zahibo,New England Revolution,M,3,1,180,0,0,1,0,0,0,0,0,9,2,0,0,2020,reg
Darwin Ceren,Houston Dynamo,M,2,0,33,0,0,1,0,0,0,0,0,0,1,0,0,2020,reg
Adama Diomande,LAFC,F,1,0,16,0,0,1,0,0,0,0,0,0,0,0,0,2020,reg
Josef Martinez,Atlanta United FC,F,1,1,69,0,0,1,0,0,0,0,0,3,0,0,0,2020,reg
Joevin Jones,FC Dallas,D-M,3,2,209,0,0,1,0,0,0,0,0,3,3,1,0,2020,reg
Daniel Steres ,LA Galaxy,D,3,3,270,0,0,1,0,0,0,0,0,4,4,1,0,2020,reg
David Accam,Nashville SC,F,2,2,126,0,0,1,0,0,0,0,0,5,3,0,0,2020,reg
Justin Portillo ,Real Salt Lake,M,1,1,79,0,0,1,0,0,0,0,0,3,1,0,0,2020,reg
Marlon Hairston,Minnesota United FC,M,1,0,4,0,0,1,0,0,0,0,0,0,0,0,0,2020,reg
Ronaldo Peña,Houston Dynamo,F,1,0,38,0,0,1,0,0,0,0,0,2,2,0,0,2020,reg
Yeimar Gomez Andrade,FC Dallas,D,3,3,242,0,0,1,0,0,0,0,0,7,1,1,0,2020,reg
Jake Mulraney,Atlanta United FC,F,4,3,214,0,0,1,1,0,0,0,0,4,4,1,1,2020,reg
Matthew Real,Philadelphia Union,D,3,2,180,0,0,1,0,0,0,0,0,2,0,1,0,2020,reg
Abu Danladi,Nashville SC,F,2,0,32,0,0,1,1,0,0,0,0,1,0,0,0,2020,reg
Fafa Picault,FC Dallas,M,2,2,127,0,0,1,0,0,0,0,0,0,1,0,0,2020,reg
Sam Johnson,Real Salt Lake,F,3,1,60,0,0,1,0,0,0,0,0,2,0,1,0,2020,reg
Chase Gasper,Minnesota United FC,D,5,5,450,0,0,1,1,0,0,0,0,2,4,1,0,2020,reg
Graham Smith,Sporting Kansas City,D,1,1,90,0,0,1,0,0,0,0,0,1,0,1,0,2020,reg
Daniel Rios,Nashville SC,F,2,0,22,0,0,1,0,0,0,0,0,0,0,0,0,2020,reg
Dave Romney,Nashville SC,D,2,2,180,0,0,1,0,0,0,0,0,0,1,0,0,2020,reg
Amro Tarek,New York Red Bulls,D,5,5,450,0,0,1,0,0,0,0,0,9,5,1,0,2020,reg
Daniel Salloi,Sporting Kansas City,F,2,0,7,0,0,1,0,0,0,0,0,0,0,0,0,2020,reg
Alex Muyl,New York Red Bulls,M,2,0,55,0,0,1,1,0,0,0,0,3,3,0,0,2020,reg
Ballou Jean-Yves Tabla,Montreal Impact,F,1,0,15,0,0,1,1,0,0,0,0,0,0,0,0,2020,reg
Sam Vines,Colorado Rapids,D,5,5,450,0,0,1,0,0,0,0,0,0,2,0,0,2020,reg
Efrain Alvarez,LA Galaxy,M,2,0,19,0,0,1,0,0,0,0,0,0,0,0,0,2020,reg
Gianluca Busio,Sporting Kansas City,M-F,5,1,92,0,0,1,1,0,0,0,0,3,3,1,0,2020,reg
Danny Musovski,LAFC,F,1,0,14,0,0,1,1,0,0,0,0,0,0,0,0,2020,reg
Theo Bair,Vancouver Whitecaps,F,3,1,106,0,0,1,1,0,0,0,0,2,0,0,0,2020,reg
Brandt Bronico,Chicago Fire FC,M,2,2,153,0,0,1,0,0,0,0,0,1,1,0,0,2020,reg
Jack Elliott,Philadelphia Union,D,5,2,183,0,0,1,0,0,0,0,0,2,0,0,0,2020,reg
Shandon Hopeau,FC Dallas,F,3,1,69,0,0,1,0,0,0,0,0,2,0,1,0,2020,reg
Felipe Hernandez,Sporting Kansas City,M,1,0,32,0,0,1,0,0,0,0,0,0,0,0,0,2020,reg
Jason Pendant,New York Red Bulls,D,3,3,269,0,0,1,0,0,0,0,0,5,1,1,0,2020,reg
DeJuan Jones,New England Revolution,D,4,3,271,0,0,1,1,0,0,0,0,4,5,1,0,2020,reg
Chris Odoi-Atsem,DC United,D,4,1,125,0,0,1,1,0,0,0,0,2,2,1,0,2020,reg
Kyle Smith,Orlando City SC,D,1,1,72,0,0,1,1,0,0,0,0,1,0,0,0,2020,reg
Derek Cornelius,Vancouver Whitecaps,D,3,2,197,0,0,1,0,0,0,0,0,1,1,1,0,2020,reg
Erik Sorga,DC United,F,2,1,120,0,0,1,0,0,0,0,0,2,2,0,0,2020,reg
Jared Stroud,New York Red Bulls,M,3,0,55,0,0,1,0,0,0,0,0,1,0,0,0,2020,reg
Andrew Gutman,FC Cincinnati,D,5,2,243,0,0,2,0,0,0,0,0,2,3,0,0,2020,reg
Tristan Blackmon,LAFC,D,5,5,420,0,0,2,1,0,0,0,0,7,3,1,0,2020,reg
Sebastian Berhalter,Columbus Crew SC,M,3,1,81,0,0,2,0,0,0,0,0,2,3,0,0,2020,reg
Bryce Duke,LAFC,M,4,0,35,0,0,2,1,0,0,0,0,1,1,0,0,2020,reg
Julian Araujo,LA Galaxy,D,2,2,145,0,0,2,2,0,0,0,0,2,0,0,0,2020,reg
Julian Carranza,MIA,F,3,1,129,0,0,2,1,0,0,0,0,5,6,1,0,2020,reg
James Sands,New York City FC,M,5,5,428,0,0,2,0,0,0,0,0,12,6,3,0,2020,reg
Nico Lemoine,Houston Dynamo,F,3,0,42,0,0,2,0,0,0,0,0,0,2,0,0,2020,reg
Justin Rennicks,New England Revolution,F,3,0,25,0,0,2,0,0,0,0,0,0,2,0,0,2020,reg
Pablo Ruiz,Real Salt Lake,M,2,1,115,0,0,2,1,0,0,0,0,2,0,0,0,2020,reg
Erickson Gallardo,Toronto FC,F-M,2,1,74,0,0,2,1,0,0,0,0,2,0,0,0,2020,reg
Jose Aja,Minnesota United FC,D,3,3,270,0,0,2,0,0,0,0,0,5,0,2,0,2020,reg
Kendall Waston,FC Cincinnati,D,5,5,448,0,0,2,0,0,0,0,0,4,3,1,0,2020,reg
Eric Remedi,Atlanta United FC,M,5,3,324,0,0,2,0,0,0,0,0,4,11,1,0,2020,reg
Nick Besler,Real Salt Lake,M,4,2,173,0,0,2,1,0,0,0,0,3,3,0,0,2020,reg
Dominique Badji,Nashville SC,F,2,2,150,0,0,2,0,0,0,0,0,1,1,0,0,2020,reg
Anthony Jackson-Hamel,Montreal Impact,F,3,1,76,0,0,2,1,0,0,0,0,2,2,1,0,2020,reg
Ryan Hollingshead,FC Dallas,M,2,2,180,0,0,2,0,0,0,0,0,2,1,0,0,2020,reg
Everton Luiz,Real Salt Lake,M,4,4,360,0,0,2,0,0,0,0,0,6,6,1,0,2020,reg
Aaron Schoenfeld ,Minnesota United FC,F,5,1,124,0,0,2,0,0,0,0,0,1,2,0,0,2020,reg
Joseph-Claude Gyau,FC Cincinnati,M,3,3,235,0,0,2,0,0,0,0,0,0,4,0,0,2020,reg
Antonio Carlos,Orlando City SC,D,5,5,450,0,0,2,1,0,0,0,0,6,3,0,0,2020,reg
Jay Chapman,MIA,M,3,0,26,0,0,2,0,0,0,0,0,2,0,0,0,2020,reg
Raymon Gaddis,Philadelphia Union,D,5,5,450,0,0,2,0,0,0,0,0,3,6,1,0,2020,reg
Michael Boxall,Minnesota United FC,D,5,5,450,0,0,2,2,0,0,0,0,4,0,0,0,2020,reg
Anibal Godoy,Nashville SC,M-D,2,2,180,0,0,2,1,0,0,0,0,2,6,0,0,2020,reg
Joe Corona,LA Galaxy,M,4,3,268,0,0,2,1,0,0,0,0,6,4,1,1,2020,reg
Adam Lundkvist,Houston Dynamo,D,5,5,441,0,0,2,0,0,0,0,0,10,4,1,0,2020,reg
Nick DePuy,LA Galaxy,D,3,3,270,0,0,2,0,0,0,0,0,5,2,0,0,2020,reg
Anton Walkes,Atlanta United FC,D,4,2,205,0,0,2,2,0,0,0,0,0,1,0,0,2020,reg
Jordy Delem,FC Dallas,M,4,2,169,0,0,2,0,0,0,0,0,2,5,1,0,2020,reg
Luka Stojanovic,Chicago Fire FC,M,2,1,60,0,0,2,1,0,0,0,0,3,0,0,0,2020,reg
Tomas Martinez,Houston Dynamo,M,4,2,162,0,0,2,0,0,0,0,0,3,4,0,0,2020,reg
Kekuta Manneh,FC Cincinnati,F,2,1,64,0,0,2,2,0,0,0,0,0,0,0,0,2020,reg
Felipe Mora,Portland Timbers,F,2,2,180,0,0,2,1,0,0,0,0,1,5,0,0,2020,reg
Nicolas Mezquida,Colorado Rapids,F-M,5,0,122,0,0,2,0,0,0,0,0,1,2,0,0,2020,reg
Alexander Ring,New York City FC,M,5,5,450,0,0,2,0,0,0,0,0,8,2,2,0,2020,reg
Ilie Sanchez,Sporting Kansas City,M,5,5,449,0,0,2,0,0,0,0,0,8,3,3,0,2020,reg
Marc Rzatkowski,New York Red Bulls,M,5,0,96,0,0,2,0,0,0,0,0,2,4,0,0,2020,reg
Marcelo Silva,Real Salt Lake,D,4,4,360,0,0,2,1,0,0,0,0,8,1,1,0,2020,reg
Anton Tinnerholm,New York City FC,D,5,5,450,0,0,2,0,0,0,0,0,4,8,2,0,2020,reg
Maikel van der Werff,FC Cincinnati,D,3,3,250,0,0,2,0,0,0,0,0,2,0,0,0,2020,reg
Michael Bradley,Toronto FC,M,3,3,270,0,0,2,0,0,0,0,0,1,4,1,0,2020,reg
Kyle Beckerman,Real Salt Lake,M,2,2,131,0,0,2,1,0,0,0,0,2,3,1,0,2020,reg
Siem de Jong,FC Cincinnati,M,2,1,92,0,0,2,0,0,0,0,0,1,1,0,0,2020,reg
Harrison Afful,Columbus Crew SC,D,4,4,360,0,0,2,0,0,0,0,0,7,1,1,0,2020,reg
Rolf Feltscher,LA Galaxy,D,5,5,450,0,0,2,0,0,0,0,0,7,2,1,0,2020,reg
Kevin Paredes,DC United,M,3,0,72,0,0,2,2,0,0,0,0,2,1,0,0,2020,reg
Dylan Nealis,MIA,D,3,3,259,0,0,2,0,0,0,0,0,6,2,0,0,2020,reg
Brian White,New York Red Bulls,F,4,2,191,0,0,2,1,0,0,0,0,5,1,1,0,2020,reg
Emil Cuello,LA Galaxy,M,4,1,128,0,0,2,2,0,0,0,0,6,0,1,0,2020,reg
Leonard Owusu,Vancouver Whitecaps,M,4,3,212,0,0,2,0,0,0,0,0,3,3,0,0,2020,reg
Cade Cowell,San Jose Earthquakes,F,2,0,50,0,0,2,0,0,0,0,0,3,1,0,0,2020,reg
Jasser Khmiri,Vancouver Whitecaps,D,5,5,387,0,0,2,0,0,0,0,0,4,1,2,0,2020,reg
Andres Reyes,MIA,D,3,3,237,0,0,2,1,0,0,0,0,8,5,1,1,2020,reg
Jose Andres Martinez,Philadelphia Union,M,3,3,234,0,0,3,1,0,0,0,0,7,4,3,0,2020,reg
Gary Mackay-Steven,New York City FC,F,4,0,39,0,0,3,2,0,0,0,0,2,1,0,0,2020,reg
Alexander Buttner,New England Revolution,D,2,2,171,0,0,3,0,0,0,0,0,1,5,0,0,2020,reg
Maynor Figueroa,Houston Dynamo,D,5,4,367,0,0,3,0,0,0,0,0,8,5,2,0,2020,reg
Maxime Chanot,New York City FC,D,3,3,183,0,0,3,0,0,0,0,0,3,1,1,1,2020,reg
Omar Gonzalez,Toronto FC,D,5,5,424,0,0,3,0,0,0,0,0,6,2,0,0,2020,reg
Osvaldo Alonso,Minnesota United FC,M,4,4,360,0,0,3,0,0,0,0,0,7,6,2,0,2020,reg
Sean Davis,New York Red Bulls,M,5,5,450,0,0,3,2,0,0,0,0,5,8,0,0,2020,reg
Sam Nicholson,Colorado Rapids,F,2,2,174,0,0,3,0,0,0,0,0,2,3,0,0,2020,reg
Kelyn Rowe,New England Revolution,M,3,3,240,0,0,3,0,0,0,0,0,3,1,1,0,2020,reg
Marky Delgado,Toronto FC,M,5,5,404,0,0,3,1,0,0,0,0,2,10,0,0,2020,reg
Ronald Matarrita,New York City FC,D,5,5,450,0,0,3,1,0,0,0,0,4,3,0,0,2020,reg
Judson,San Jose Earthquakes,M,3,3,219,0,0,3,1,0,0,0,0,2,2,1,0,2020,reg
Michael Barrios,FC Dallas,M,2,2,179,0,0,3,1,0,0,0,0,2,2,0,0,2020,reg
Mark McKenzie,Philadelphia Union,D,5,5,450,0,0,3,1,0,0,0,0,5,1,0,0,2020,reg
Joseph Mora,DC United,D,5,5,383,0,0,3,0,0,0,0,0,2,0,1,0,2020,reg
Cristhian Paredes,Portland Timbers,M,3,2,179,0,0,3,1,0,0,0,0,5,2,2,0,2020,reg
George Bello,Atlanta United FC,D,2,2,141,0,0,3,0,0,0,0,0,1,3,0,0,2020,reg
Luis Binks,Montreal Impact,D,5,5,405,0,0,3,0,0,0,0,0,7,4,1,0,2020,reg
Elliot Collier,Chicago Fire FC,F,4,0,54,0,0,3,1,0,0,0,0,1,0,0,0,2020,reg
Tom Barlow,New York Red Bulls,F,5,2,157,0,0,3,1,0,0,0,0,1,0,0,0,2020,reg
Miles Robinson,Atlanta United FC,D,3,3,270,0,0,3,0,0,0,0,0,4,2,2,0,2020,reg
Nouhou Tolo,FC Dallas,D,5,3,291,0,0,3,0,0,0,0,0,5,4,0,0,2020,reg
Ethan Zubak,LA Galaxy,F,2,1,97,0,0,4,1,0,0,0,0,3,0,0,0,2020,reg
Zachary Brault-Guillard,Montreal Impact,D,5,3,355,0,0,4,0,0,0,0,0,4,2,0,0,2020,reg
Tajon Buchanan,New England Revolution,F,5,1,113,0,0,4,0,0,0,0,0,4,3,0,0,2020,reg
Omir Fernandez,New York Red Bulls,M,3,1,135,0,0,4,0,0,0,0,0,4,3,0,0,2020,reg
Samuel Piette,Montreal Impact,M,5,5,444,0,0,4,0,0,0,0,0,3,7,0,0,2020,reg
Brooks Lennon,Atlanta United FC,D,5,5,450,0,0,4,0,0,0,0,0,4,5,0,0,2020,reg
Boris Sekulic,Chicago Fire FC,D,3,3,269,0,0,4,0,0,0,0,0,3,1,1,0,2020,reg
Nedum Onuoha,Real Salt Lake,D,2,2,180,0,0,4,1,0,0,0,0,0,0,0,0,2020,reg
Sacha Kljestan,LA Galaxy,M,4,3,257,0,0,4,2,0,0,0,0,5,0,0,0,2020,reg
Justin Meram,Real Salt Lake,M,5,2,240,0,0,4,1,0,0,0,0,4,4,1,0,2020,reg
Sebastian Lletget,LA Galaxy,M,5,4,387,0,0,5,1,0,0,0,0,7,8,0,0,2020,reg
Roman Torres,MIA,D,4,4,324,0,0,5,0,0,0,0,0,3,1,0,1,2020,reg
Lucas Cavallini,Vancouver Whitecaps,F,2,2,180,0,0,5,3,0,0,0,0,2,5,0,0,2020,reg
Tsubasa Endoh,Toronto FC,M,4,3,262,0,0,5,3,0,0,0,0,3,8,1,0,2020,reg
Manuel Castro,Atlanta United FC,F,3,1,104,0,0,5,2,0,0,0,0,0,1,0,0,2020,reg
Nick Lima,San Jose Earthquakes,D,5,5,370,0,0,5,1,0,0,0,0,4,6,0,0,2020,reg
Ulises Segura,DC United,M,4,3,298,0,0,5,4,0,0,0,0,2,5,0,0,2020,reg
Douglas Martinez,Real Salt Lake,F,4,2,232,0,0,5,1,0,0,0,0,4,4,1,0,2020,reg
Thomas McNamara,Houston Dynamo,M,4,2,179,0,0,6,0,0,0,0,0,3,3,0,0,2020,reg
Edison Flores,DC United,M,4,4,287,0,0,6,1,0,0,0,0,4,3,0,0,2020,reg
Yimmi Chara,Portland Timbers,M,5,3,280,0,0,6,4,0,0,0,0,0,7,0,0,2020,reg
Hany Mukhtar,Nashville SC,M,2,2,180,0,0,6,1,0,0,0,0,1,4,0,0,2020,reg
Miguel Ibarra ,FC Dallas,M,4,3,204,0,0,6,3,0,0,0,0,1,0,0,0,2020,reg
Ola Kamara,DC United,F,4,3,170,0,0,6,1,0,0,0,0,2,3,0,0,2020,reg
Boniek Garcia,Houston Dynamo,M,5,5,419,0,0,6,0,0,0,0,0,6,3,3,0,2020,reg
Hassani Dotson,Minnesota United FC,M-D,5,2,262,0,0,6,2,0,0,0,0,1,4,1,0,2020,reg
Nicolas Figal,MIA,D,5,5,450,0,0,7,4,0,0,0,0,8,13,2,0,2020,reg
Sebastian Mendez,Orlando City SC,M,5,2,303,0,0,7,2,0,0,0,0,8,2,1,0,2020,reg
Randall Leal,Nashville SC,F-M,2,2,177,0,0,7,2,0,0,0,0,3,2,0,0,2020,reg
Keaton Parks,New York City FC,M,5,2,207,0,0,8,4,0,0,0,0,2,2,1,0,2020,reg
Danny Hoesen,San Jose Earthquakes,F,4,2,146,0,0,8,1,0,0,0,0,2,0,0,0,2020,reg
Diego Fagundez,New England Revolution,M,4,3,298,0,0,8,1,0,0,0,0,4,1,0,0,2020,reg
Aleksandar Katai,LA Galaxy,M,2,2,117,0,0,8,0,0,0,0,0,5,2,2,0,2020,reg
Jozy Altidore,Toronto FC,F,3,2,173,0,0,9,4,0,0,0,0,3,6,1,0,2020,reg
Andre Shinyashiki,Colorado Rapids,F,3,3,216,0,0,9,4,0,0,0,0,2,3,1,0,2020,reg
Fabian Herbers,Chicago Fire FC,F,5,4,375,0,0,9,2,0,0,0,0,7,4,4,0,2020,reg
Przemyslaw Frankowski,Chicago Fire FC,M,5,5,450,0,0,10,5,0,0,0,0,11,4,0,0,2020,reg
Valentin Castellanos,New York City FC,F,5,3,303,0,0,21,7,0,0,0,0,10,5,1,0,2020,reg